­ЪЈ╗	рѕюрЅх рїѕрѕІрїГ ріарѕ╗рѕ╗рІГ, рЅєрІ│, рІерЅєрІ│ рІЊрІГріљрЅх-1-2, рІхрѕЮрЇђрЅх
­ЪЈ╝	рѕўрѕЃріерѕѕріЏ рЅђрѕІ рІФрѕѕ рІерЅєрІ│ рЅђрѕѕрѕЮ, рѕхрѕюрЅх рїѕрѕІрїГ ріарѕ╗рѕ╗рІГ, рЅєрІ│, рІхрѕЮрЇђрЅх
­ЪЈй	рѕхрѕюрЅх рїѕрѕІрїГ ріарѕ╗рѕ╗рІГ, рЅєрІ│, рІерЅєрІ│ рІЊрІГріљрЅх-4, рІхрѕЮрЇђрЅх
­ЪЈЙ	рѕхрѕюрЅх рїѕрѕІрїГ ріарѕ╗рѕ╗рІГ, рЅєрІ│, рІерЅєрІ│ рІЊрІГріљрЅх-5, рІхрѕЮрЇђрЅх
­ЪЈ┐	рѕхрѕюрЅх рїѕрѕІрїГ ріарѕ╗рѕ╗рІГ, рЅєрІ│, рІерЅєрІ│ рІЊрІГріљрЅх-6, рІхрѕЮрЇђрЅх
­Ъўђ	рЇѕрїѕрїЇ рІФрѕѕ рЇірЅх, рЇѕрїѕрїЇрЅ│, рЇірЅх
­ЪўЂ	рѕБрЅѓрЅ│ рІЊрІГріќрЅй рІФрѕЅрЅх рЇірЅх, рѕБрЅЁ, рІЊрІГріЋ, рЇѕрїѕрїЇрЅ│, рЇірЅх
­Ъўѓ	рѕљрѕцрЅх, ріЦріЋрЅБ, ріерЅБрІх рѕБрЅЁ, рІерѕљрѕцрЅх ріЦріЋрЅБ рІФрѕЅрЅх рЇірЅх, рЇірЅх
­ЪцБ	рѕўрѕгрЅх, рѕўрѕйріерѕГріерѕГ, рѕ│рЅЁ, рЅарѕ│рЅЁ рѕўрѕгрЅх рѕІрІГ рѕўрѕйріерѕГріерѕГ, рЇірЅх
­ЪўЃ	рѕБрЅЁ, ріарЇЅ рІерЅ░ріерЇѕрЅ░ рѕБрЅѓрЅ│ рЇірЅх, ріарЇЇ, ріГрЇЇрЅх, рЇірЅх
­Ъўё	рѕБрЅЁ, ріарЇЇ, ріерЅ░ріерЇѕрЅ░ ріарЇЇ рїІрѕГ рѕБрЅѓрЅ│ рЇірЅх ріЦріЊ рѕБрЅѓрЅ│ рІЊрІГріќрЅй, ріГрЇЇрЅх, рІЊрІГріЋ
­ЪўЁ	рѕІрЅЦ, рѕБрЅЁ, рЅђрІЮрЅЃрІЏ, ріерЅ░ріерЇѕрЅ░ ріарЇЇ рїІрѕГ рѕБрЅѓрЅ│ рЇірЅх ріЦріЊ рЅђрІЮрЅЃрІЏ рѕІрЅЦ, ріГрЇЇрЅх
­Ъўє	рѕБрЅЁ, ріарЇЇ, ріерЅ░ріерЇѕрЅ░ ріарЇЇ рїІрѕГ рѕБрЅѓрЅ│ рЇірЅх ріЦріЊ рІерЅ░рїерЇѕріЉ рІЊрІГріќрЅй, ріГрЇЇрЅх, рЇірЅх
­ЪўЅ	рІерѕџрїБрЅђрѕх рЇірЅх, рїарЅђрѕ│, рЇірЅх
­Ъўі	рѕБрЅѓрЅ│ рІЊрІГріќрЅй рІФрѕЅрЅх рѕБрЅѓрЅ│ рЇірЅх, рѕБрЅЁ, рІЊрІГріЋ, рІЋрЇЇрѕерЅх, рЇірЅх
­ЪўІ	рѕБрЅЁ, рЅарїБрЇІрїГ рѕЮрїЇрЅЦ рІерїјрѕўрїђ рЇірЅх, ріарѕхрїјрѕЮрїѓ, рїБрЇІрїГ, рЇірЅх
­Ъўј	рЅЦрѕЕрѕЁ, ріарѕфрЇЇ, рІерЇђрѕљрІГ рѕўріљрїйрѕГ рІФрІ░рѕерїѕ рѕБрЅѓрЅ│ рЇірЅх, рЇђрѕљрІГ, рЇірЅх
­ЪўЇ	рѕБрЅЁ, рІЊрІГріЋ, рІерѕЇрЅЦ рЅЁрѕГрїй рІФрѕІрЅИрІЇ рІЊрІГріќрЅй рІФрѕЅрЅх рѕБрЅѓрЅ│ рЇірЅх, рЇірЅх, рЇЇрЅЁрѕГ
­Ъўў	рѕЇрЅЦ, рѕўрѕ│рѕЮ, рІерѕџрѕхрѕЮ рЇірЅх, рЇірЅх
­ЪЦ░	ріарЇѕрЅђрѕе, ріерЇЇ рІФрѕѕ ріГрЅЦрѕГ рѕ░рїа, рІѕрІ░рІ░, рІерѕџрѕхрЅЁ рЇірЅх ріе 3 рѕЇрЅЦ рїІрѕГ
­ЪўЌ	рѕўрѕ│рѕЮ, ріЦрІерѕ│рѕў рІФрѕѕ рЇірЅх, рЇірЅх
­ЪўЎ	рѕўрѕ│рѕЮ, рѕБрЅЁ, рІЊрІГріЋ, рІерѕџрѕхрѕЮ рЇірЅх ріерѕБрЅѓрЅ│ рІЊрІГріќрЅй рїІрѕГ, рЇірЅх
­Ъўџ	рѕўрѕ│рѕЮ, рІЊрІГріЋ, рІерѕџрѕхрѕЮ рЇірЅх ріерЅ░рІўрїЅ рІЊрІГріќрЅй рїІрѕГ, рІерЅ░рІўрїІ, рЇірЅх
Рў║	рѕБрЅѓрЅ│ рЇірЅх, рѕБрЅЁ, рІерЅ░ріљрІ░рЇѕ, рІерЅ░рІЮріЊріЊ, рЇірЅх
­ЪЎѓ	рѕБрЅЁ, рЅарЅхріЋрѕ╣ рѕБрЅѓрЅ│ рЇірЅх, рЇірЅх
­ЪцЌ	рѕўрЅ░рЅЃрЅђрЇЇ, рѕЏрЅђрЇЇ, ріЦрІФрЅђрЇѕ рІФрѕѕ рЇірЅх, рЇірЅх
­ЪцЕ	рі«ріерЅЦ, рІЊрІГріќрЅй, рІерЅ░рІІріЋрІФріЋ ріарІхріЊрЅѓ, рЇірЅх
­Ъцћ	рѕЃрѕ│рЅб рЇірЅх, рѕЏрѕ░рЅЦ, рЇірЅх
­Ъце	рЅЁріЋрІхрЅЦ рІерЅ░ріљрѕ│ рЇірЅх
­Ъўљ	рі«рѕхрЅ░рѕГ рІФрѕѕ, рїѕрѕѕрѕЇрЅ░ріЏ, рїѕрѕѕрѕЇрЅ░ріЏ рЇірЅх, рЇірЅх
­ЪўЉ	рѕЮріЋрѕЮ рѕхрѕюрЅх рІерѕїрѕѕрІЇ рЇірЅх, рѕхрѕюрЅх рІерѕѕрѕй, рѕхрѕюрЅх рІерѕЏрІГрїѕрѕЇрїй, рЇірЅх
­ЪўХ	ріарЇЇ, ріарЇЇ рІерѕїрѕѕрІЇ рЇірЅх, рІЮрѕЮ рІФрѕѕ, рїИрїЦрЅ│, рЇірЅх
­ЪЎё	рІЊрІГріќрЅй, рІерѕџрѕйріерѕеріерѕЕ, рІерѕџрѕйріерѕеріерѕЕ рІЊрІГріќрЅй рІФрѕЅрЅх рЇірЅх, рЇірЅх
­ЪўЈ	рѕЮрїИрЅх, рЅарѕЮрїИрЅх рЇѕрїѕрїЇ рІерѕџрѕЇ рЇірЅх, рЇірЅх
­ЪўБ	рїйріЊрЅх, рїйріЊрЅхріЋ ріаріЋрїИрЅБрѕФрЅѓ рЇірЅх, рЇірЅх
­ЪўЦ	ріарѕ░рІГ, ріЦрЇјрІГ рІФрѕѕ, рІерЅ░ріерЇІ, рІерЅ░ріерЇІ рїЇріЋ рІерЅ░рїйріЊріЊ рЇірЅх, рЇірЅх
­Ъў«	рѕљрІўріћрЅ│, ріарЇЇ, ріарЇЇ рІеріерЇѕрЅ░ рЇірЅх, ріГрЇЇрЅх, рЇірЅх
­Ъцљ	рЅБрѕѕрІџрЇЋ ріарЇЇ рЇірЅх, ріарЇЇ, рІџрЇЋ, рЇірЅх
­Ъў»	рЅ░рІ░рѕўрѕў, рЅ░рїѕрѕерѕў, ріаріЋрѕЙріФрѕЙріе, ріаріЋрѕЙріФрѕ┐ріф рЇірЅх, рЇірЅх
­Ъўф	ріЦріЋрЅЁрѕЇрЇЅ рІерѕўрїБ рЇірЅх, ріЦріЋрЅЁрѕЇрЇЇ, рЇірЅх
­ЪўФ	рІерІ░ріерѕў, рІерІ░ріерѕўрІЇ рЇірЅх, рЇірЅх
­Ъў┤	ріЦріЋрЅЁрѕЇрЇЇ, рІерѕџрІФріЋрЅђрѕІрЇІ рЇірЅх, рЇірЅх
­Ъўї	ріЦрЇјрІГ рІФрѕѕ, ріЦрЇјрІГ рІФрѕѕ рЇірЅх, рЇірЅх
­ЪўЏ	рѕЮрѕІрѕ▒ріЋ рІФрІѕрїБ рЇірЅх, рѕЮрѕІрѕх, рЇірЅх
­Ъўю	рѕЮрѕІрѕ▒ріЋ рІФрІѕрїБ ріЦріЊ рІЊрІГріЉ рІерѕџрїБрЅђрѕх рЇірЅх, рѕЮрѕІрѕх, рЅђрѕЇрІх, рІЊрІГріЋ, рїарЅђрѕ│
­ЪўЮ	рѕЮрѕІрѕ▒ріЋ рІФрІѕрїБ ріЦріЊ рІЊрІГріЉріЋ рІерїерЇѕріљ рЇірЅх, рѕЮрѕІрѕх, ріарѕхрЅђрІФрѕџ, рІЊрІГріЋ, рїБрІЋрѕЮ
­Ъцц	рѕѕрѕђрїГ, рІерѕѕрѕђрїГ рЇірЅх, рЇірЅх
­Ъўњ	рІФрѕЇрЅ░рІ░рѕ░рЅ░, рІФрѕЇрЅ░рїѕрѕерѕў, рІФрѕЇрЅ░рїѕрѕерѕў рЇірЅх, рЇірЅх
­ЪўЊ	рѕІрЅЦ, рЅђрІЮрЅЃрІЏ, рЅђрІЮрЅЃрІЏ рѕІрЅЦ рІФрѕѕрІЇ рЇірЅх, рЇірЅх
­Ъўћ	рѕљрѕ│рЅЦ рІерїѕрЅБрІЇ, ріЦрІФрѕ░рЅа рІФрѕѕ рЇірЅх, рїѕрѕѕрѕЇ рІФрѕѕ, рЇірЅх
­ЪўЋ	рїЇрѕФ рІерЅ░рїІрЅБ, рїЇрѕФ рІерЅ░рїІрЅБ рЇірЅх, рЇірЅх
­ЪЎЃ	рІерЅ░рїѕрѕѕрЅарїа, рІерЅ░рїѕрѕѕрЅарїа рЇірЅх, рЇірЅх
­ЪцЉ	ріарЇЅ рѕІрІГ рїѕріЋрІўрЅЦ рІФрѕѕрЅарЅх рЇірЅх, ріарЇЇ, рїѕріЋрІўрЅЦ, рЇірЅх
­Ъў▓	рѕЎрѕЅ рЅарѕЎрѕЅ, рІерЅ░рїѕрѕерѕў, рІерЅ░рїѕрѕерѕў рЇірЅх, рІерІ░ріљрїѕрїа, рЇірЅх
Рў╣	рІерЅ░рі«рѕ│рЅ░рѕе, рІерЅ░рі«рѕ│рЅ░рѕе рЇірЅх, рЇірЅх
­ЪЎЂ	рЅаріерЇірѕЇ рІерЅ░рі«рѕ│рЅ░рѕе рЇірЅх, рІерЅ░рі«рѕ│рЅ░рѕе, рЇірЅх
­Ъўќ	ріЦріЋрЅБрІЇ рІерѕўрїБ, ріЦріЋрЅБрІЇ рІерѕўрїБ ріеріЋрЇѕрѕЕ рІерѕџріЋрЅђрїарЅђрїЦ рЇірЅх, рЇірЅх
­Ъўъ	рІерЅ░ріерЇІ, рІерЅ░ріерЇІ рЇірЅх, рЇірЅх
­ЪўЪ	рІерЅ░рїеріљрЅђ, рІерЅ░рїеріљрЅђ рЇірЅх, рЇірЅх
­Ъўц	рѕЏрѕИріљрЇЇ, ріеріарЇЇріЋрїФ ріЦріЋрЇІрѕјрЅх рІерѕџрІѕрїБрІЇ рЇірЅх, рІхрѕЇ, рЇірЅх
­Ъўб	рѕѕрЅЁрѕХ, ріЦріЋрЅБ, рІерѕџрІФрѕѕрЅЁрѕх рЇірЅх, рІФрІўріљ, рЇірЅх
­ЪўГ	рѕѕрЅЁрѕХ, рѕўріЋрѕ░рЅЁрѕ░рЅЁ, рЅаріерЅБрІх рІерѕџрІФрѕѕрЅЁрѕх рЇірЅх, ріЦріЋрЅБ, рІФрІўріљ
­Ъўд	ріарЇЅ рІерЅ░ріерЇѕрЅ░ рІерЅ░рі«рѕ│рЅ░рѕе рЇірЅх, ріарЇЇ, ріГрЇЇрЅх, рІерЅ░рі«рѕ│рЅ░рѕе, рЇірЅх
­ЪўД	рЅ░рѕЏрѕ« рІерѕџрІФрѕѕрЅЁрѕх рЇірЅх
­Ъўе	рІерЇѕрѕФ, рЇѕрѕф, рЇірЅх, рЇЇрѕГрѕЃрЅх, рЇЇрѕГрѕЃрЅх рІерЅ░рѕърѕІ рЇірЅх
­ЪўЕ	рѕЮрѕГрѕГ рІФрѕѕрІЇ рЇірЅх, рІерЅ░рѕ░рѕІрЅИ, рІерІ░ріерѕўрІЇ, рЇірЅх
­Ъц»	рІерЇѕріљрІ│ рїГріЋрЅЁрѕІрЅх
­Ъўг	рЅ│рѕъ рІерЅ░рїерѕЏрІ░рІ░, рЅ│рѕъ рІерЅ░рїерѕЏрІ░рІ░ рЇірЅх, рЇірЅх
­Ъў░	рѕІрЅЦ, рѕ░рѕЏрІФрІі, рЅђрІЮрЅЃрІЏ, ріарЇЅ рІерЅ░ріерЇѕрЅ░ ріЦріЊ рЅђрІЮрЅЃрІЏ рѕІрЅЦ рІФрѕѕрІЇ рЇірЅх
­Ъў▒	рЅарЇЇрѕГрѕЃрЅх рІерѕџрї«рій рЇірЅх, рІерЅ░рѕ│рЅђрЅђ, рїЦрѕГрѕх рѕўріЋріерѕх, рїЕріИрЅх, рЇірЅх
­ЪЦх	рѕЎрЅђрЅх, рѕЏрѕІрЅЦ, рЅђрІГ рЇірЅх, рІерѕЎрЅђрЅх рїЇрЇірЅх, рІерЅђрѕІ рЇірЅх
­ЪЦХ	рѕ░рѕЏрІФрІі рЇірЅх, рЅђрІЮрЅЃрІЏ, рЅарѕФрІ│, рЅарЅЁрІЮрЅЃрІю рІерЅ░рїјрІ│ ріарЇЇріЋрїФ, рІерЅђрІўрЅђрІў рЇірЅх
­Ъў│	рІерЅ░рІ░рЅарѕе, рІерІ░ріљрЅарѕе рЇірЅх, рІФрЇѕрѕе, рЇірЅх
­Ъцф	ріЦрЅЦрІх рЇірЅх
­Ъўх	рІерІ░рЅарЅ░рІЇ, рІерІ░рЅарЅ░рІЇ рЇірЅх, рЇірЅх
­ЪўА	рЅђрІГ, рЅЂрїБ, рІерЅарїѕріљ рЇірЅх, рІерЅ░рЅєрїБ, рІерЅ░ріЊрІ░рІ░
­Ъўа	ріЦрЅЦрІх, рІерЅ░ріЊрІ░рІ░, рІерЅ░ріЊрІ░рІ░ рЇірЅх, рЇірЅх
­Ъцг	рІеріарЇЇ рѕЮрѕЇріГрЅх рІФрѕѕрЅарЅх рЇірЅх
­Ъўи	рЅђрІЮрЅЃрІЏ, рІерѕЋріГрѕЮріЊ рїГріЋрЅЦрѕЇ рІФрІ░рѕерїѕ рЇірЅх, рІерЅ│рѕўрѕў, рІХріГрЅ░рѕГ, рїГріЋрЅЦрѕЇ
­Ъцњ	рЅарѕйрЅ░ріЏ, рЅ┤рѕГрѕърѕюрЅхрѕГ, рЅ┤рѕГрѕърѕюрЅхрѕГ рІерІФрІў рЇірЅх, рІерЅ│рѕўрѕў, рЇірЅх
­ЪцЋ	рЅЂрѕхрѕЇ, ріЦрѕФрѕ▒ рѕІрІГ рЇІрѕ╗ рІерїарЅђрѕѕрѕѕ рЇірЅх, рїЅрІ│рЅх, рЇірЅх, рЇІрѕ╗
­Ъцб	рѕЏрѕхрЅ│рІѕріГ, рІФрѕхрЅ│рІѕріе, рІФрѕхрЅ│рІѕріе рЇірЅх, рЇірЅх
­Ъц«	рІерѕџрІФрѕхрЅ│рІЇріГ рЇірЅх
­ЪцД	рѕўрѕЇріФрѕЮ рїцріЊ, рѕЏрѕхріљрїарѕх, рІерѕџрІФрѕхріљрїЦрѕх рЇірЅх, рЇірЅх
­ЪўЄ	рѕІрІЕ рѕІрІГ ріГрЅЦ рІФрѕѕрЅарЅх рѕБрЅѓрЅ│ рЇірЅх, рѕўрѕЇрІЊріГ, рѕЮріЊрЅБрІі, рЅ│рѕЏріЮ, рІерІІрѕЁ, рЇірЅх
­Ъца	ріерЅЦрЅх рїарЅБрЅѓ, рі«рЇЇрІФ, рІеріерЅЦрЅх рїарЅБрЅѓ рі«рЇЇрІФ рЇірЅх, рЇірЅх
­ЪЦ│	рЅђріЋрІх, ріГрЅЦрѕе рЅарІЊрѕЇ, рі«рЇЇрІФ, рІерІхрїЇрѕх рЇірЅх, рІхрїЇрѕх
­ЪЦ┤	ріарїЦрІѕрѕЇрІІрІГ рЇірЅх, рІерѕ░ріерѕе, рІерЅ░рѕИрІІрѕерѕе ріарІГріЋ, рІхріЋрІЮрІЮ, рїЇрѕЇрЅЦрїЦ
­ЪЦ║	рѕЇрѕўріЊ, рѕЮрѕЁрѕерЅх, рІерѕЎрїЇрЅх рЇірЅх, рІерЅхріЋріЋрѕй рІЇрѕЙрЅй ріарІГріЋ
­ЪцЦ	рІЇрѕИрЅх, рІерѕџрІІрѕй рЇірЅх, рЇірЅх, рЇњріќріфрІ«
­ЪцФ	рІерїИрїЦрЅ│ рЇірЅх
­ЪцГ	ріЦрїЂріЋ ріеріЋрЇѕрѕЕ рѕІрІГ рІФрІ░рѕерїѕ рЇірЅх
­ЪДљ	рІерІЊрІГріЋ рЅБрїЁ рІФрІ░рѕерїѕ рЇірЅх
­ЪцЊ	рѕўріљрїйрѕФрѕЮ, рІерїѕрїарїа, рІФрїѕрїарїа рЅБрѕѕрѕўріљрїйрѕГ рЇірЅх, рЇірЅх
­Ъўѕ	рѕБрЅЁ, рЅђріЋрІх рІФрѕѕрІЇ рѕБрЅѓрЅ│ рЇірЅх, рЅђріЋрІХрЅй, рЅ░рѕерЅх рЅ░рѕерЅх, рЇірЅх
­ЪЉ┐	рѕЮріЊрЅБрІі, рЅ░рѕерЅх рЅ░рѕерЅх, рІ▓рІФрЅЦрѕјрѕх, рїІріћріЋ, рЇірЅх
­ЪцА	ріарѕхрЅѓріЮ рЅ░рІІріЊрІГ, рІеріарѕхрЅѓріЮ рЅ░рІІріЊрІГ рЇірЅх, рЇірЅх
­ЪЉ╣	рЅ░рѕерЅх рЅ░рѕерЅх, рІерїЃрЇЊріЋ, рїГрѕФрЅЁ, рЇірЅх, рЇЇрїАрѕГ
­ЪЉ║	рЅ░рѕерЅх рЅ░рѕерЅх, рІерїЃрЇЊріЋ, рїєрѕ« рЅєрѕФрїГ, рїГрѕФрЅЁ, рЇірЅх
­Ъњђ	рѕърЅх, рЅ░рѕерЅх рЅ░рѕерЅх, рІерѕФрѕх рЅЁрѕЇ рІЊрЇЁрѕЮ, рїГрѕФрЅЁ, рЇірЅх
Рўа	рІерѕФрѕх рЅЁрѕЇ, рІерѕФрѕхрЅЁрѕЇ ріерЅ░рїБрѕўрѕе рІЊрЇЁрѕЮ рїІрѕГ, рІерЅ░рїБрѕўрѕе рІЊрЇЁрѕЮ, рїГрѕФрЅЁ, рЇірЅх
­ЪЉ╗	рЅ░рѕерЅх рЅ░рѕерЅх, рІерѕЎрЅх рѕўріЋрЇѕрѕх, рїГрѕФрЅЁ, рЇірЅх, рЇЇрїАрѕГ
­ЪЉй	рѕЮріЊрЅБрІі, рІерѕїрѕІ рІЊрѕѕрѕЮ рЇЇрїАрѕГ, рїГрѕФрЅЁ, рЇірЅх, рЇЇрїАрѕГ
­ЪЉЙ	рѕЮріЊрЅБрІі, рІерѕїрѕІ рІЊрѕѕрѕЮ рїГрѕФрЅЁ рЇЇрїАрѕГ, рІерѕїрѕІ рІЊрѕѕрѕЮ рЇЇрїАрѕГ, рїГрѕФрЅЁ, рЇірЅх, рЇЇрїАрѕГ
­Ъцќ	рѕ«рЅдрЅх, рІерѕ«рЅдрЅх рЇірЅх, рїГрѕФрЅЁ, рЇірЅх
­ЪњЕ	ріарѕхрЅѓріЮ, ріарІЏрЅБ, рІеріФріФ ріГрѕЮрѕГ, рїГрѕФрЅЁ, рЇірЅх
­Ъў║	ріарЇЇ, ріарЇЈріЋ рІеріерЇѕрЅ░рЅй рѕБрЅѓрЅ│ рІхрѕўрЅх рЇірЅх, ріГрЇЇрЅх, рІхрѕўрЅх, рЇірЅх
­ЪўИ	рІЊрІГріЋ, рІЊрІГріќрЅ┐ рѕБрЅѓрЅ│ рІерѕєріЉ рЇѕрїѕрїЇ рІФрѕѕрЅй рІхрѕўрЅх рЇірЅх, рІхрѕўрЅх, рЇѕрїѕрїЇрЅ│, рЇірЅх
­Ъў╣	рѕљрѕцрЅх, ріЦріЋрЅБ, рІерѕљрѕцрЅх ріЦріЋрЅБ рІФрѕІрЅх рІхрѕўрЅх рЇірЅх, рІхрѕўрЅх, рЇірЅх
­Ъў╗	рѕЇрЅЦ рЅЁрѕГрїй рІФрѕІрЅИрІЇ рІЊрІГріќрЅй рІФрѕІрЅх рѕБрЅѓрЅ│ рІхрѕўрЅх, рѕБрЅЁ, рІЊрІГріЋ, рІхрѕўрЅх, рЇірЅх
­Ъў╝	рѕЮрїИрЅх, рѕЮрїйрЅ│рІі рѕБрЅЁ, рІерЅЦрѕЇрїЦ рѕБрЅЁ рІерѕЮрЅхрѕЦрЅЁ рІхрѕўрЅх рЇірЅх, рІхрѕўрЅх, рЇірЅх
­Ъўй	рѕўрѕ│рѕЮ, рІЊрІГріЋ, рІЊрІГріќрЅ┐ріЋ рІерїерЇѕріљрЅй рІерѕЮрЅхрѕхрѕЮ рІхрѕўрЅх, рІхрѕўрЅх, рЇірЅх
­ЪЎђ	рІерЅ░рїѕрѕерѕў, рІерІ░ріерѕўрІЇ, рІерІ░ріерѕЏрЅх рІхрѕўрЅх рЇірЅх, рІхрѕўрЅх, рЇірЅх
­Ъў┐	рѕЏрѕЇрЅђрѕх, ріЦріЋрЅБ, рІерѕЮрЅ│рѕѕрЅЁрѕх рІхрѕўрЅх рЇірЅх, рІФрІўріљ, рІхрѕўрЅх
­ЪўЙ	рІѕрѕ▓рЅЦ рІерїарѕЏрЅх, рІерѕЮрЅ│рѕѕріерѕЇріГ рІхрѕўрЅх рЇірЅх, рІхрѕўрЅх, рЇірЅх
­ЪЎѕ	рѕЏрІерЅх, рѕЮріЋрѕЮ ріГрЇЅ ріарѕІрІГрѕЮ, ріГрЇЅ, рІерЅ░ріерѕѕріерѕѕ, рїдрїБ, рЇірЅх
­ЪЎЅ	рѕЮріЋрѕЮ ріГрЇЅ ріарѕЇрѕ░рѕЏрѕЮ, ріГрЇЅ, рІерЅ░ріерѕѕріерѕѕ, рїдрїБ, рЇірЅх
­ЪЎі	рѕўріЊрїѕрѕГ, рѕЮріЋрѕЮ ріГрЇЅ ріарѕЇріЊрїѕрѕГрѕЮ, ріГрЇЅ, рІерЅ░ріерѕѕріерѕѕ
­ЪЉХ	рѕЋрї╗ріЋ, рїерЅЁрѕІ
­ЪДњ	рѕЇрїЁ
­ЪЉд	рЅ░рЅБрІЋрЅх/рІѕріЋрІх рѕЇрїЁ, рІѕріЋрІх рѕЇрїЁ
­ЪЉД	рѕЇрїЃрїѕрѕерІх, рЅфрѕГрїј, рі«рѕерІ│, рІърІхрІФріГ, рІхріЋрїЇрѕЇ
­ЪДЉ	рїјрѕЇрѕЏрѕ│
­ЪЉ▒	рѕЅрїФ/рѕЅрїФ рїИрїЅрѕГ рІФрѕѕрІЇ рѕ░рІЇ, рїјрѕЇрѕЏрѕ│/рѕЅрїФ рїИрїЅрѕГ рІФрѕѕрІЇ
­ЪЉе	рѕ░рІЇ, рІѕріЋрІх
­ЪЉ▒РђЇРЎѓ	рѕ░рІЇ, рІѕрѕГрЅЃрѕЏ, рІѕрѕГрЅЃрѕЏ рїИрїЅрѕГ рІФрѕѕрІЇ рІѕріЋрІх, рІѕріЋрІх
­ЪДћ	рї║рѕЏрѕЮ рѕ░рІЇ
­ЪЉЕ	рѕ┤рЅх, ріЦріЋрѕхрЅх
­ЪЉ▒РђЇРЎђ	рѕ░рІЇ, рѕ┤рЅх, рІѕрѕГрЅЃрѕЏ, рІѕрѕГрЅЃрѕЏ рїИрїЅрѕГ рІФрѕІрЅх рѕ┤рЅх
­ЪДЊ	рІФрѕерїђ рїјрѕЇрѕЏрѕ│
­ЪЉ┤	рѕйрѕЏрїЇрѕї, рІѕріЋрІх
­ЪЉх	рѕ┤рЅх, рѕйрѕЏрїЇрѕї, ріарѕ«рїірЅх рѕ┤рЅх
­ЪЉеРђЇРџЋ	рѕљріфрѕЮ, рЅ░рЅБрІЋрЅх, рЅ┤рѕФрЇњрѕхрЅх, ріљрѕГрѕх, рІѕріЋрІх, рІѕріЋрІх ріљрѕГрѕх
­ЪЉЕРђЇРџЋ	рѕ┤рЅх, рѕ┤рЅх ріљрѕГрѕх, рЅ┤рѕФрЇњрѕхрЅх, ріљрѕГрѕх, ріфрѕЮ, рІерїцріЊ ріЦріЋріГрЅЦріФрЅц
­ЪЉеРђЇ­ЪјЊ	рЅ░рѕўрѕФрЅѓ, рЅ░рѕЏрѕф, рЅ░рЅБрІЋрЅх, рІѕріЋрІх, рІѕріЋрІх рЅ░рѕўрѕФрЅѓ
­ЪЉЕРђЇ­ЪјЊ	рѕ┤рЅх, рѕ┤рЅх рЅ░рѕўрѕФрЅѓ, рЅ░рѕўрѕФрЅѓ, рЅ░рѕЏрѕф, ріЦріЋрѕхрЅх
­ЪЉеРђЇ­ЪЈФ	рЅ░рЅБрІЋрЅх, ріарѕхрЅ░рѕЏрѕф, рІѕріЋрІх, рІѕріЋрІх ріарѕхрЅ░рѕЏрѕф, рЇЋрѕ«рЇїрѕ░рѕГ
­ЪЉЕРђЇ­ЪЈФ	рѕ┤рЅх, рѕ┤рЅх ріарѕхрЅ░рѕЏрѕф, ріарѕхрЅ░рѕЏрѕф, рЇЋрѕ«рЇїрѕ░рѕГ
­ЪЉеРђЇРџќ	рѕџрІЏріЋ, рЅ░рЅБрІЋрЅх, рІѕріЋрІх, рІѕріЋрІх рІ│ріЏ, рЇЇрЅхрѕЁ
­ЪЉЕРђЇРџќ	рѕџрІЏріЋ, рѕ┤рЅх, рѕ┤рЅх рІ│ріЏ, ріЦріЋрѕхрЅх, рІ│ріЏ
­ЪЉеРђЇ­ЪїЙ	рѕ░рІЇ, рЅ░ріГрѕЇ, рІѕріЋрІх, рІѕріЋрІх рїѕрЅарѕг, рїѕрЅарѕг
­ЪЉЕРђЇ­ЪїЙ	рѕ░рІЇ, рѕ┤рЅх, рѕ┤рЅх рїѕрЅарѕг, рЅ░ріГрѕЇ, рїѕрЅарѕг
­ЪЉеРђЇ­ЪЇ│	рѕЏрЅЦрѕ░рѕЇ, рѕ░рІЇ, ріарЅЦрѕ│рІГ, рІѕріЋрІх, рІѕріЋрІх ріарЅЦрѕ│рІГ
­ЪЉЕРђЇ­ЪЇ│	рѕЏрЅЦрѕ░рѕЇ, рѕ┤рЅх, рѕ┤рЅх ріарЅЦрѕ│рІГ, ріарЅЦрѕ│рІГ
­ЪЉеРђЇ­ЪћД	рѕюріФріњріГ, рѕ░рІЇ, рІѕріЋрІх, рІѕріЋрІх рѕюріФріњріГ, рІерЅДріЋрЅД рѕ░рѕФрЅ░ріЏ, рІеріцрѕіріГрЅхрѕфріГ рѕ░рѕФрЅ░ріЏ
­ЪЉЕРђЇ­ЪћД	рѕюріФріњріГ, рѕ░рІЇ, рѕ┤рЅх, рѕ┤рЅх рѕюріФріњріГ, рІерЅДріЋрЅД рѕ░рѕФрЅ░ріЏ, рІеріцрѕіріГрЅхрѕфріГ рѕ░рѕФрЅ░ріЏ
­ЪЉеРђЇ­ЪЈГ	рѕўрїѕрїБрїарѕџрІФ, рѕ░рѕФрЅ░ріЏ, рібріЋрІ▒рѕхрЅхрѕф, рІѕріЋрІх, рІѕріЋрІх рІерЇІрЅЦрѕфріФ рѕ░рѕФрЅ░ріЏ, рЇІрЅЦрѕфріФ
­ЪЉЕРђЇ­ЪЈГ	рѕўрїѕрїБрїарѕџрІФ, рѕ░рѕФрЅ░ріЏ, рѕ┤рЅх рІерЇІрЅЦрѕфріФ рѕ░рѕФрЅ░ріЏ, рібріЋрІ▒рѕхрЅхрѕф, рЇІрЅЦрѕфріФ
­ЪЉеРђЇ­Ъњ╝	рѕўрѕљріЋрІ▓рѕх, ріЋрїЇрІх, ріарѕхрЅ░рІ│рІ│рѕф, рІѕріЋрІх, рІѕріЋрІх рІерЅбрѕ« рѕ░рѕФрЅ░ріЏ
­ЪЉЕРђЇ­Ъњ╝	рѕўрѕљріЋрІ▓рѕх, рѕ┤рЅх, рѕ┤рЅх рІерЅбрѕ« рѕ░рѕФрЅ░ріЏ, ріЋрїЇрІх, ріарѕхрЅ░рІ│рІ│рѕф
­ЪЉеРђЇ­Ъћг	рѕ│рІГріЋрЅ▓рѕхрЅх, рЅБрІ«рѕјрїѓрѕхрЅх, рібріЋрїѓріљрѕГ, рігрѕџрѕхрЅх, рІѕріЋрІх, рІѕріЋрІх рѕ│рІГріЋрЅ▓рѕхрЅх
­ЪЉЕРђЇ­Ъћг	рѕ│рІГріЋрЅ▓рѕхрЅх, рѕ┤рЅх, рѕ┤рЅх рѕ│рІГріЋрЅ▓рѕхрЅх, рЅБрІ«рѕјрїѓрѕхрЅх, рібріЋрїѓріљрѕГ, рігрѕџрѕхрЅх
­ЪЉеРђЇ­Ъњ╗	рѕХрЇЇрЅхрІїрѕГ, рЅ┤ріГріќрѕјрїѓ ріарІІрЅѓ, рІѕріЋрІх, рІѕріЋрІх рЅ┤ріГріќрѕјрїѓ ріарІІрЅѓ, рЇѕрїБрѕф
­ЪЉЕРђЇ­Ъњ╗	рѕ┤рЅх, рѕ┤рЅх рЅ┤ріГріќрѕјрїѓ ріарІІрЅѓ, рѕХрЇЇрЅхрІїрѕГ, рЅ┤ріГріќрѕјрїѓ ріарІІрЅѓ, рЇѕрїБрѕф
­ЪЉеРђЇ­Ъјц	рЅ░рІІріЊрІГ, ріарІЮріЊріЮ, рі«ріерЅЦ, рІѕріЋрІх, рІѕріЋрІх рІўрЇІріЮ, рІўрЇІріЮ
­ЪЉЕРђЇ­Ъјц	рѕ┤рЅх, рѕ┤рЅх рІўрЇІріЮ, рЅ░рІІріЊрІГ, ріарІЮріЊріЮ, рі«ріерЅЦ, рІўрЇІріЮ
­ЪЉеРђЇ­Ъје	рѕарІЊрѕі, рѕ░рІЇ, рІѕріЋрІх, рІѕріЋрІх рѕарІЊрѕі, рІерѕЦрІЋрѕЇ рЅЁрЅЦ рѕЦрѕФ
­ЪЉЕРђЇ­Ъје	рѕарІЊрѕі, рѕ░рІЇ, рѕ┤рЅх, рѕ┤рЅх рѕарІЊрѕі, рІерѕЦрІЋрѕЇ рЅЁрЅЦ рѕЦрѕФ
­ЪЉеРђЇРюѕ	рѕ░рІЇ, ріарІЇрѕ«рЇЋрѕІріЋ, ріарІЇрѕ«рЇЋрѕІріЋ ріарЅЦрѕФрѕф, рІѕріЋрІх, рІѕріЋрІх ріарІЇрѕ«рЇЋрѕІріЋ ріарЅЦрѕФрѕф
­ЪЉЕРђЇРюѕ	рѕ░рІЇ, рѕ┤рЅх, рѕ┤рЅх ріарІЇрѕ«рЇЋрѕІріЋ ріарЅЦрѕФрѕф, ріарІЇрѕ«рЇЋрѕІріЋ, ріарІЇрѕ«рЇЋрѕІріЋ ріарЅЦрѕФрѕф
­ЪЉеРђЇ­Ъџђ	рѕЁрІІ, рѕ«рігрЅх, рѕ░рІЇ, рІѕріЋрІх, рІѕріЋрІх рІерѕЁрІІ рЅ░рѕўрѕФрѕЏрѕф
­ЪЉЕРђЇ­Ъџђ	рѕЁрІІ, рѕ«рігрЅх, рѕ┤рЅх рІерѕЁрІІ рЅ░рѕўрѕФрѕЏрѕф, рІѕріЋрІх
­ЪЉеРђЇ­Ъџњ	рѕ░рІЇ, рІѕріЋрІх, рІѕріЋрІх рІеріЦрѕ│рЅх ріарІ░рїІ рЅ░ріерѕІріФрІГ, рІеріЦрѕ│рЅх ріарІ░рїІ рѕўріфріЊ, рІеріЦрѕ│рЅх ріарІ░рїІ рЅ░ріерѕІріФрІГ
­ЪЉЕРђЇ­Ъџњ	рѕ┤рЅх, рѕ┤рЅх рІеріЦрѕ│рЅх ріарІ░рїІ рЅ░ріерѕІріФрІГ, рІеріЦрѕ│рЅх ріарІ░рїІ рѕўріфріЊ, рІеріЦрѕ│рЅх ріарІ░рїІ рЅ░ріерѕІріФрІГ
­ЪЉ«	рІерЇќрѕірѕх рѕ╣рѕЮ, рЇќрѕірѕх
­ЪЉ«РђЇРЎѓ	рѕ░рІЇ, рІѕріЋрІх, рІѕріЋрІх рІерЇќрѕірѕх рѕ╣рѕЮ, рІерЇќрѕірѕх рѕ╣рѕЮ, рЇќрѕірѕх
­ЪЉ«РђЇРЎђ	рѕ░рІЇ, рѕ┤рЅх, рѕ┤рЅх рІерЇќрѕірѕх рѕ╣рѕЮ, рІерЇќрѕірѕх рѕ╣рѕЮ, рЇќрѕірѕх
­ЪЋх	рѕўрѕГрѕЏрѕф рЇќрѕірѕх, рѕ░рѕІрІГ, ріГрЅхрЅхрѕЇ рЇќрѕірѕх
­ЪЋхРђЇРЎѓ	рѕўрѕГрѕЏрѕф рЇќрѕірѕх, рѕ░рѕІрІГ, ріГрЅхрЅхрѕЇ рЇќрѕірѕх, рІѕріЋрІх, рІѕріЋрІх рѕўрѕГрѕЏрѕф рЇќрѕірѕх
­ЪЋхРђЇРЎђ	рѕўрѕГрѕЏрѕф рЇќрѕірѕх, рѕ░рѕІрІГ, рѕ┤рЅх, рѕ┤рЅх рѕўрѕГрѕЏрѕф рЇќрѕірѕх, ріГрЅхрЅхрѕЇ рЇќрѕірѕх
­Ъњѓ	рїарЅБрЅѓ
­ЪњѓРђЇРЎѓ	рѕ░рІЇ, рІѕріЋрІх, рІѕріЋрІх рїарЅБрЅѓ, рїарЅБрЅѓ
­ЪњѓРђЇРЎђ	рѕ░рІЇ, рѕ┤рЅх, рѕ┤рЅх рїарЅБрЅѓ, рїарЅБрЅѓ
­ЪЉи	рѕарѕФрЅ░ріЏ, рі«рЇірІФ, рІерїЇріЋрЅБрЅ│ рѕЦрѕФ рѕарѕФрЅ░ріЏ, рїЇріЋрЅБрЅ│
­ЪЉиРђЇРЎѓ	рѕарѕФрЅ░ріЏ, рѕ░рІЇ, рІѕріЋрІх, рІѕріЋрІх рІерїЇріЋрЅБрЅ│ рѕ░рѕФрЅ░ріЏ, рїЇріЋрЅБрЅ│
­ЪЉиРђЇРЎђ	рѕарѕФрЅ░ріЏ, рѕ┤рЅх, рѕ┤рЅх рІерїЇріЋрЅБрЅ│ рѕ░рѕФрЅ░ріЏ, рІѕріЋрІх, рїЇріЋрЅБрЅ│
­Ъц┤	рѕЇрІЉрѕЇ
­ЪЉИ	рѕЇрІЋрѕЇрЅх, рѕЮріЊрЅБрІі, рЅ░рѕерЅх рЅ░рѕерЅх
­ЪЉ│	рІѕріЋрІх, рїЦрѕЮрїБрѕЮ, рїЦрѕЮрїБрѕЮ рІФрІ░рѕерїѕ рѕ░рІЇ
­ЪЉ│РђЇРЎѓ	рѕ░рІЇ, рІѕріЋрІх, рїЦрѕЮрїБрѕЮ, рїЦрѕЮрїБрѕЮ рІФрІ░рѕерїѕ рІѕріЋрІх
­ЪЉ│РђЇРЎђ	рѕ░рІЇ, рѕ┤рЅх, рїЦрѕЮрїБрѕЮ, рїЦрѕЮрїБрѕЮ рІФрІ░рѕерЅй рѕ┤рЅх
­ЪЉ▓	рі«рЇЇрІФ, рІѕріЋрІх, рІерЅ╗рІГріЊ рі«рЇЇрІФ рІФрІ░рѕерїѕ рѕ░рІЇ
­ЪДЋ	рѕ┤рЅх рЅарѕхріФрѕГрЇЇ
­Ъцх	рѕЎрѕйрѕФ, рѕ░рІЇ, рѕ▒рЇЇ рѕЇрЅЦрѕх рІерѕѕрЅарѕ░ рѕ░рІЇ, рЅХріГрѕ▓рІХ
­ЪЉ░	рѕЎрѕйрѕфрЅх, рѕ░рѕГрїЇ, рЅгрѕј, рЅгрѕј рІФрІ░рѕерїѕрЅй рѕЎрѕйрѕФ
­Ъц░	рѕ┤рЅх, ріЦрѕГрїЅрІЮ, ріЦрѕГрїЅрІЮ рѕ┤рЅх
­Ъц▒	рїАрЅх рѕЏрїЦрЅБрЅх
­ЪЉ╝	рѕЋрЇЃріЉ рѕўрѕЇрІЊріГ, рѕЋрЇЃріЋ, рѕўрѕЇрІЊріГ, рѕЮріЊрЅБрІі, рЅ░рѕерЅх рЅ░рѕерЅх, рЇірЅх
­ЪјЁ	ріарЅБрЅБ рїѕріЊ, ріарЅБрЅх, ріГрЅЦрѕе рЅарІЊрѕЇ, рІерїѕріЊ ріарЅБрЅх, рїѕріЊ
­ЪцХ	ріЦріЊрЅх, рІѕ/рѕ« ріерѕІрІЇрѕх, рІерїѕріЊ ріЦріЊрЅх, рїѕріЊ
­ЪдИ	рїђрїЇріЊ, рїђрїЇріЊ рѕ┤рЅх, рїЦрѕЕ
­ЪдИРђЇРЎђ	рѕ┤рЅх, рІерѕ┤рЅх рїђрїЇріЊ, рїђрїЇріЊ, рїЦрѕЕ
­ЪдИРђЇРЎѓ	рІѕріЋрІх, рІерІѕріЋрІх рїђрїЇріЊ, рїђрїЇріЊ, рїЦрѕЕ
­Ъд╣	рѕЃрІФрѕЇ, рЅ░ріЋрі«рѕѕріЏ, ріГрЇЅ, рІѕріЋрїђрѕЇ, рІерїђрїЇріЊ рѕЮрѕхрѕЇ
­Ъд╣РђЇРЎђ	рѕЃрІФрѕЇ, рЅ░ріЋрі«рѕѕріЏ, ріГрЇЅ, рІѕріЋрїђрѕЇ, рІерѕ┤рЅх рїђрїЇріЊ рѕЮрѕхрѕЇ
­Ъд╣РђЇРЎѓ	рѕЃрІФрѕЇ, рѕ░рІЇ, рЅ░ріЋрі«рѕѕріЏ, ріГрЇЅ, рІѕріЋрїђрѕѕріЏ, рІерІѕріЋрІх рїђрїЇріЊ рѕЮрѕхрѕЇ
­ЪДЎ	ріарѕхрѕЏрЅх
­ЪДЎРђЇРЎђ	ріарѕхрѕЏрЅ░ріЏ рѕ┤рЅх
­ЪДЎРђЇРЎѓ	ріарѕхрѕЏрЅ░ріЏ рІѕріЋрІх
­ЪДџ	рїаріЋрЅІрІГ
­ЪДџРђЇРЎђ	рїаріЋрЅІрІГ рѕ┤рЅх
­ЪДџРђЇРЎѓ	рїаріЋрЅІрІГ рІѕріЋрІх
­ЪДЏ	рїЦрѕГрѕх рІФрѕѕрІЇ рїГрѕФрЅЁ
­ЪДЏРђЇРЎђ	рїЦрѕГрѕх рІФрѕІрЅх рѕ┤рЅх рїГрѕФрЅЁ
­ЪДЏРђЇРЎѓ	рїЦрѕГрѕх рІФрѕѕрІЇ рІѕріЋрІх рїГрѕФрЅЁ
­ЪДю	рїЇрѕЏрѕй рѕ░рІЇ рїЇрѕЏрѕй рІЊрѕ│
­ЪДюРђЇРЎђ	рѕ┤рЅх рїЇрѕЏрѕй рѕ░рІЇ рїЇрѕЏрѕй рІЊрѕ│
­ЪДюРђЇРЎѓ	рІѕріЋрІх рїЇрѕЏрѕй рѕ░рІЇ рїЇрѕЏрѕй рІЊрѕ│
­ЪДЮ	ріцрѕЇрЇЇ
­ЪДЮРђЇРЎђ	рѕ┤рЅх ріцрѕЇрЇЇ
­ЪДЮРђЇРЎѓ	рІѕріЋрІх ріцрѕЇрЇЇ
­ЪДъ	рїЁріњ
­ЪДъРђЇРЎђ	рѕ┤рЅх рїЁріњ
­ЪДъРђЇРЎѓ	рІѕріЋрІх рїЁріњ
­ЪДЪ	рІърѕЮрЅб
­ЪДЪРђЇРЎђ	рѕ┤рЅх рІърѕЮрЅб
­ЪДЪРђЇРЎѓ	рІѕріЋрІх рІърѕЮрЅб
­ЪЎЇ	рІерЅ░рі«рѕ│рЅ░рѕе, рІерЅ░рі«рѕ│рЅ░рѕе рѕ░рІЇ, рІеріЦрїЁ рѕЮрѕЇріГрЅх
­ЪЎЇРђЇРЎѓ	рІѕріЋрІх, рІѕріЋрІх рЅ░рі«рѕ│рЅхрѕ«, рІерЅ░рі«рѕ│рЅ░рѕе, рІеріЦрїЁ рѕЮрѕЇріГрЅх
­ЪЎЇРђЇРЎђ	рѕ┤рЅх рЅ░рі«рѕ│рЅхрѕФ, рІѕріЋрІх, рІерЅ░рі«рѕ│рЅ░рѕе, рІеріЦрїЁ рѕЮрѕЇріГрЅх
­ЪЎј	рѕЂріћрЅ│рІЇ рІФрѕЇрїБрѕўрІЇ рѕ░рІЇ, рІѕрѕ▓рЅЦ рІерїарѕЏрЅх, рІеріЦрїЁ рѕЮрѕЇріГрЅх
­ЪЎјРђЇРЎѓ	рѕЏрѕѕріГрѕѕріГ, рІѕріЋрІх, рІѕріЋрІх рѕЏрѕѕріГрѕѕріГ, рІеріЦрїЁ рѕЮрѕЇріГрЅх
­ЪЎјРђЇРЎђ	рѕЏрѕѕріГрѕѕріГ, рѕ┤рЅх, рѕ┤рЅх рѕЏрѕѕріГрѕѕріГ, рІеріЦрїЁ рѕЮрѕЇріГрЅх
­ЪЎЁ	ріЦрїЁ, ріГрѕЇріГрѕЇ, рІерЅ░ріерѕѕріерѕѕ, рІеріЦрїЁ рѕЮрѕЇріГрЅх, рІеріЦрїЁ рѕЮрѕЇріГрЅх рѕѕріарІГрѕєріЋрѕЮ
­ЪЎЁРђЇРЎѓ	ріЦрїЁ, рІѕріЋрІх, рІерЅ░ріерѕѕріерѕѕ, рІеріЦрїЁ рѕЮрѕЇріГрЅх, рІеріЦрїЁ рѕЮрѕЇріГрЅх рѕѕріарІГрѕєріЋрѕЮ рІѕріЋрІх
­ЪЎЁРђЇРЎђ	рѕ┤рЅх, ріЦрїЁ, ріГрѕЇріГрѕЇ, рІерЅ░ріерѕѕріерѕѕ, рІеріЦрїЁ рѕЮрѕЇріГрЅх, рІеріЦрїЁ рѕЮрѕЇріГрЅх рѕѕріарІГрѕєріЋрѕЮ рѕ┤рЅх
­ЪЎє	ріЦрѕ║, ріЦрїЁ, рІеріЦрїЁ рѕЮрѕЇріГрЅх, рІеріЦрїЁ рѕЮрѕЇріГрЅх рѕѕріЦрѕ║
­ЪЎєРђЇРЎѓ	ріЦрѕ║, ріЦрїЁ, рІѕріЋрІх, рІеріЦрїЁ рѕЮрѕЇріГрЅх, рІеріЦрїЁ рѕЮрѕЇріГрЅх рѕѕріЦрѕ║ рІѕріЋрІх
­ЪЎєРђЇРЎђ	рѕ┤рЅх, ріЦрѕ║, ріЦрїЁ, рІеріЦрїЁ рѕЮрѕЇріГрЅх, рІеріЦрїЁ рѕЮрѕЇріГрЅх рѕѕріЦрѕ║ рѕ┤рЅх
­ЪњЂ	рѕўрѕерїЃ, рѕўрѕерїЃ рѕ░рїф, рѕўрѕерїЃ рѕ░рїф рїЇрѕѕрѕ░рЅЦ, ріЦрїЁ, ріЦрїѕрІЏ
­ЪњЂРђЇРЎѓ	рѕўрѕерїЃ рѕ░рїф, рѕ┤рЅх, ріЦрїЁ, ріЦрїѕрІЏ, рІѕріЋрІх рѕўрѕерїЃ рѕ░рїф
­ЪњЂРђЇРЎђ	рѕўрѕерїЃ рѕ░рїф, рѕ┤рЅх, рѕ┤рЅх рѕўрѕерїЃ рѕ░рїф, ріЦрїЁ, ріЦрїѕрІЏ
­ЪЎІ	ріЦрїЁ, ріерЇЇ рІФрІ░рѕерїѕ, рІеріЦрїЁ рѕЮрѕЇріГрЅх, рІ░рѕх рІФрѕѕрІЇ ріЦрїЂріЋ рІерѕџрІФрІѕрїБ рѕ░рІЇ, рІ░рѕхрЅ░ріЏ
­ЪЎІРђЇРЎѓ	ріЦрїЁ, ріерЇЇ рІФрІ░рѕерїѕ, рІѕріЋрІх, рІеріЦрїЁ рѕЮрѕЇріГрЅх, рІерІѕріЋрІх ріЦрїЁ рѕЏрІЇрїБрЅх
­ЪЎІРђЇРЎђ	рѕ┤рЅх, ріЦрїЁ, ріерЇЇ рІФрІ░рѕерїѕ, рІерѕ┤рЅх ріЦрїЁ рѕЏрІЇрїБрЅх, рІеріЦрїЁ рѕЮрѕЇріГрЅх
­ЪЎЄ	рѕЏрїјріЋрЅарѕх, ріерІѕрїѕрЅА рїјріЋрЅарѕх рЅЦрѕј рѕ░рѕІрѕЮрЅ│ рІерѕџрѕ░рїЦ рѕ░рІЇ, рІеріЦрїЁ рѕЮрѕЇріГрЅх, рІГрЅЁрѕГрЅ│
­ЪЎЄРђЇРЎѓ	рѕЏрїјріЋрЅарѕх, рІѕріЋрІх, рІѕріЋрІх рѕЏрїјріЋрЅарѕх, рІеріЦрїЁ рѕЮрѕЇріГрЅх, рІГрЅЁрѕГрЅ│
­ЪЎЄРђЇРЎђ	рѕЏрїјріЋрЅарѕх, рѕ┤рЅх, рѕ┤рЅх рѕЏрїјріЋрЅарѕх, рІеріЦрїЁ рѕЮрѕЇріГрЅх, рІГрЅЁрѕГрЅ│
­Ъцд	рѕўрІ░ріљрЅЁ, рѕўрІ│рЇЇ, рѕЏрІўріЋ, ріарѕѕрѕЏрѕўріЋ, ріЦрїЁ
­ЪцдРђЇРЎѓ	рѕўрІ░ріљрЅЁ, рѕўрІ│рЇЇ, ріарѕѕрѕЏрѕўріЋ, рІѕріЋрІх рЇірЅх рѕўрЅЁрѕІрЅх, рЇірЅх рѕўрЅЁрѕІрЅх
­ЪцдРђЇРЎђ	рѕўрІ░ріљрЅЁ, рѕўрІ│рЇЇ, рѕ┤рЅх, рѕ┤рЅх рЇірЅх рѕўрЅЁрѕІрЅх, ріарѕѕрѕЏрѕўріЋ
­Ъци	рѕЇрІЕріљрЅх, рѕўрїарѕФрїарѕГ, ріЋрЅє рѕўрЅ░рІЇ, ріарѕѕрѕЏрІѕрЅЁ
­ЪциРђЇРЎѓ	рѕЇрІЕріљрЅх, рѕўрїарѕФрїарѕГ, ріЋрЅє рѕўрЅ░рІЇ, ріарѕѕрѕЏрІѕрЅЁ, рІѕріЋрІх ріарѕѕрѕЏрІѕрЅЁ
­ЪциРђЇРЎђ	рѕЇрІЕріљрЅх, рѕўрїарѕФрїарѕГ, рѕ┤рЅх ріарѕѕрѕЏрІѕрЅЁ, ріЋрЅє рѕўрЅ░рІЇ, ріарѕѕрѕЏрІѕрЅЁ
­Ъњє	рѕЏрѕ│рїЁ, рѕ│рѕјріЋ, рІерЇірЅх рѕЏрѕ│рїЁ
­ЪњєРђЇРЎѓ	рѕЏрѕ│рїЁ, рѕ│рѕјріЋ, рІѕріЋрІх, рІѕріЋрІх рІерЇірЅх рѕЏрѕ│рїЁ
­ЪњєРђЇРЎђ	рѕЏрѕ│рїЁ, рѕ│рѕјріЋ, рѕ┤рЅх, рѕ┤рЅх рІерЇірЅх рѕЏрѕ│рїЁ
­ЪњЄ	ріЦріЋрїЇрІ│ рѕўрЅђрЅарІФ, рІЇрЅарЅх, рїИрїЅрѕГ рѕўрЅєрѕерїЦ, рїИрїЅрѕГ рЅєрѕФрїГ
­ЪњЄРђЇРЎѓ	рѕ░рІЇ, рІѕріЋрІх, рІѕріЋрІх рїИрїЅрѕГ рѕўрЅєрѕерїЦ, рїИрїЅрѕГ рЅєрѕФрїГ
­ЪњЄРђЇРЎђ	рѕ┤рЅх, рѕ┤рЅх рїИрїЅрѕГ рѕўрЅєрѕерїЦ, рїИрїЅрѕГ рЅєрѕФрїГ
­ЪџХ	рѕўрѕФрѕўрІх, рЅаріЦрїЇрѕГ рѕўрѕИрѕФрѕИрѕГ, ріЦрїЇрѕеріЏ, рІеріЦрїЇрѕГ рѕерІЦрѕЮ рїЅрІъ
­ЪџХРђЇРЎѓ	рѕўрѕФрѕўрІх, рЅаріЦрїЇрѕГ рѕўрѕИрѕФрѕИрѕГ, рІеріЦрїЇрѕГ рѕерІЦрѕЮ рїЅрІъ, рІерІѕріЋрІх ріЦрїЇрѕГ рїЅрІъ
­ЪџХРђЇРЎђ	рѕўрѕФрѕўрІх, рЅаріЦрїЇрѕГ рѕўрѕИрѕФрѕИрѕГ, рІерѕ┤рЅХрЅй ріЦрїЇрѕГ рїЅрІъ, рІеріЦрїЇрѕГ рѕерІЦрѕЮ рїЅрІъ
­ЪЈЃ	рѕЏрѕФрЅХріЋ, рѕЕрїФ, рѕ»рїГ
­ЪЈЃРђЇРЎѓ	рѕЏрѕФрЅХріЋ, рѕЕрїФ, рІЇрІхрІхрѕГ, рІерІѕріЋрІх рѕЕрїФ
­ЪЈЃРђЇРЎђ	рѕЏрѕФрЅХріЋ, рѕЕрїФ, рІЇрІхрІхрѕГ, рІерѕ┤рЅх рѕЕрїФ
­ЪњЃ	рѕўрІ░ріљрѕх, рѕ┤рЅх, рѕ┤рЅХрЅй рѕ▓рІ░ріЋрѕ▒
­ЪЋ║	рѕ░рІЇ, рѕ░рІЇ рѕ▓рІ░ріЋрѕх, рІ│ріЋрѕх
­ЪЉ»	рѕЇрїЃрїѕрѕерІх, рѕ░рІјрЅй рѕ▓рїерЇЇрѕЕ, рѕ┤рЅх, рѕ╣рѕФрЅЦ рі«рЇЇрІФ, рІ│ріЋрѕ░ріЏ
­ЪЉ»РђЇРЎѓ	рѕЇрїЃрїѕрѕерІх, рѕ┤рЅх, рѕ╣рѕФрЅЦ рі«рЇЇрІФ, рІѕріЋрІХрЅй рѕ▓рїерЇЇрѕЕ, рІ│ріЋрѕ░ріЏ
­ЪЉ»РђЇРЎђ	рѕЇрїЃрїѕрѕерІх, рѕ┤рЅх, рѕ┤рЅХрЅй рѕ▓рїерЇЇрѕЕ, рѕ╣рѕФрЅЦ рі«рЇЇрІФ, рІ│ріЋрѕ░ріЏ
­ЪДќ	рѕ░рІЇ рЅаріЦріЋрЇІрѕјрЅх ріГрЇЇрѕЇ рІЇрѕхрїЦ
­ЪДќРђЇРЎђ	рѕ┤рЅх рЅаріЦріЋрЇІрѕјрЅх ріГрЇЇрѕЇ рІЇрѕхрїЦ
­ЪДќРђЇРЎѓ	рІѕріЋрІх рЅаріЦріЋрЇІрѕјрЅх ріГрЇЇрѕЇ рІЇрѕхрїЦ
­ЪДЌ	рѕ░рІЇ рЅ░рѕФрѕФ рѕ▓рІѕрїБ
­ЪДЌРђЇРЎђ	рѕ┤рЅх рЅ░рѕФрѕФ рѕхрЅхрІѕрїБ
­ЪДЌРђЇРЎѓ	рІѕріЋрІх рЅ░рѕФрѕФ рѕ▓рІѕрїБ
­ЪДў	рЅарѕјрЅ│рѕх ріБрЅђрѕЏрѕўрїЦ
­ЪДўРђЇРЎђ	рЅарѕјрЅ│рѕх ріБрЅђрѕЏрѕўрїЦ рѕ┤рЅх
­ЪДўРђЇРЎѓ	рЅарѕјрЅ│рѕх ріБрЅђрѕЏрѕўрїЦ рІѕріЋрІх
­ЪЏђ	рІерїѕрѕІ рѕўрЅ│рїарЅбрІФ рїѕріЋрІ│, рїѕрѕІріЋ рѕўрЅ│рїарЅЦ, рїѕрѕІрІЇріЋ рІерѕџрЅ│рїарЅЦ рѕ░рІЇ
­ЪЏї	рѕєрЅ┤рѕЇ, ріарѕЇрїІ рѕІрІГ рІерЅ░ріЏ рѕ░рІЇ, ріЦріЋрЅЁрѕЇрЇЇ
­ЪЋ┤	рѕЎрѕЅ рѕЇрЅЦрѕх, рѕйріГ рЅЦрѕј рІерѕѕрЅарѕ░ рІерѕЦрѕФ рѕ░рІЇ, ріЋрїЇрІх рѕЦрѕФ, рІѕріЋрІх
­ЪЌБ	рѕўріЊрїѕрѕГ, рѕФрѕх, рЅБрѕѕ ріаріЋрІх рЅђрѕѕрѕЮ рѕЮрѕхрѕЇ, ріЦрІерЅ░ріЊрїѕрѕе рІФрѕѕ рѕФрѕх, рЇірЅх
­ЪЉц	рѕљрІЇрѕЇрЅх, рІерѕ░рІЇ рїЦрѕІ
­ЪЉЦ	рѕљрІЇрѕЇрЅх, рІерѕ░рІЇ рїЦрѕІ, рІерѕ░рІЇ рїЦрѕІрІјрЅй
­Ъц║	рѕ░рІЇ, рѕхрЇќрѕГрЅх, рѕ╗рЅдрѕІ, рѕ╗рЅдрѕІ рѕўрїФрІѕрЅх, рѕ╗рЅдрѕІ рЅ░рїФрІІрЅй
­ЪЈЄ	ріЦрѕйрЅЁрІхрѕЮрІхрѕЮ, рІеріЦрѕйрЅЁрІхрѕЮрІхрѕЮ рЇѕрѕерѕх, рІерЇѕрѕерѕх ріЦрѕйрЅЁрІхрѕЮрІхрѕЮ, рїєріГрѕјріГ, рЇѕрѕерѕх
РЏи	рѕхріф, рѕхріф рЅ░рїФрІІрЅй, рЅарѕерІХ
­ЪЈѓ	рѕхріф, рЅарѕерІХ, рЅарѕерІХ рѕИрѕГрЅ░рЅ┤ рЅ░рїФрІІрЅй, рІерЅарѕерІХ рѕўріЋрѕИрѕФрЅ░рЅ╗
­ЪЈї	рі│рѕх, рїјрѕЇрЇЇ, рїјрѕЇрЇЇ рЅ░рїФрІІрЅй
­ЪЈїРђЇРЎѓ	рѕ░рІЇ, рІѕріЋрІх, рІѕріЋрІх рїјрѕЇрЇЇ рЅ░рїФрІІрЅй, рїјрѕЇрЇЇ
­ЪЈїРђЇРЎђ	рѕ┤рЅх, рѕ┤рЅх рїјрѕЇрЇЇ рЅ░рїФрІІрЅй, рїјрѕЇрЇЇ
­ЪЈё	рІерІЇрѕЃ рѕИрѕГрЅ░рЅ┤, рІерІЇрѕЃ рѕИрѕГрЅ░рЅ┤ рЅ░рїФрІІрЅй
­ЪЈёРђЇРЎѓ	рІѕріЋрІх, рІѕріЋрІх рІерІЇрѕЃ рѕИрѕГрЅ░рЅ┤ рЅ░рїФрІІрЅй, рІерІЇрѕЃ рѕИрѕГрЅ░рЅ┤
­ЪЈёРђЇРЎђ	рѕ┤рЅх, рѕ┤рЅх рІерІЇрѕЃ рѕИрѕГрЅ░рЅ┤ рЅ░рїФрІІрЅй, рІерІЇрѕЃ рѕИрѕГрЅ░рЅ┤
­ЪџБ	рЅ░рѕйріерѕГріФрѕф, рІерЅ│ріЋрі│ рЅђрІўрЇІ, рїђрѕЇрЅБ
­ЪџБРђЇРЎѓ	рЅ░рѕйріерѕГріФрѕф, рІѕріЋрІх, рІерІѕріЋрІх рїђрѕЇрЅБ рЅђрІЏрЇі, рїђрѕЇрЅБ
­ЪџБРђЇРЎђ	рѕ┤рЅх, рЅ░рѕйріерѕГріФрѕф, рІерѕ┤рЅх рїђрѕЇрЅБ рЅђрІЏрЇі, рїђрѕЇрЅБ
­ЪЈі	рІІріЊ, рІІріЊрЅ░ріЏ
­ЪЈіРђЇРЎѓ	рѕ░рІЇ, рІѕріЋрІх, рІІріЊ, рІерІѕріЋрІх рІІріЊрЅ░ріЏ
­ЪЈіРђЇРЎђ	рѕ┤рЅх, рІІріЊ, рІерѕ┤рЅх рІІріЊрЅ░ріЏ
РЏ╣	рі│рѕх, рі│рѕх рІерІФрІў рѕ░рІЇ
РЏ╣РђЇРЎѓ	рі│рѕх, рі│рѕх рІерІФрІў рІѕріЋрІх, рІѕріЋрІх
РЏ╣РђЇРЎђ	рѕ┤рЅх, рі│рѕх, рі│рѕх рІерІФрІўрЅй рѕ┤рЅх
­ЪЈІ	ріГрЅЦрІ░рЅх, ріГрЅЦрІ░рЅх ріаріЋрѕ║
­ЪЈІРђЇРЎѓ	ріГрЅЦрІ░рЅх, рІѕріЋрІх, рІѕріЋрІх ріГрЅЦрІ░рЅх ріаріЋрѕ║
­ЪЈІРђЇРЎђ	рѕ┤рЅх, рѕ┤рЅх ріГрЅЦрІ░рЅх ріаріЋрѕ║, ріГрЅЦрІ░рЅх
­Ъџ┤	рЅЦрѕхріГрѕїрЅх, рЅЦрѕхріГрѕїрЅх рїІрѕІрЅб
­Ъџ┤РђЇРЎѓ	рЅЦрѕхріГрѕїрЅх, рІѕріЋрІх, рІѕріЋрІх рЅЦрѕхріГрѕїрЅх рїІрѕІрЅб
­Ъџ┤РђЇРЎђ	рѕ┤рЅх, рѕ┤рЅх рЅЦрѕхріГрѕїрЅх рїІрѕІрЅб, рЅЦрѕхріГрѕїрЅх
­Ъџх	рЅЦрѕхріГрѕїрЅх, рЅЦрѕхріГрѕїрЅх рїІрѕІрЅб, рЅ░рѕФрѕФ, рІерЅ░рѕФрѕФ рЅЦрѕхріГрѕїрЅх рїІрѕІрЅб
­ЪџхРђЇРЎѓ	рЅЦрѕхріГрѕїрЅх, рЅЦрѕхріГрѕїрЅх рїІрѕІрЅб, рЅ░рѕФрѕФ, рІѕріЋрІх, рІѕріЋрІх рІерЅ░рѕФрѕФ рЅЦрѕхріГрѕїрЅх рїІрѕІрЅб
­ЪџхРђЇРЎђ	рѕ┤рЅх, рѕ┤рЅх рІерЅ░рѕФрѕФ рЅЦрѕхріГрѕїрЅх рїІрѕІрЅб, рЅЦрѕхріГрѕїрЅх, рЅЦрѕхріГрѕїрЅх рїІрѕІрЅб, рЅ░рѕФрѕФ
­ЪЈј	рѕўріфріЊ, ріЦрѕйрЅЁрІхрѕЮрІхрѕЮ, рІерІЇрІхрІхрѕГ рѕўріфріЊ
­ЪЈЇ	рѕърЅ░рѕГрѕ│рІГріГрѕЇ, ріЦрѕйрЅЁрІхрѕЮрІхрѕЮ
­ЪцИ	рѕ░рІЇ, рѕхрЇќрѕГрЅх, ріаріГрѕ«рЅБрЅх, рїЁрѕЮріЊрѕхрЅ▓ріГ
­ЪцИРђЇРЎѓ	рѕ░рІЇ, рѕхрЇќрѕГрЅх, ріаріГрѕ«рЅБрЅх, рІѕріЋрІх, рІерІѕріЋрІх ріаріГрѕ«рЅБрЅх, рїЁрѕЮріЊрѕхрЅ▓ріГ
­ЪцИРђЇРЎђ	рѕ┤рЅх, рѕхрЇќрѕГрЅх, ріаріГрѕ«рЅБрЅх, рІерѕ┤рЅх ріаріГрѕ«рЅБрЅх, рїЁрѕЮріЊрѕхрЅ▓ріГ
­Ъц╝	рѕ░рІЇ, рѕхрЇќрѕГрЅх, ріљрї╗ рЅхрїЇрѕЇ
­Ъц╝РђЇРЎѓ	рѕ░рІЇ, рѕхрЇќрѕГрЅх, ріљрї╗ рЅхрїЇрѕЇ, рІѕріЋрІх, рІерІѕріЋрІх ріљрї╗ рЅхрїЇрѕЇ
­Ъц╝РђЇРЎђ	рѕ░рІЇ, рѕ┤рЅх, рѕхрЇќрѕГрЅх, ріљрї╗ рЅхрїЇрѕЇ, рІерѕ┤рЅх ріљрї╗ рЅхрїЇрѕЇ
­Ъцй	рѕ░рІЇ, рѕхрЇќрѕГрЅх, рІЇрѕЃ, рІерІЇрѕЃ рѕІрІГ рїѕріЊ рїерІІрЅ│, рІерїѕріЊ рїерІІрЅ│
­ЪцйРђЇРЎѓ	рѕхрЇќрѕГрЅх, рІѕріЋрІх, рІЇрѕЃ, рІерІѕріЋрІх рІерІЇрѕЃ рѕІрІГ рїѕріЊ рїерІІрЅ│, рІерїѕріЊ рїерІІрЅ│
­ЪцйРђЇРЎђ	рѕ┤рЅх, рѕхрЇќрѕГрЅх, рІЇрѕЃ, рІерѕ┤рЅх рІерІЇрѕЃ рѕІрІГ рїѕріЊ рїерІІрЅ│, рІерїѕріЊ рїерІІрЅ│
­ЪцЙ	рѕ░рІЇ, рѕхрЇќрѕГрЅх, рі│рѕх, рІеріЦрїЁ рі│рѕх
­ЪцЙРђЇРЎѓ	рѕхрЇќрѕГрЅх, рі│рѕх, рІѕріЋрІх, рІеріЦрїЁ рі│рѕх, рІерІѕріЋрІх рІеріЦрїЁ рі│рѕх рїерІІрЅ│
­ЪцЙРђЇРЎђ	рѕ┤рЅх, рѕхрЇќрѕГрЅх, рі│рѕх, рІерѕ┤рЅх рІеріЦрїЁ рі│рѕх рїерІІрЅ│, рІеріЦрїЁ рі│рѕх
­Ъц╣	рѕџрІЏріЋ, рѕхрѕФрЅЦрІЎ, рЅЁрѕЇрѕЇрЅдрѕй, рЅйрѕјрЅ│
­Ъц╣РђЇРЎѓ	рѕхрѕФрЅЦрІЎ, рЅЁрѕЇрѕЇрЅдрѕй, рЅйрѕјрЅ│, рІѕріЋрІх, рІерІѕріЋрІх рЅЁрЅЦрЅЦрѕјрѕй
­Ъц╣РђЇРЎђ	рѕ┤рЅх, рѕхрѕФрЅЦрІЎ, рЅЁрѕЇрѕЇрЅдрѕй, рІерѕ┤рЅх рЅЁрЅЦрЅЦрѕјрѕй
­ЪЉФ	рѕ┤рЅх, ріЦрїЁ, ріЦрїЁ рѕѕріЦрїЁ рІерЅ░рІФрІФрІЎ рІѕріЋрІх ріЦріЊ рѕ┤рЅх, рІѕріЋрІх, рїЦріЋрІХрЅй
­ЪЉг	рѕўріЋрЅхрІ«рЅй, рѕўрІФрІЮ ріЦрїЁ, ріЦрїЁ рѕѕріЦрїЁ рІерЅ░рІФрІФрІЎ рІѕріЋрІХрЅй, рІърІхрІФріГ, рїёрѕЮріњ, рїЦріЋрІХрЅй
­ЪЉГ	рѕўрІФрІЮ, рѕ┤рЅх, ріЦрїЁ, ріЦрїЁ рѕѕріЦрїЁ рІерЅ░рІФрІФрІЎ рѕ┤рЅХрЅй, рїЦріЋрІХрЅй
­ЪњЈ	рѕўрѕ│рѕЮ, рїЦріЋрІХрЅй, рЇЇрЅЁрѕГ
­ЪњЉ	рѕЇрЅЦ, рѕЇрЅЦ рЅарѕўрѕЃрѕІрЅИрІЇ рІФрѕЅ рїЦріЋрІХрЅй, рїЦріЋрІХрЅй, рЇЇрЅЁрѕГ
­ЪЉф	рѕЇрїЁ, рЅцрЅ░рѕ░рЅЦ, ріарЅБрЅх, ріЦріЊрЅх
­Ъц│	рѕхрѕЇріГ, ріЦрѕФрѕх рЇјрЅХ рѕЏріЋрѕ│рЅх, ріФрѕюрѕФ
­Ъњф	рЅ│рїЦрЇј рІерЅ░рІѕрїарѕе рІеріЦрїЁ рїАріЋрЅ╗, ріарѕхрЅѓріЮ, ріаріФрѕЇ, рІеріЦрїЁ рїАріЋрЅ╗, рїАріЋрЅ╗
­Ъдх	рѕўрѕЮрЅ│рЅх, ріаріФрѕІрЅх, ріЦрїЇрѕГ
­ЪдХ	рѕўрѕЮрЅ│рЅх, рѕўрѕГрїѕрїЦ, ріЦрїЇрѕГ рІерЅ│рЅйріЏрІЇ ріГрЇЇрѕЇ
­ЪЉѕ	ріљрїЦрЅЦ, ріЦрїЁ, рІѕрІ░ ріІрѕІ рѕўрїѕрѕЇрЅарїЦ, рІерїЇрѕФ ріарІГрЅарѕЅрЅБ ріЦрїЁ рІерЅ░рЅђрѕ░рѕе ріарѕўрѕЇріФрЅй рїБрЅх, рїБрЅх
­ЪЉЅ	ріљрїЦрЅЦ, ріЦрїЁ, рІѕрІ░ ріІрѕІ рѕўрїѕрѕЇрЅарїЦ, рІерЅђріЮ ріарІГрЅарѕЅрЅБ ріЦрїЁ рІерЅ░рЅђрѕ░рѕе ріарѕўрѕЇріФрЅй рїБрЅх, рїБрЅх
РўЮ	рѕІрІГ, ріљрїЦрЅЦ, ріЦрїЁ, рІѕрІ░ рѕІрІГ рІерЅ░рЅђрѕ░рѕе ріарѕўрѕЇріФрЅй рїБрЅх, рїБрЅх
­ЪЉє	рѕІрІГ, ріљрїЦрЅЦ, ріЦрїЁ, рІѕрІ░ рѕІрІГ рІерЅ░рЅђрѕ░рѕе ріарІГрЅарѕЅрЅБ рЅаріЕрѕЇ ріарѕўрѕЇріФрЅй рїБрЅх, рІѕрІ░ ріІрѕІ рѕўрїѕрѕЇрЅарїЦ
­ЪќЋ	ріаріФрѕЇ, ріЦрїЁ, рІерѕўрѕЃрѕЇ рїБрЅх, рїБрЅх
­ЪЉЄ	рЅ│рЅй, ріљрїЦрЅЦ, ріЦрїЁ, рІѕрІ░ рЅ│рЅй рІерЅ░рЅђрѕ░рѕе ріарІГрЅарѕЅрЅБ рЅаріЕрѕЇ ріарѕўрѕЇріФрЅй рїБрЅх, рІѕрІ░ ріІрѕІ рѕўрїѕрѕЇрЅарїЦ
Рюї	ріаріФрѕЇ, ріЦрїЁ, рІерІхрѕЇ ріарІхрѕФрїіріљрЅх рѕЮрѕЇріГрЅх ріЦрїЁ, рІхрѕЇ
­Ъцъ	рѕЏрїБрѕўрѕГ, ріЦрІхрѕЇ, ріЦрїЁ, рїБрЅх, рїБрЅх рѕЏрїБрѕўрѕГ
­Ъќќ	рЅЕрѕЇріФріЋ, рЅЕрѕЇріФріЋ рѕ░рѕІрѕЮрЅ│, ріаріФрѕЇ, ріЦрїЁ, рїБрЅх
­Ъцў	рЅђріЋрІХрЅй, ріаріФрѕЇ, ріЦрїЁ, рІерЅђріЋрІХрЅй рѕЮрѕЇріГрЅх, рїБрЅх
­ЪцЎ	ріЦрїЁ, рІ░рІЇрѕЇрѕЇріЮ, рІ░рІЇрѕЇрѕЇріЮ рІеріЦрїЁ рѕЮрѕЇріГрЅх
­Ъќљ	рѕѕрѕ░рѕІрѕЮрЅ│ рІѕрІ░ рѕІрІГ рІерЅ░рІўрѕерїЅ рІеріЦрїЁ рїБрЅХрЅй, рѕўрІўрѕГрїІрЅх, ріаріФрѕЇ, ріЦрїЁ, рїБрЅх
РюІ	ріаріФрѕЇ, ріЦрїЁ, рІѕрІ░ рѕІрІГ рІерЅ░рІ░рѕерїѕ ріЦрїЁ
­ЪЉї	ріаріФрѕЇ, ріЦрѕ║, ріЦрѕ║ рѕЮрѕЇріГрЅх ріЦрїЁ, ріЦрїЁ
­ЪЉЇ	рѕІрІГ, ріарІЇрѕФ рїБрЅх, ріарІЇрѕФ рїБрЅх рІѕрІ░ рѕІрІГ, ріЦрїЁ, рЇірЅх
­ЪЉј	рЅ│рЅй, ріарІЇрѕФ рїБрЅх, ріарІЇрѕФ рїБрЅх рІѕрІ░ рЅ│рЅй, ріЦрїЁ, рЇірЅх
Рюі	рЅАрїб, ріЦрїЁ, рІѕрІ░ рѕІрІГ рІерЅ░рІФрІў рЅАрїб, рІерЅ░рїерЅарїа, рїАрїФ
­ЪЉі	рЅАрїб, ріЦрїЁ, рІерЅ░рѕ░ріљрІўрѕе рїАрїФ, рІерЅ░рїерЅарїа, рїАрїФ
­ЪцЏ	рЅАрїб, рІѕрІ░ рїЇрѕФ, рІѕрІ░ рїЇрѕФ рІерІърѕе рЅАрїб
­Ъцю	рЅАрїб, рІѕрІ░ рЅђріЮ, рІѕрІ░ рЅђріЮ рІерІърѕе рЅАрїб
­Ъцџ	рІѕрІ░ ріІрѕЇ, рІѕрІ░ ріІрѕЇ рІерЅ░рІўрѕерїІ ріЦрїЁ, рІерЅ░рІўрѕерїІ
­ЪЉІ	рѕърїѕрІх, рЅ░рІѕрІЏрІІрІЦ ріЦрїЁ, ріаріФрѕЇ, ріЦрїЁ, ріЦрїЁ рѕЏрІѕрІЏрІѕрІЮ
­ЪцЪ	рѕЮрѕЇріГрЅхрѕЁріЋ рІѕрІхрїђрІІрѕѕрѕЂ
РюЇ	рѕўрї╗рЇЇ, ріаріФрѕЇ, ріЦрІерї╗рЇѕ рІФрѕѕ ріЦрїЁ, ріЦрїЁ
­ЪЉЈ	рѕЏрїерЅЦрїерЅЦ, ріаріФрѕЇ, ріарїерЅЦрїФрЅб ріЦрїєрЅй, ріЦрїЁ
­ЪЉљ	ріаріФрѕЇ, ріЦрїЁ, ріГрЇЇрЅх, рІерЅ░ріерЇѕрЅ▒ рѕЂрѕѕрЅх ріЦрїєрЅй
­ЪЎї	ріЦрїЁ, ріЦрїєрЅ╣ріЋ рЅарЅЃ рЅЦрѕј рІФріљрѕ│ рѕ░рІЇ, ріерЇЇ рІФрІ░рѕерїѕ, ріГрЅЦрѕе рЅарІЊрѕЇ, рІеріЦрїЁ рѕЮрѕЇріГрЅх
­Ъц▓	рѕўрІ│рЇЇ ріаріЋрІх рѕІрІГ рІѕрІ░рѕІрІГ
­ЪЎЈ	рѕўрїарІерЅЁ, рѕўрїИрѕѕрІГ, рѕЮрѕхрїІріЊ, ріЦрїЁ, рІерЅ░рїБрѕўрѕе, рІеріЦрїЁ рѕўрІ│рЇјрЅ╣ріЋ рІФрїБрЅарЅђ рѕ░рІЇ
­ЪцЮ	рѕўрїерЅБрЅарїЦ, рѕхрѕЮрѕЮріљрЅх, рѕхрЅЦрѕ░рЅБ, ріЦрїЁ, ріЦрїЁ рѕўрїерЅБрЅарїЦ
­ЪњЁ	ріЦріЋріГрЅЦріФрЅц, рі«рѕхрѕърЅ▓ріГрѕх, рІерїБрЅх рІЇрЅарЅх рїЦрЅарЅЃ, рІерїЦрЇЇрѕГ рЅђрѕѕрѕЮ, рїЦрЇЇрѕГ
­ЪЉѓ	ріаріФрѕЇ, рїєрѕ«
­ЪЉЃ	ріаріФрѕЇ, ріарЇЇріЋрїФ
­ЪЉБ	ріарѕЇрЅБрѕ│рЅх, ріарѕ╗рѕФ, ріаріФрѕЇ, рІеріЦрїЇрѕГ рІ▒ріФ
­ЪЉђ	ріаріФрѕЇ, рІЊрІГріЋ, рІЊрІГріќрЅй, рЇірЅх
­ЪЉЂ	ріаріФрѕЇ, рІЊрІГріЋ
­ЪЉЂРђЇ­ЪЌе	рѕЮрѕхріГрѕГ, ріЋрїЇрїЇрѕГ, ріарІГріЋ, рІЊрІГріЋ рЅаріЋрїЇрїЇрѕГ ріарЇЅрЇІ
­ЪДа	ріаріЦрѕЮрѕ«
­Ъд┤	ріарїЦріЋрЅх, рІљрЇЁрѕЮ
­Ъди	рІерїЦрѕГрѕх рѕЃріфрѕЮ, рїЦрѕГрѕх
­ЪЉЁ	рѕЮрѕІрѕх, ріаріФрѕЇ
­ЪЉё	ріаріФрѕЇ, ріарЇЇ, ріеріЋрЇѕрѕ«рЅй
­Ъд░	рЅђрІГ рїИрїЅрѕГ, рїѓріЋрїђрѕГ
­Ъд▒	ріарЇЇрѕ«, рІерЅ░рїарЅђрѕѕрѕѕ, рІерЅ░рїарЅђрѕѕрѕѕ рїИрїЅрѕГ, рїЅріЋрїЅріЋ
­Ъд│	ріљрїГ, ріљрїГ рїИрїЅрѕГ, ріарѕ«рїї, рїѕрЅЦрѕхрѕЏ, рїИрїЅрѕГ
­Ъд▓	рѕўрѕІрїБ, рігрѕърЅ┤рѕФрЇњ, рІерЅ░рѕІрїе, рїИрїЅрѕГ рІерѕїрѕѕрІЇ
­ЪњІ	рѕўрѕ│рѕЮ, рѕЮрѕЇріГрЅх, ріеріЋрЇѕрѕ«рЅй, рІерѕўрѕ│рѕЮ рѕЮрѕЇріГрЅх
­Ъњў	рѕЇрЅЦ, рЅђрѕхрЅх, рЅђрѕхрЅх рІерѕ░ріљрїарЅђрІЇ рѕЇрЅЦ, рІерЅ░рѕ░ріљрїарЅђ, рЇЇрЅЁрѕГ
­ЪњЮ	рѕЇрЅЦ, рѕфрЅБріЋ, рЅарѕфрЅБріЋ рІерЅ│рѕ░рѕе рѕЇрЅЦ, рЅФрѕѕріЋрЅ│рІГріЋ
­Ъњќ	рѕЇрЅЦ, ріаріЋрїИрЅБрѕФрЅѓ, ріаріЋрїИрЅБрѕФрЅѓ рѕЇрЅЦ, рІерїЊрїЊ
­ЪњЌ	ріЦрІФрІ░рїѕ рІерѕџрѕёрІх рѕЇрЅЦ, рІерѕЇрЅЦ рѕЮрЅх, рІерѕџрІФрІхрїЇ, рІерїЊрїЊ, рІерЇѕрѕФ
­ЪњЊ	рѕЇрЅЦ, рѕўрѕЮрЅ│рЅх, ріЦрІерѕўрЅ│ рІФрѕѕ рѕЇрЅЦ, рІерѕЇрЅЦ рѕЮрЅх, рІерѕЇрЅЦ ріарѕўрЅ│рЅх
­Ъњъ	рѕЇрЅЦ, рІерѕџрѕИріерѕеріерѕГ, рІерѕџрѕйріерѕеріерѕЕ рѕЇрЅдрЅй
­ЪњЋ	рѕЂрѕѕрЅх рѕЇрЅдрЅй, рѕЇрЅЦ, рЇЇрЅЁрѕГ
­Ъњї	рѕЇрЅЦ, рІерЇЇрЅЁрѕГ рІ░рЅЦрІ│рЅц, рІ░рЅЦрІ│рЅц, рЇЇрЅЁрѕГ, рЇќрѕхрЅ│
РЮБ	рѕЇрЅЦ, рѕЮрѕЇріГрЅх, рѕЦрѕГрІЊрЅ░ ріљрїЦрЅЦ, рЅЃрѕѕ ріарїІріќ, рЅарѕЇрЅЦ рЅЁрѕГрЇЁ рІерЅ░рІўрїІрїђ рІерЅЃрѕѕ ріарїІріќ рѕЮрѕЇріГрЅх
­Ъњћ	рѕЇрЅЦ, рѕ░рЅарѕе, рІерЅ░рѕ░рЅарѕе, рІерЅ░рѕ░рЅарѕе рѕЇрЅЦ
РЮц	рѕЇрЅЦ, рЅђрІГ рѕЇрЅЦ
­ЪДА	рЅЦрѕГрЅ▒ріФріЊрѕЏ рѕЇрЅЦ
­ЪњЏ	рѕЇрЅЦ, рЅбрїФ, рЅбрїФ рѕЇрЅЦ
­Ъњџ	рѕЇрЅЦ, ріарѕеріЋрїЊрІ┤, ріарѕеріЋрїЊрІ┤ рѕЇрЅЦ
­ЪњЎ	рѕЇрЅЦ, рѕ░рѕЏрІФрІі, рѕ░рѕЏрІФрІі рѕЇрЅЦ
­Ъњю	рѕЇрЅЦ, рІѕрІГріЋ рїарїЁ, рІѕрІГріЋ рїарїЁ рѕЇрЅЦ
­Ъќц	рѕЇрЅЦ, рѕ░рІГрїБріЋ, ріЦрѕГрїЅрѕЮ, рїЦрЅЂрѕГ, рїЦрЅЂрѕГ рѕЇрЅЦ
­ЪњЪ	рѕЇрЅЦ, рІерѕЇрЅЦ рїїрїЦ
­Ъњц	ріарѕхрЅѓріЮ, ріЦріЋрЅЁрѕЇрЇЇ, рІЮ рІЮ рІЮ
­Ъњб	ріЋрІ┤рЅх, ріарѕхрЅѓріЮ, ріЦрЅЦрІх, рІеріЋрІ┤рЅх рѕЮрѕЇріГрЅх
­ЪњБ	рЅдрѕЮрЅЦ, ріарѕхрЅѓріЮ
­ЪњЦ	ріарѕхрЅѓріЮ, рїЇрїГрЅх
­Ъњд	рѕІрЅЦ, ріарѕхрЅѓріЮ, рІерІЇрѕЃ рѕўрѕерїерЅх, рїБрЇІрїГ рїарЅЦрЅ│рІјрЅй
­Ъње	рѕЕрїФ, рѕ░рѕГрІЮ, ріарѕхрЅѓріЮ, ріЦрІерЅдріљріљ рІФрѕѕ
­ЪњФ	ріарѕхрЅѓріЮ, рі«ріерЅЦ, рІхрЅЦрЅх
­Ъњг	ріЋрїЇрїЇрѕГ, ріарѕерЇІ, ріарѕхрЅѓріЮ, ріарЇЅрЇІ, рІѕрѕг, рІеріЋрїЇрїЇрѕГ ріарЇЅрЇІ
­ЪЌе	ріЋрїЇрїЇрѕГ, рІѕрѕг, рІерїЇрѕФ ріЋрїЇрїЇрѕГ ріарЇЅрЇІ
­ЪЌ»	ріЋрІ┤рЅх, ріарѕерЇІ, ріарЇЅрЇІ, ріЦрЅЦрІх, рІерЅђріЮ рІеріЋрІ┤рЅх ріарЇЅрЇІ
­ЪњГ	рѕљрѕ│рЅЦ, рѕљрѕ│рЅЦ рїѕрѕІрїГ ріарЇЅрЇІ, ріарѕерЇІ, ріарѕхрЅѓріЮ, ріарЇЅрЇІ
­ЪЋ│	рЅђрІ│рІ│
­ЪЉЊ	рѕўріљрїйрѕГ, ріарѕЇрЅБрѕ│рЅх, рІЊрІГріЋ, рІЊрІГріЋ рЅ░рѕѕрЅБрѕй, рІЊрІГріЋрѕўріљрїйрѕГ
­ЪЋХ	рѕўріљрїйрѕГ, рІЊрІГріЋ, рІЊрІГріЋ рЅ░рѕѕрЅБрѕй, рІерЇђрѕљрІГ рѕўріљрїйрѕГ, рїерѕѕрѕЏ
­ЪЦй	рѕўрЅарІерІх, рѕўрІІріўрЅх, рІерѕўрІІріЏ рѕўріљрїйрѕГ, рІеріарІГріЋ рѕўріерѕІріерІФ
­ЪЦ╝	рѕЎріерѕФ, рѕ│рІГріЋрЅ▓рѕхрЅх, рІерЅцрЅ░ рѕЎріерѕФ рЅцрЅх, рІХріГрЅ░рѕГ
­ЪЉћ	ріарѕЇрЅБрѕ│рЅх, ріерѕерЅБрЅх
­ЪЉЋ	рѕИрѕџрІЮ, рЅ▓рѕИрѕГрЅх, ріарѕЇрЅБрѕ│рЅх
­ЪЉќ	рѕ▒рѕф, ріарѕЇрЅБрѕ│рЅх, рїѓріЋрѕх
­ЪДБ	рѕхріФрѕГрЇЇ
­ЪДц	рїЊріЋрЅх
­ЪДЦ	рі«рЅх
­ЪДд	ріФрѕЇрѕ▓
­ЪЉЌ	рЅђрѕџрѕх, ріарѕЇрЅБрѕ│рЅх
­ЪЉў	ріарѕЇрЅБрѕ│рЅх, рІерїЃрЇЊріЋ рЅђрѕџрѕх
­ЪЉЎ	рЅбріфріњ, ріарѕЇрЅБрѕ│рЅх, рІІріЊ
­ЪЉџ	рѕ┤рЅх, ріарѕЇрЅБрѕ│рЅх, рІерѕ┤рЅх рѕЇрЅЦрѕх
­ЪЉЏ	рѕ│ріЋрЅ▓рѕЮ, ріарѕЇрЅБрѕ│рЅх, рІерѕ┤рЅх рІеріЦрїЁ рЅдрѕГрѕ│
­ЪЉю	рЅдрѕГрѕ│, ріарѕЇрЅБрѕ│рЅх, рІеріЦрїЁ рЅдрѕГрѕ│
­ЪЉЮ	рЅдрѕГрѕ│, ріарѕЇрЅБрѕ│рЅх, рІерѕ┤рЅх рЅдрѕГрѕ│
­ЪЏЇ	рѕєрЅ┤рѕЇ, рЅдрѕГрѕ│, рІерѕўрїѕрЅарІФрІФ рЅдрѕГрѕ│рІјрЅй, рїѕрЅарІФ рѕўрІЇрїБрЅх
­Ъјњ	рЅдрѕГрѕ│, рЅхрѕЮрѕЁрѕГрЅх рЅцрЅх, ріГрѕГрЅ│рѕх, рІерЅхрѕЮрѕЁрѕГрЅх рЅцрЅх рЅдрѕГрѕ│
­ЪЉъ	ріарѕЇрЅБрѕ│рЅх, рІѕріЋрІх, рІерІѕріЋрІх рїФрѕЏ, рїФрѕЏ
­ЪЉЪ	ріарѕЇрЅБрѕ│рЅх, ріарЅхрѕїрЅ│рІі, рІерѕЕрїФ рїФрѕЏ, рїФрѕЏ
­ЪЦЙ	ріФрѕЮрЇЋ, рІеріЦрїЇрѕГ рѕйрѕГрѕйрѕГ, рІеріЦрїЇрѕГ рѕйрѕГрѕйрѕГ рїФрѕЏ, рІерїђрѕГрЅБ рЅдрѕГрѕ│, рїФрѕЏ
­ЪЦ┐	рЅБрѕї рІ│ріЋрѕх, ріљрїарѕІ рїФрѕЏ, рїарѕѕрЅЁ ріарІ░рѕерїѕ, рїарЇЇрїБрЇІ рїФрѕЏ
­ЪЉа	рѕ┤рЅх, рЅБрѕѕ рЅ░рѕеріерІЮ рІерѕ┤рЅх рїФрѕЏ, рЅ░рѕеріерІЮ, ріарѕЇрЅБрѕ│рЅх, рїФрѕЏ
­ЪЉА	рѕ░ріЋрІ░рѕЇ, рѕ┤рЅх, ріарѕЇрЅБрѕ│рЅх, рІерѕ┤рЅх рѕ░ріЋрІ░рѕЇ рїФрѕЏ, рїФрѕЏ
­ЪЉб	рѕ┤рЅх, рЅАрЅхрѕх, ріарѕЇрЅБрѕ│рЅх, рІерѕ┤рЅх рЅАрЅхрѕх рїФрѕЏ, рїФрѕЏ
­ЪЉЉ	ріЋрїЅрѕЦ, ріЋрїЇрѕЦрЅх, ріарѕЇрЅБрѕ│рЅх, рІўрІЇрІх
­ЪЉњ	рѕ┤рЅх, ріарѕЇрЅБрѕ│рЅх, рі«рЇірІФ, рІерѕ┤рЅх рЅБрѕГріћрїБ
­ЪјЕ	рЅХрЇЋ рі«рЇірІФ, ріарѕЇрЅБрѕ│рЅх, ріерѕІрІГ рЅ░рѕѕрЅБрѕй, рі«рЇірІФ, рІерІѕріЋрІх рІерѕЎрѕЅ рѕЇрЅЦрѕх рЅБрѕГріћрїБ
­ЪјЊ	рѕЮрѕГрЅЃрЅх, ріарѕЇрЅБрѕ│рЅх, рігрЇЋ, ріГрЅЦрѕе рЅарІЊрѕЇ, рі«рЇірІФ, рІерѕЮрѕГрЅЃрЅх рі«рЇЇрІФ
­ЪДб	рІерЅ░ріерЇѕрѕѕрЅарЅх рЅБрѕГріћрїБ
РЏЉ	рѕўрѕхрЅђрѕЇ, рЅЦрѕерЅх рі«рЇЇрІФ, ріљрїГ рѕўрѕхрЅђрѕЇ рІФрѕѕрЅарЅх рЅЦрѕерЅх рі«рЇЇрІФ, ріЦрѕГрІ│рЅ│, рі«рЇірІФ
­ЪЊ┐	рѕўрЅЂрїИрѕфрІФ, ріЃрІГрѕЏріќрЅх, ріарѕЇрЅБрѕ│рЅх, рІеріаріЋрїѕрЅх рѕђрЅЦрѕЇ, рїерѕїрІјрЅй, рїИрѕјрЅх
­Ъњё	рѕўрІІрЅбрІФ, рѕюріГріарЇЋ, рІеріеріЋрЇѕрѕГ рЅђрѕѕрѕЮ
­ЪњЇ	ріарѕЇрѕЏрІЮ, рІерїБрЅх рЅђрѕѕрЅарЅх, рЇЇрЅЁрѕГ
­Ъњј	ріарѕЇрѕЏрІЮ, рїёрѕЮ, рїїрїЦ, рЇЇрЅЁрѕГ
­Ъљх	рІерїдрїБ рЇірЅх, рїдрїБ, рЇірЅх
­Ъљњ	рїдрїБ
­ЪдЇ	ріЦріЋрѕхрѕ│, рїЅрѕгрѕІ
­ЪљХ	рІЇрѕ╗, рІерЅцрЅх ріЦріЋрѕхрѕ│, рІерІЇрѕ╗ рЇірЅх, рЇірЅх
­ЪљЋ	рІЇрѕ╗, рІерЅцрЅх ріЦріЋрѕхрѕ│
­ЪљЕ	рІЇрѕ╗, рїИрїЅрѕФрѕЮ рЇЉрІхрѕЇ рІЇрѕ╗
­Ъљ║	рЅђрЅарѕ«, рІерЅ░ріЕрѕІ рЇірЅх, рЇірЅх
­Ъді	рЅђрЅарѕ«, ріЦріЋрѕхрѕ│, рІерЅђрЅарѕ« рЇірЅх, рЇірЅх
­ЪдЮ	рѕФріЕріЋ, рЅ░ріЋрі«рѕѕріЏ, рїЅрїЅ
­Ъљ▒	рІерЅцрЅх ріЦріЋрѕхрѕ│, рІерІхрѕўрЅх рЇірЅх, рІхрѕўрЅх, рЇірЅх
­Ъљѕ	рІерЅцрЅх ріЦріЋрѕхрѕ│, рІхрѕўрЅх
­ЪдЂ	рѕірІ«, ріаріЋрЅарѕ│, рІърІ▓рІФріГ, рІеріаріЋрЅарѕ│ рЇірЅх, рЇірЅх
­Ъљ»	ріљрЅЦрѕГ, рІеріљрЅЦрѕГ рЇірЅх, рЇірЅх
­ЪљЁ	ріљрЅЦрѕГ
­Ъљє	ріаріљрѕГ
­Ъљ┤	рІерЇѕрѕерѕх рЇірЅх, рЇѕрѕерѕх, рЇірЅх
­Ъљј	ріЦрѕйрЅЁрІхрѕЮрІхрѕЮ, рІеріЦрѕйрЅЁрІхрѕЮрІхрѕЮ рЇѕрѕерѕх, рЇѕрѕерѕх
­Ъдё	рЅБрѕѕ ріаріЋрІх рЅђріЋрІх рЇѕрѕерѕх, рЅБрѕѕ ріаріЋрІх рЅђріЋрІх рЇѕрѕерѕх рЇірЅх, рЇірЅх
­ЪдЊ	рІерѕюрІ│ ріарѕЁрІФ
­Ъдї	ріарїІрІўріЋ, ріЦріЋрѕхрѕ│
­Ъљ«	рѕІрѕЮ, рІерѕІрѕЮ рЇірЅх, рЇірЅх
­Ъљѓ	рЅарѕг, рЅ│рІЇрѕерѕх, рІърІ▓рІФріГ
­ЪљЃ	рІЇрѕЃ, рІерІЇрѕЃ ріарІЇрѕФрѕфрѕх, рїјрѕй
­Ъљё	рѕІрѕЮ
­Ъљи	рІЊрѕБрѕЏ, рІерІЊрѕБрѕЏ рЇірЅх, рЇірЅх
­Ъљќ	ріарѕГрІФ, рІЊрѕБрѕЏ
­ЪљЌ	рІЊрѕБрѕЏ, рІерїФріФ рІЊрѕБрѕЏ
­Ъљй	ріарЇЇріЋрїФ, рІЊрѕБрѕЏ, рІерІЊрѕБрѕЏ ріарЇЇріЋрїФ, рЇірЅх
­ЪљЈ	рѕЎріГрЅх рЅарїЇ, рЅарїЇ, ріцрѕфрѕх, рІърІ▓рІФріГ
­ЪљЉ	рѕ┤рЅх рЅарїЇ, рЅарїЇ
­Ъљљ	ріФрЇЋрѕфрі«рѕГріЋ, рІърІ▓рІФріГ, рЇЇрІерѕЇ
­Ъљф	рѕ╗ріЏ, рїЇрѕўрѕЇ
­ЪљФ	рѕ╗ріЏ, рЅБрѕѕрѕЂрѕѕрЅх рѕ╗ріЏ рїЇрѕўрѕЇ, рЅБріГрЅхрѕгріЋ, рїЇрѕўрѕЇ
­ЪдЎ	рѕІрѕЏ, рѕ▒рЇЇ, рЅфріЕріЊ, рїЇрѕўрѕЇ
­Ъдњ	рЅђрїГріћ
­Ъљў	рІЮрѕєріЋ
­ЪдЈ	ріарІЇрѕФрѕфрѕх, ріЦріЋрѕхрѕ│
­ЪдЏ	рїЅрѕЏрѕг, рїјрѕЏрѕг
­ЪљГ	ріарІГрїЦ, рІеріарІГрїЦ рЇірЅх, рЇірЅх
­ЪљЂ	ріарІГрїЦ
­Ъљђ	ріарІГрїарѕърїјрїЦ
­Ъљ╣	рѕџрїбрїб ріарІГрїЦ, рѕџрїбрїб ріарІГрїЦ рЇірЅх, рІерЅцрЅх ріЦріЋрѕхрѕ│, рЇірЅх
­Ъљ░	рЅБріњ, рІерЅцрЅх ріЦріЋрѕхрѕ│, рІерїЦріЋрЅИрѕЇ рЇірЅх, рїЦріЋрЅИрѕЇ, рЇірЅх
­ЪљЄ	рЅБріњ, рІерЅцрЅх ріЦріЋрѕхрѕ│, рїЦріЋрЅИрѕЇ
­Ъљ┐	рЅ║рЇЋрѕўріЋріГ
­Ъдћ	ріарїЦрЅб ріЦріЋрѕхрѕ│
­ЪдЄ	ріарѕхрЇѕрѕф, ріЦріЋрѕхрѕ│, рІерѕїрѕірЅх рІѕрЇЇ
­Ъљ╗	рІерІхрЅЦ рЇірЅх, рІхрЅЦ, рЇірЅх
­Ъље	ріФрідрѕІ, рІхрЅЦ
­Ъљ╝	рІерЇЊріЋрІ│ рЇірЅх, рЇірЅх, рЇЊріЋрІ│
­Ъдў	рѕўрІЮрѕѕрѕЇ, ріарІЇрѕхрЅхрѕФрѕірІФ, ріфрѕ┤, ріФріЋрїІрѕ«, рІ░рѕхрЅ│
­ЪдА	рІЇрѕ╗ рІерѕџрѕўрѕхрѕЇ ріЦріЋрѕ░рѕ│, рїЦрѕГріЮ
­ЪљЙ	ріарѕ╗рѕФ, ріЦрїЇрѕГ, рІеріЦріЋрѕ│рѕ│ рѕўрІ│рЇЇ рІ▒ріФрІјрЅй, рІеріЦріЋрѕхрѕ│ рѕўрІ│рЇЇ
­ЪдЃ	рЅєрЅЁ, рІѕрЇЇ
­Ъљћ	рѕ┤рЅх рІХрѕ«, рІХрѕ«
­ЪљЊ	ріарІЇрѕФ рІХрѕ«, рІѕрЇЇ
­ЪљБ	рѕЋрЇЃріЋ, рѕўрЇѕрѕЇрЇѕрѕЇ, ріеріЦріЋрЅЂрѕІрѕЇ рЅ░рЇѕрѕЇрЇЇрѕІ рІерѕЮрЅхрІѕрїБ рїФрїЕрЅх, рїФрїЕрЅх
­Ъљц	рѕЋрЇЃріЋ, рѕџрїбрїб рїФрїЕрЅх, рїФрїЕрЅх
­ЪљЦ	рѕЋрЇЃріЋ, рїФрїЕрЅх, рЇірЅх рѕѕрЇірЅх рІерѕЮрЅхрЅ│рІГ рѕџрїбрїб рїФрїЕрЅх
­Ъљд	рІѕрЇЇ
­ЪљД	рЇћріЋрїЇрІіріЋ
­ЪЋі	рѕ░рѕІрѕЮ, рЅЦрѕерѕГ, ріЦрѕГрїЇрЅЦ, рІѕрЇЇ
­ЪдЁ	ріЋрѕхрѕГ ріарѕърѕФ, рІѕрЇЇ
­Ъдє	рІѕрЇЇ, рІ│ріГрІг
­Ъдб	рЅхріЋрѕй рІЮрІг, ріарѕхрЅђрІФрѕџ рІ│ріГрІг, рІѕрЇЇ, рІерІЇрѕђ рІХрѕ«
­ЪдЅ	ріарІІрЅѓ, рІѕрЇЇ, рїЅрїЅрЅх
­Ъдџ	ріЕрѕФрЅх, рІѕрЇЇ, рІерѕџрѕўріФ, рЇњрі«ріГ
­Ъдю	рЅђрЇЇ, рЅарЅђрЅђріЋ, ріЋрїЇрїЇрѕГ, рїарѕІрЇі
­ЪљИ	ріЦріЋрЅЂрѕФрѕфрЅх, рІеріЦріЋрЅЂрѕФрѕфрЅх рЇірЅх, рЇірЅх
­Ъљі	ріарІъ
­Ъљб	ріцрѕі
­Ъдј	рЅарІ░рѕерЅ│рЅИрІЇ рІерѕџрѕ│рЅА ріЦріЋрѕхрѕ│рЅх, ріЦріЋрѕйрѕІрѕірЅх
­ЪљЇ	рЅ░рѕИріФрѕџ, ріЦрЅБрЅЦ, рідрЇірІЕріерѕх, рІърІ▓рІФріГ
­Ъљ▓	рЅ░рѕерЅх рЅ░рѕерЅх, рІўріЋрІХ, рІерІхрѕФрїјріЋ рЇірЅх, рЇірЅх
­ЪљЅ	рЅ░рѕерЅх рЅ░рѕерЅх, рІхрѕФрїјріЋ
­ЪдЋ	рІ│рІГріќрѕ░рѕГ
­Ъдќ	рЅ│рІГріќрѕ│рѕерѕх, рЅ│рІГріќрѕ│рѕерѕх рІ│рІГріќрѕ░рѕГ
­Ъљ│	рІЇрѕЃ рІерѕџрІФріЋрЅдрїФрѕГрЅЁ, рІЇрѕЃ рІерѕџрІФріЋрЅдрїФрѕГрЅЁ рІЊрѕБ ріљрЅБрѕф, рІЊрѕБ ріљрЅБрѕф, рЇірЅх
­ЪљІ	ріарѕБ ріљрЅБрѕф
­Ъљг	рІХрѕЇрЇіріЋ, рЇЇрѕірЇљрѕГ
­ЪљЪ	рІЊрѕБ, рІърІ▓рІФріГ, рЇќрІГрѕ▓рѕх
­Ъља	рІЊрѕБ, рІерѕЮрІхрѕГ рІѕрїѕрЅЦ ріаріФрЅБрЅб, рІерѕЮрІхрѕГ рІѕрїѕрЅЦ ріаріФрЅБрЅб рІЊрѕБ
­ЪљА	рЅЦрѕјрІЇрЇірѕй, рІЊрѕБ
­Ъдѕ	рѕ╗рѕГріГ, ріарѕБ
­ЪљЎ	рідріГрЅХрЇљрѕх
­Ъљџ	рѕ║рѕЇ, рѕйрЅЦрѕЇрѕЇ рІерЅђріЋрІх ріарІЇрїБ рѕ╝рѕЇ, рїЦрЅЁрѕЇрѕЇ
­Ъдђ	рѕИрѕГрїБріЋ, ріФріЋрѕ░рѕГ, рІърІ▓рІФріГ
­Ъдъ	рѕјрЅЦрѕхрЅ░рѕГ, рѕЏрїЅрѕГрїЦ, рЅбрѕхріГ, рІерЅБрѕЁрѕГ рѕЮрїЇрЅдрЅй
­Ъдљ	рѕЮрїЇрЅЦ, рЅхріЋрѕй, рЅхріЋрѕй ріарѕБ, рїаріЋріФрѕФ рѕйрЇІріЋ рІФрѕѕрІЇ ріарѕБ
­ЪдЉ	рѕЮрїЇрЅЦ, рѕърѕЅрѕхріГ, рѕхріГрІірІх
­Ъљї	рЅђріЋрІх ріарІЇрїБ
­ЪдІ	рЅєріЋрїє, рЅбрѕФрЅбрѕ«, ріљрЇЇрѕ│рЅх
­ЪљЏ	рЅхріІріЋ, ріљрЇЇрѕ│рЅх
­Ъљю	ріљрЇЇрѕ│рЅх, рїЅріЋрІ│ріЋ
­ЪљЮ	рЅхріЋріЮ, ріЋрЅЦ
­Ъљъ	рѕїрІ▓рЅарѕГрІх, рѕїрІ▓рЅБрїЇ, рѕ┤рЅх рїбріЋрІџрІЏ, ріљрЇЇрѕ│рЅх, рїбріЋрІџрІЏ
­ЪдЌ	ріГрѕфрігрЅх
­ЪЋи	ріљрЇЇрѕ│рЅх, ріЦріЋрѕИрѕерѕфрЅх
­ЪЋИ	ріЦріЋрѕИрѕерѕфрЅх, рІеріЦріЋрѕИрѕерѕфрЅх рІхрѕГ, рІхрѕГ
­Ъдѓ	рѕхрі«рѕГрЇњрІерѕх, рѕхрі«рѕГрЇњрІ«, рІърІ▓рІФріГ, рїіріЋрїЦ
­ЪдЪ	рЅарѕйрЅ│, рЅФрІГрѕерѕх, рЅхріЕрѕ│рЅх, ріљрЇЇрѕ│рЅх, рІѕрЅБ
­Ъда	рЅБріГрЅ┤рѕфрІФ, рЅФрІГрѕерѕх, рЅ░рѕЁрІІрѕ│рЅх, ріарѕюрЅБ
­Ъњљ	рЅ░ріГрѕЇ, ріарЅарЅБ, ріЦрЅЁрЇЇ ріарЅарЅБ, рЇЇрЅЁрѕГ
­ЪїИ	рЅ░ріГрѕЇ, рЅ╝рѕф, ріарЅарЅБ, рІерѕџрЇѕріФ, рІерѕџрЇѕріФ рЅ╝рѕф ріарЅарЅБ
­Ъњ«	ріљрїГ ріарЅарЅБ, ріарЅарЅБ
­ЪЈх	рѕ«рІюрЅх, рЅ░ріГрѕЇ
­Ъї╣	рЅ░ріГрѕЇ, ріарЅарЅБ, рїйрїїрѕгрІ│
­ЪЦђ	рѕўрїарІЇрѕѕрїЇ, ріарЅарЅБ, рІерїарІѕрѕѕрїѕ ріарЅарЅБ
­Ъї║	рѕѓрЅбрѕхріерѕх ріарЅарЅБ, рЅ░ріГрѕЇ, ріарЅарЅБ
­Ъї╗	рЅ░ріГрѕЇ, ріарЅарЅБ, рІерѕ▒рЇЇ ріарЅарЅБ, рЇђрѕљрІГ
­Ъї╝	рЅ░ріГрѕЇ, ріарЅарЅБ, рІеріарЅарЅБ рЇЇріФрЅх
­Ъїи	рЅ░ріГрѕЇ, рЅ▒рѕірЇЋ ріарЅарЅБ, ріарЅарЅБ
­Ъї▒	рЅ░ріГрѕЇ, рЅйрїЇріЮ, ріарЇЇрѕІ
­Ъї▓	рѕЂрѕїрѕЮ ріарѕеріЋрїЊрІ┤, рЅ░ріГрѕЇ, рІЏрЇЇ
­Ъї│	рЅБрѕѕ рїЦрѕІ рЅ░ріГрѕЇ, рЅБрѕѕрїЦрѕІ рІЏрЇЇ, рІЏрЇЇ, рїЦрѕІ
­Ъї┤	рЅ░ріГрѕЇ, рІўріЋрЅБрЅБ, рІЏрЇЇ
­Ъїх	рЅЂрѕЇрЅІрѕЇ, рЅ░ріГрѕЇ
­ЪїЙ	рѕЕрІЮ, рЅ░ріГрѕЇ, рІерѕЕрІЮ рЅ░ріГрѕЇ рІърѕІ, рїєрѕ«
­Ъї┐	рЅЁрїарѕЇ, рЅ░ріГрѕЇ
Рўў	рѕ╗рѕЮрѕ«ріГ рЅЁрїарѕЇ, рЅ░ріГрѕЇ
­ЪЇђ	4, рЅЁрїарѕЇ, рЅ░ріГрѕЇ, ріарѕФрЅх, рІхріЋрЅЦрѕІрѕЇ
­ЪЇЂ	рѕЏрЇЋрѕЇ, рѕЏрЇЋрѕЇ рЅЁрїарѕЇ, рЅЁрїарѕЇ, рЅ░ріГрѕЇ, рІерѕџрІѕрІхрЅЁ
­ЪЇѓ	рЅЁрїарѕЇ, рЅ░ріГрѕЇ, рІерѕџрІѕрІхрЅЁ, рІерѕерїѕрЇѕ рЅЁрїарѕЇ
­ЪЇЃ	рЅЁрїарѕЇ, рЅаріарІерѕГ рѕІрІГ рІерѕџріЋрѕ│рЇѕрЇЅ рЅЁрїарѕјрЅй, рЅ░ріЋрѕ│рЇІрЇі, рЅ░ріГрѕЇ, ріљрЇІрѕх
­ЪЇЄ	рЅ░ріГрѕЇ, рІѕрІГріЋ, рІерІѕрІГріЋ рІЏрѕІрІјрЅй, рЇЇрѕФрЇЇрѕг
­ЪЇѕ	рѕєрѕЮрїБрїц, рЅ░ріГрѕЇ, рЇЇрѕФрЇЇрѕг
­ЪЇЅ	рѕљрЅЦрѕљрЅЦ, рЅ░ріГрѕЇ, рЇЇрѕФрЇЇрѕг
­ЪЇі	рѕўріЋрІ░рѕфріЋ, рЅЦрѕГрЅхрі│ріЊрѕЏ, рЅ░ріГрѕЇ, рЇЇрѕФрЇЇрѕг
­ЪЇІ	рѕјрѕџ, рЅ░ріГрѕЇ, рЇЇрѕФрЇЇрѕг
­ЪЇї	рѕЎрІЮ, рЅ░ріГрѕЇ, рЇЇрѕФрЇЇрѕг
­ЪЇЇ	рЅ░ріГрѕЇ, ріаріЊріЊрѕх, рЇЇрѕФрЇЇрѕг
­ЪЦГ	рѕЏріЋрїј, рІѕрІГріЊрІ░рїІ, рЇЇрѕФрЇЇрѕг
­ЪЇј	рЅђрІГ, рЅђрІГ ріарЇЋрѕЇ, рЅ░ріГрѕЇ, рЅ▒рЇІрѕЋ, рЇЇрѕФрЇЇрѕг
­ЪЇЈ	рЅ░ріГрѕЇ, рЅ▒рЇІрѕЋ, ріарѕеріЋрїЊрІ┤, ріарѕеріЋрїЊрІ┤ ріарЇЋрѕЇ, рЇЇрѕФрЇЇрѕг
­ЪЇљ	рЅ░ріГрѕЇ, рЇЇрѕФрЇЇрѕг, рЇќрѕЮ
­ЪЇЉ	рЅ░ріГрѕЇ, рі«ріГ, рЇЇрѕФрЇЇрѕг
­ЪЇњ	рЅ░ріГрѕЇ, рЅ╝рѕф, рЅ╝рѕф рЇЇрѕг, рЇЇрѕФрЇЇрѕг
­ЪЇЊ	рЅ░ріГрѕЇ, ріЦріЋрїєрѕф, рЇЇрѕФрЇЇрѕг
­ЪЦЮ	рѕЮрїЇрЅЦ, ріфрІі, ріфрІі рЇЇрѕФрЇЇрѕг, рЇЇрѕФрЇЇрѕг
­ЪЇЁ	рЅ░ріГрѕЇ, рЅ▓рѕЏрЅ▓рѕЮ, ріарЅ│ріГрѕЇрЅх
­ЪЦЦ	рі«рі«ріЊрЅх
­ЪЦЉ	рѕЮрїЇрЅЦ, ріарЅдріФрІХ, рЇЇрѕФрЇЇрѕг
­ЪЇє	рЅ░ріГрѕЇ, ріарЅ│ріГрѕЇрЅх, ріАрЅарѕГрїѓріЋ, ріцрїЇрЇЋрѕІріЋрЅх рЇЇрѕг
­ЪЦћ	рѕЮрїЇрЅЦ, ріарЅхріГрѕЇрЅх, рІхріЋрЅй
­ЪЦЋ	рѕЮрїЇрЅЦ, ріарЅхріГрѕЇрЅх, ріФрѕ«рЅх
­Ъїй	рЅарЅєрѕј, рЅ░ріГрѕЇ, рІерЅарЅєрѕј рІЏрѕІ, рїєрѕ«
­ЪїХ	рѕџрїЦрѕџрїБ, рЅ░ріГрѕЇ, рІерѕџрІФрЅЃрїЦрѕЇ, рІерѕџрїЦрѕџрїБ рЅЃрѕфрІФ
­ЪЦњ	рѕЮрїЇрЅЦ, ріарЅхріГрѕЇрЅх, рІ▒рЅБ, рЇњріГрѕЇ
­ЪЦг	рѕ░рѕІрїБ, рЅЁрїарѕІ рЅЁрїарѕЇ, ріарѕюрѕ│, рІерЅ╗рІГріЊ рѕ░рѕІрїБ, рїЦрЅЁрѕЇ рїјрѕўріЋ
­ЪЦд	рЅЦрѕ«рі«рѕі
­ЪЇё	рЅ░ріГрѕЇ, ріЦріЋрїЅрІ│рІГ
­ЪЦю	рѕЮрїЇрЅЦ, ріљрЅх, ріарЅхріГрѕЇрЅх, рідрЅЙрѕјріњ
­Ъї░	рЅ░ріГрѕЇ, рІерѕѕрІЇрІЮ рЇЇрѕг
­ЪЇъ	рІерІ│рЅд рЅЂрѕФрѕй, рІ│рЅд
­ЪЦљ	рѕЮрїЇрЅЦ, ріГрѕгрѕ░ріЋрЅх, ріГрѕгрѕ░ріЋрЅх рѕЎрѕЇрѕЎрѕЇ, рІерЇѕрѕеріЋрѕ│рІГ, рІ│рЅд
­ЪЦќ	рѕЮрїЇрЅЦ, рЅБріГрІїрЅх, рІерЇѕрѕеріЋрѕ│рІГ рІ│рЅд, рІ│рЅд, рЇѕрѕеріЋрѕ│рІГ
­ЪЦе	рІ░рѕерЅЁ рЅЦрѕхріЕрЅх
­ЪЦ»	рѕўрїІрїѕрѕфрІФ, рІерѕџрїѕрЇІрЇІ ріљрїѕрѕГ, рїБрЇІрїГ рІ│рЅд
­ЪЦъ	рѕЮрїЇрЅЦ, рЅхріЕрѕх рігріГ, ріГрѕгрЇЋ, рЇЊріЋрігріГ
­ЪДђ	рІерЅ║рІЮ рЅЂрѕФрїГ, рЇњрІЮ
­ЪЇќ	рѕЦрїІ, рѕЦрїІ рІерѕѕрІЇ ріарїЦріЋрЅх, рѕЦрїІ рІФрѕѕрІЇ ріарїЦріЋрЅх
­ЪЇЌ	рѕЦрїІ рІерѕѕрІЇ ріарїЦріЋрЅх, рѕ┤рЅх рІХрѕ«, ріЦрїЇрѕГ, рІерІХрѕ« ріЦрѕГрЅБрЅ│, рІерІХрѕ« ріЦрїЇрѕГ
­ЪЦЕ	рЅЂрѕФрїГ рѕхрїІ
­ЪЦЊ	рѕЮрїЇрЅЦ, рѕхрїІ, рЅцріеріЋ
­ЪЇћ	рѕЃрѕЮрЅарѕГрїѕрѕГ, рЅарѕГрїѕрѕГ
­ЪЇЪ	рІерЇѕрѕеріЋрѕ│рІГ, рЇЇрѕФрІГрѕх, рЇЇрѕгріЋрЅй рЇЇрѕФрІГрѕх
­ЪЇЋ	рЅЂрѕФрѕй, рЅ║рІЮ, рЇњрІЏ
­ЪїГ	рѕЃрЅх рІХрїЇ, рѕЃрЅхрІХрїЇ, рЅІрѕірѕЏ, рЇІрѕФріЋріГрЇЅрЅ░рѕГ
­ЪЦф	рѕ│ріЋрІхрІірЅй
­Ъї«	рЅ│рі«, рІерѕюріГрѕ▓рі«
­Ъї»	рЅАрѕфрЅХ, рІерѕюріГрѕ▓рі«
­ЪЦЎ	рѕЮрїЇрЅЦ, рЅарѕЮрїЇрЅЦ рІерЅ░рѕърѕІ рІ│рЅд, ріерЅБрЅЦ, рІерЅ░рѕърѕІ, рїЁрІГрѕ«
­ЪЦџ	рѕЮрїЇрЅЦ, ріЦріЋрЅЂрѕІрѕЇ
­ЪЇ│	рѕўрїЦрЅарѕ╗, рѕЏрЅЦрѕ░рѕЇ, рѕЮрїЇрЅЦ рѕЏрЅЦрѕ░рѕЇ, ріЦріЋрЅЂрѕІрѕЇ
­ЪЦў	рѕЮрїЇрЅЦ, рѕ│рѕЁріЋ, рІерѕЮрїЇрЅЦ рѕЏрЅЁрѕерЅбрІФ, рїјрІхрїЊрІ│, рїјрІхрїЊрІ│ рѕ│рѕЁріЋ рѕѕрѕЮрїЇрЅЦ
­ЪЇ▓	рѕЮріЋрЅИрЅх, рЅЁрЅЁрѕЇ, рІерѕЮрїЇрЅЦ рѕ│рѕЋріЋ
­ЪЦБ	рѕ│рѕЁріЋ рѕЎрѕЅ рѕЏріЋріфрІФ
­ЪЦЌ	рѕЮрїЇрЅЦ, рѕ░рѕІрїБ, ріарѕеріЋрїЊрІ┤, ріарѕеріЋрїЊрІ┤ рѕ░рѕІрїБ
­ЪЇ┐	рЇѕріЋрІхрѕ╗
­ЪДѓ	рѕўрІѕрІЮрІѕрІБ, рЅЁрѕўрѕЮ, рїерІЇ
­ЪЦФ	рІерЅ│рѕИрїѕ рѕЮрїЇрЅЦ
­ЪЇ▒	рѕБрїЦріЋ, рЅцріЋрЅХ, рЅцріЋрЅХ рЅдріГрѕх
­ЪЇў	рѕЕрІЮ, рЅЦрѕхріЕрЅх, рІерѕЕрІЮ рЅЦрѕхріЕрЅх
­ЪЇЎ	рѕЕрІЮ, рі│рѕх, рІерѕЕрІЮ рі│рѕх, рІерїЃрЇЊріЋ
­ЪЇџ	рѕЕрІЮ, рІерЅарѕ░рѕѕ, рІерЅ░рЅђрЅђрѕѕ рѕЕрІЮ
­ЪЇЏ	рѕЕрІЮ, ріерѕф, ріерѕф рѕЕрІЮ
­ЪЇю	рѕЏрїЦрѕѕрѕЇ, рѕЏрїЦрѕѕрІФ рїјрІхрїЊрІ│ рѕ│рѕЋріЋ, рѕ╝рЇЋрІіріЋ, ріЉрІхрѕЇ, рїјрІхрїЊрІ│ рѕ│рѕЋріЋ
­ЪЇЮ	рѕхрЇЊрїїрЅ▓, рЇќрѕхрЅ│
­ЪЇа	рІерЅ░рїарЅарѕ░, рІерЅ░рїарЅарѕ░ рѕхрі│рѕГ рІхріЋрЅй, рІхріЋрЅй, рїБрЇІрїГ
­ЪЇб	рѕхрЅ▓ріГ, рѕхрігрІѕрѕГ, рідрІ┤ріЋ, ріГрЅБрЅЦ, рІерЅБрѕЋрѕГ рѕЮрїЇрЅЦ
­ЪЇБ	рѕ▒рѕ║
­ЪЇц	рѕйрѕфрѕЮрЇЋ, рЅ┤рѕЮрЇЉрѕФ, рІерЅ░рїарЅарѕ░, рІерЅ░рїарЅарѕ░ рѕйрѕфрѕЮрЇЋ рІЊрѕБ, рЇЋрѕФрІЇріЋ
­ЪЇЦ	рігріГ, рігріГріЊ рЅЦрѕхріЕрЅх, рІЊрѕБ, рІерЅ░рѕИрѕеріФріерЇѕ, рІерІЊрѕБ рігріГ ріерЅ░рѕИрѕеріФріерЇѕ ріГрЇѕрЇЇ рїІрѕГ
­ЪЦ«	рѕўріерѕГ, рЅарІЊрѕЇ, рІерїерѕерЅЃ рігріГ
­ЪЇА	рѕхрЅ▓ріГ, рѕхрігрІѕрѕГ, рІерїЃрЇЊріЋ, рІ│ріЋрїј, рїБрЇІрїГ
­ЪЦЪ	рЇЇрѕФрЇЇрѕг
­ЪЦа	рЇјрѕГрЅ╣ріЋ ріЕріф
­ЪЦА	рѕЮрїЇрЅЦ рѕўрІЇрѕ░рїЃ ріЦрЅЃ
­ЪЇд	рѕѕрѕхрѕІрѕ│, рЅђрѕІрѕЇ ріарІГрѕхріГрѕгрѕЮ, рЅарѕерІХ, ріарІГрѕхріГрѕгрѕЮ, ріГрѕгрѕЮ, рїБрЇІрїГ
­ЪЇД	ріарІГрѕх, рІерЅ░рѕИрѕѕрЅ░, рІерЅ░рѕИрѕѕрЅ░ ріарІГрѕхріГрѕгрѕЮ, рїБрЇІрїГ, рїБрЇІрїГ рѕЮрїЇрЅЦ
­ЪЇе	ріарІГрѕх, ріарІГрѕхріГрѕгрѕЮ, ріГрѕгрѕЮ, рїБрЇІрїГ, рїБрЇІрїГ рѕЮрїЇрЅЦ
­ЪЇЕ	рІХріЊрЅх, рїБрЇІрїГ, рїБрЇІрїГ рѕЮрїЇрЅЦ
­ЪЇф	ріЕріфрѕх, рїБрЇІрїГ, рїБрЇІрїГ рѕЮрїЇрЅЦ
­Ъјѓ	рігріГ, ріГрЅЦрѕе рЅарІЊрѕЇ, рІерѕЇрІ░рЅх рЅђріЋ, рІерѕЇрІ░рЅх рігріГ, рїБрЇІрїГ
­ЪЇ░	рЅЂрѕФрѕй, рігріГ, рігріГріЊ рЅЦрѕхріЕрЅх, рІерѕЇрІ░рЅх рігріГ рЅЂрѕФрѕй, рїБрЇІрїГ, рїБрЇІрїГ рѕЮрїЇрЅЦ
­ЪДЂ	рѕўрїІрїѕрѕфрІФ, рІеріЕрЅБрІФ рігріГ, рїБрЇІрїГ
­ЪЦД	рЇЊрІГ
­ЪЇФ	рЅИрі«рѕІрЅ│, рЅИрі«рѕІрЅх, ріарѕърѕї, рїБрЇІрїГ, рїБрЇІрїГ рѕЮрїЇрЅЦ
­ЪЇг	ріерѕерѕюрѕІ, рїБрЇІрїГ, рїБрЇІрїГ рѕЮрїЇрЅЦ
­ЪЇГ	рѕјрѕірЇќрЇЋ ріерѕерѕюрѕІ, ріерѕерѕюрѕІ, рїБрЇІрїГ, рїБрЇІрїГ рѕЮрїЇрЅЦ
­ЪЇ«	ріФрѕхрЅ│рѕГрІх рігріГ, рїБрЇІрїГ, рїБрЇІрїГ рѕЮрїЇрЅЦ, рЇЉрІ▓ріЋрїЇ
­ЪЇ»	рѕЏрѕГ, рѕЏрѕ░рѕ«, рІерѕЏрѕГ рѕЏрѕ░рѕ«, рїБрЇІрїГ
­ЪЇ╝	рѕЋрЇЃріЋ, рІѕрЅ░рЅх, рІерѕЁрї╗ріЋ рїАрїд, рїарѕГрѕЎрѕх, рїарїБ
­ЪЦЏ	рѕўрїарїБрЅх, рЅЦрѕГрїГрЅє, рІѕрЅ░рЅх, рІерІѕрЅ░рЅх рЅЦрѕГрїГрЅє
РўЋ	рѕЏрїЦрѕѕрѕЇ, рѕ╗рІГ, рЅАріЊ, рЅхріЕрѕх, рІерѕџрїарїБ рЅхріЕрѕх ріљрїѕрѕГ
­ЪЇх	рѕЏріЋрїарѕЇрїарІФ рІерѕїрѕѕрІЇ рІерѕ╗рІГ рѕхріњ, рѕхріњ, рѕ╗рІГ, рІерѕџрїарїБ ріљрїѕрѕГ, рІерѕ╗рІГ рѕхріњ
­ЪЇХ	рѕЏрѕ░рѕ«, рѕхріњ, ріарѕърѕї, рІерѕџрїарїБ ріљрїѕрѕГ, рїарѕГрѕЎрѕх
­ЪЇЙ	ріарѕърѕї, рі«рѕГріф, рїарѕГрѕЎрѕх, рїарѕГрѕЎрѕх ріеріљрѕўріГрЇѕрЅ╗рІЇ, рїарїБ
­ЪЇи	рѕўріљрїйрѕГ, рІѕрІГріЋ, рІерѕџрїарїБ ріљрїѕрѕГ, рІерІѕрІГріЋ рЅЦрѕГрїГрЅє, рїарїБ
­ЪЇИ	рѕўріљрїйрѕГ, ріарѕърѕї, рі«ріГрЅ┤рѕЇ, рІері«ріГрЅ┤рѕЇ рЅЦрѕГрїГрЅє, рїарїБ
­ЪЇ╣	рЅхрѕ«рЇњріФрѕЇ, рЅхрѕ«рЇњріФрѕЇ рѕўрїарїЦ, ріарѕърѕї, рїарїБ
­ЪЇ║	рЅбрѕФ, ріарѕърѕї, ріЕрЅБрІФ, рІерІхрѕФрЇЇрЅх рЅЦрѕГрїГрЅє, рїарїБ
­ЪЇ╗	рЅбрѕФ, ріарѕърѕї, ріЕрЅБрІФ, ріГрѕіріЋріГ, рІерѕџрїІрїЕ рІерІхрѕФрЇЇрЅх рЅЦрѕГрїГрЅєрІјрЅй
­ЪЦѓ	рѕўрїарїБрЅх, рѕЏріЋрЅЃрїерѕЇ, рѕЏріГрЅарѕГ, рЅЦрѕГрїГрЅє, рІерЅЦрѕГрїГрЅє рѕЏріЋрЅЃрїерѕЇ
­ЪЦЃ	рѕўрѕѕріфрІФ, рѕўрїарїЦ, рЅЦрѕГрїГрЅє, ріарѕЇрі«рѕЇ, рІЇрѕхріф, рІерѕўрїарїЦ рЅЦрѕГрїГрЅє
­ЪЦц	рЅЦрѕГрїГрЅє ріерѕўрїарїФ рїІрѕГ
­ЪЦб	рЅЙрЇЋрѕхрЅ▓ріГ
­ЪЇй	рѕЏріЋріфрІФ ріЦріЊ рѕ╣ріФ ріерѕ│рѕЋріЋ рїІрѕГ, рѕЮрїЇрЅЦ рѕЏрЅЦрѕ░рѕЇ, рѕ│рѕЋріЋ, рѕ╣ріФ, рЅбрѕІрІІ
­ЪЇ┤	рѕЮрїЇрЅЦ рѕЏрЅЦрѕ░рѕЇ/рЅбрѕѕрІІ/рѕ╣ріФ/рѕ╣ріФріЊ рЅбрѕѕрІІ/рЅбрѕѕрІІ, рѕ╣ріФріЊ рЅбрѕѕрІІ
­ЪЦё	рѕЏріЋріфрІФ, рІерЅцрЅх рІЋрЅЃрІјрЅй
­Ъћф	рѕєрЅЙ, рѕЮрїЇрЅЦ рѕЏрЅЦрѕ░рѕЇ, рЅбрѕІрІІ, рІерІѕрїЦ рЅцрЅх рЅбрѕІрІІ, рїдрѕГ рѕўрѕБрѕфрІФ
­ЪЈ║	рѕўрїарїБрЅх, рѕЏрѕ░рѕ«, рѕЮрїЇрЅЦ рѕЏрЅЦрѕ░рѕЇ, ріарѕЮрЇјрѕФ рѕЏрѕ░рѕ«, ріарі│рІГрѕерѕх, рїєрїЇ
­ЪїЇ	рѕЅрѕЇ, рѕўрѕгрЅх, ріарІЇрѕ«рї│, ріарІЇрѕ«рЇЊріЊ ріарЇЇрѕфріФ рІерѕџрІФрѕ│рІГ рѕЅрѕЇ, ріарЇЇрѕфріФ
­Ъїј	рѕЅрѕЇ, рѕўрѕгрЅх, рѕ░рѕюріЋріЊ рІ░рЅАрЅЦ ріарѕюрѕфріФ, рѕ░рѕюріЋріЊ рІ░рЅАрЅЦ ріарѕюрѕфріФ рІерѕџрІФрѕ│рІГ рѕЅрѕЇ, рІЊрѕѕрѕЮ
­ЪїЈ	рѕЅрѕЇ, рѕўрѕгрЅх, ріарІЇрѕхрЅхрѕФрѕірІФ, ріЦрѕхрІФ, ріЦрѕхрІФріЊ ріарІЇрѕхрЅхрѕФрѕірІФ рІерѕџрІФрѕ│рІГ рѕЅрѕЇ
­Ъїљ	рѕЅрѕЇ, рѕўрѕгрЅх, рѕюрѕфрІ▓рІФріќрЅй, рѕюрѕфрІ▓рІФріќрЅй рІФрѕЅрЅарЅх рѕЅрѕЇ, рІЊрѕѕрѕЮ
­ЪЌ║	ріФрѕГрЅ│, рІЊрѕѕрѕЮ, рІерІЊрѕѕрѕЮ ріФрѕГрЅ│
­ЪЌЙ	ріФрѕГрЅ│, рІерїЃрЇЊріЋ ріФрѕГрЅ│, рїЃрЇЊріЋ
­ЪДГ	рѕЏрѕ░рѕх, рѕЏрЅЁрїарїЦ, рѕЏрїЇріћрЅ▓ріГ, рі«рѕЮрЇЊрѕх
­ЪЈћ	рЅђрІЮрЅЃрІЏ, рЅарѕерІХ, рЅ░рѕФрѕФ, рїФрЇЅ рЅарѕерІХ рІФрѕѕрЅарЅх рЅ░рѕФрѕФ
РЏ░	рЅ░рѕФрѕФ
­ЪїІ	рЅ░рѕФрѕФ, ріЦрѕ│рЅ░ рїјрѕўрѕФ, рІеріарІерѕГ ріЋрЅЦрѕерЅх, рЇЇріЋрІ│рЅ│
­ЪЌ╗	рЅ░рѕФрѕФ, рІерЇЅрїѓ рЅ░рѕФрѕФ, рЇЅрїѓ
­ЪЈЋ	рѕ░рЇѕрѕФ
­ЪЈќ	рІБріЋрїЦрѕІ, рІерЅБрѕЋрѕГ рІ│рѕГрЅ╗, рІерЅБрѕЋрѕГ рІ│рѕГрЅ╗ ріерІБріЋрїЦрѕІ рїІрѕГ
­ЪЈю	рЅарѕГрѕЃ
­ЪЈЮ	рЅарѕГрѕЃ, рІерЅарѕГрѕЃ рІ░рѕ┤рЅх, рІ░рѕ┤рЅх
­ЪЈъ	рЅЦрѕћрѕФрІі рЇќрѕГріГ, рЇќрѕГріГ
­ЪЈЪ	рѕхрЅ│рІ▓рІерѕЮ
­ЪЈЏ	рѕЋріЋрї╗, рїЦріЋрЅ│рІі, рїЦріЋрЅ│рІі рѕЋріЋрї╗
­ЪЈЌ	рѕЋріЋрї╗, рІерѕЋріЋрї╗ рїЇріЋрЅБрЅ│, рїЇріЋрЅБрЅ│
­ЪД▒	рѕърѕГрЅ│рѕГ, рѕИріГрѕІ, рїЇрІхрїЇрІ│
­ЪЈў	рѕЋріЋрї╗, рЅцрЅх, рІерѕўріќрѕфрІФ рЅцрЅХрЅй рїЇріЋрЅБрЅ│
­ЪЈџ	рѕЋріЋрї╗, рЅцрЅх, рІерЅ░рЅ░рІѕ рІерЅцрЅх рїЇріЋрЅБрЅ│, рІ░рѕГрѕіріГрЅх
­ЪЈа	рѕЋріЋрї╗, рѕўріќрѕфрІФ рЅцрЅх, рЅцрЅх, рІерЅцрЅх рїЇріЋрЅБрЅ│
­ЪЈА	рѕЋріЋрї╗, рѕўріЊрЇѕрѕ╗, рѕўріЊрЇѕрѕ╗ рЅдрЅ│ рІФрѕѕрІЇ рЅцрЅх, рѕўріќрѕфрІФ рЅцрЅх, рЅцрЅх
­ЪЈб	рѕЋріЋрї╗, рІерЅбрѕ« рѕЋріЋрї╗
­ЪЈБ	рѕЋріЋрї╗, рІерїЃрЇЊріЋ, рІерїЃрЇЊріЋ рЇќрѕхрЅ│ рЅцрЅх, рЇќрѕхрЅ│ рЅцрЅх
­ЪЈц	рѕЋріЋрї╗, рІеріарІЇрѕ«рї│, рЇќрѕхрЅ│ рЅцрЅх
­ЪЈЦ	рѕєрѕхрЇњрЅ│рѕЇ, рѕЋріЋрї╗, рѕЋріГрѕЮріЊ, рІХріГрЅ░рѕГ
­ЪЈд	рѕЋріЋрї╗, рЅБріЋріГ
­ЪЈе	рѕєрЅ┤рѕЇ, рѕЋріЋрї╗
­ЪЈЕ	рѕєрЅ┤рѕЇ, рѕЋріЋрї╗, рІерЇЇрЅЁрѕГ рѕєрЅ┤рѕЇ, рЇЇрЅЁрѕГ
­ЪЈф	24 рѕ░рІЊрЅх рІерѕџрѕ░рѕФ рїѕрЅарІФ ріарІ│рѕФрѕй, рѕЋріЋрї╗, рѕўрІ░рЅЦрѕГ
­ЪЈФ	рѕЋріЋрї╗, рЅхрѕЮрѕЁрѕГрЅх рЅцрЅх
­ЪЈг	рѕЋріЋрї╗, рѕўріќрѕфрІФ ріарЇЊрѕГрЅ│рѕЏ, рѕўрІ░рЅЦрѕГ, рІ▓рЇЊрѕГрЅхрѕўріЋрЅх
­ЪЈГ	рѕЋріЋрї╗, рЇІрЅЦрѕфріФ
­ЪЈ»	рѕЋріЋрї╗, рІерЅцрЅ░ рѕўріЋрїЇрѕЦрЅх рѕЋріЋрї╗, рІерїЃрЇЊріЋ, рІерїЃрЇЊріЋ рЅцрЅ░рѕўріЋрїЇрѕЦрЅх рѕЋріЋрї╗
­ЪЈ░	рѕЋріЋрї╗, рІерЅцрЅ░рѕўріЋрїЇрѕЦрЅх рѕЋріЋрї╗, рІеріарІЇрѕ«рї│
­Ъњњ	рѕ░рѕГрїЇ, рЅ╗рЇћрѕЇ, рЇЇрЅЁрѕГ
­ЪЌ╝	рѕЏрѕЏ, рЅХріГрІ«, рІерЅХріГрІ« рѕЏрѕЏ
­ЪЌй	рѕљрІЇрѕЇрЅх, ріљрї╗ріљрЅх, рІеріљрї╗ріљрЅх рѕљрІЇрѕЇрЅх
РЏф	рѕЋріЋрї╗, рѕўрѕхрЅђрѕЇ, рЅцрЅ░ріГрѕГрѕхрЅхрІФріЋ, ріЃрІГрѕЏріќрЅх, ріГрѕГрѕхрЅхрІФріЋ
­ЪЋї	рѕўрѕхрїѓрІх, рѕЎрѕхрѕірѕЮ, ріЃрІГрѕЏріќрЅх, ріЦрѕхрѕІрѕЮ
­ЪЋЇ	рЅцрЅ░ рѕўрЅЁрІ░рѕх, ріЃрІГрѕЏріќрЅх, ріарІГрѕЂрІ│рІі, ріарІГрѕЂрІх
РЏЕ	рѕ║ріЋрЅХ, ріЃрІГрѕЏріќрЅх, рІерѕ║ріЋрЅХ рѕўріФріљ рѕўрЅЃрЅЦрѕГ, рІерЅ░рЅђрІ░рѕ░ рѕўріФріљ рѕўрЅЃрЅЦрѕГ
­ЪЋІ	рѕЎрѕхрѕірѕЮ, ріЃрІГрѕЏріќрЅх, ріЦрѕхрѕІрѕЮ, рІерѕЎрѕхрѕірѕЮ ріФрЅБ
РЏ▓	рЇЈрЇЈрЅ┤
РЏ║	рЅарІхріЋрі│ріЋ рѕўрѕхрЇѕрѕГ, рІхріЋрі│ріЋ
­ЪїЂ	рІеріарІерѕГ ріЋрЅЦрѕерЅх, рїГрїІрїІрѕЏ, рїГрїІрїЇ
­ЪїЃ	рѕїрѕірЅх, ріерІІріГрЅЦрЅх рІФрѕЅрЅарЅх рѕѕрѕірЅх, рі«ріерЅЦ, рІеріарІерѕГ ріЋрЅЦрѕерЅх
­ЪЈЎ	рѕЋріЋрї╗, ріерЅ░рѕЏ, рІеріерЅ░рѕЏ рѕўрѕЇріГрІЊ рѕЮрІхрѕГ
­Ъїё	рЅарЅ░рѕФрѕ«рЅй ріаріЊрЅх рѕІрІГ рІерѕЮрЅхрІѕрїБ рЇђрѕљрІГ, рЅ░рѕФрѕФ, рІеріарІерѕГ ріЋрЅЦрѕерЅх, рїарІІрЅх, рЇђрѕљрІГ
­ЪїЁ	рІеріарІерѕГ ріЋрЅЦрѕерЅх, рІерЇђрѕљрІГ рІЇрїБрЅх, рїарІІрЅх, рЇђрѕљрІГ
­Ъїє	рѕўрѕЇріГрІЊ рѕЮрІхрѕГ, рѕЮрѕйрЅх, ріерЅ░рѕЏ, рІеріерЅ░рѕЏ рѕўрѕЇріГрІЊ рѕЮрІхрѕГ рЅарѕЮрѕйрЅх, рІерЇђрѕљрІГ рїЇрЅБрЅх
­ЪїЄ	рѕЋріЋрї╗, рІеріарІерѕГ ріЋрЅЦрѕерЅх, рІерЇђрѕљрІГ рїЇрЅБрЅх, рїерѕѕрѕЏ, рЇђрѕљрІГ
­ЪїЅ	рѕїрѕірЅх, рІеріарІерѕГ ріЋрЅЦрѕерЅх, рІхрѕЇрІхрІГ, рІхрѕЇрІхрІГ рЅарѕѕрѕірЅх
РЎе	рѕЮріЋрї«рЅй, рЅхріЕрѕх, рЅхріЕрѕх рЇЇрѕЇрІЇрѕЃ, ріЦріЋрЇІрѕјрЅх, рЇЇрѕЇрІЇрѕЃ
­Ъїї	рѕЁрІІ, рІеріарІерѕГ ріЋрЅЦрѕерЅх, рЇЇріќрЅ░ рѕљрѕірЅЦ
­Ъја	ріФрѕ«рѕ┤рѕЇ, ріФрѕ«рѕ┤рѕЇ рЇѕрѕерѕх, рЇѕрѕерѕх
­ЪјА	рѕўрІўрІЇрѕГ, рѕўрІЮріЊріЏ рЇќрѕГріГ, рЅхрѕЇріГ рѕўрѕГріерЅЦ, рЇїрѕфрѕх рІірѕЇ ріЦрѕйріГрѕГріГрѕ«рѕй
­Ъјб	рѕўрІЮріЊріЏ рЇќрѕГріГ, рѕ«рѕѕрѕГ, рѕ«рѕѕрѕГ рі«рѕхрЅ░рѕГ ріЦрѕйріГрѕГріГрѕ«рѕй, рі«рѕхрЅ░рѕГ
­Ъњѕ	рѕхрѕЇріГ ріЦріЋрїерЅх, рІерїИрїЅрѕГ ріарѕхрЅ░ріФріФрІГ рѕхрѕЇріГ ріЦріЋрїерЅх, рїИрїЅрѕГ рѕўрЅєрѕерїЦ, рїИрїЅрѕГ рЅєрѕФрїГ
­Ъјф	рѕ░рѕГріерѕх, рІерѕ░рѕГріерѕх рІхріЋрі│ріЋ, рІхріЋрі│ріЋ
­Ъџѓ	рѕърЅ░рѕГ, рЅБрЅАрѕГ, рЅ░рѕйріерѕГріФрѕф, ріЦріЋрЇІрѕјрЅх, рІерЅБрЅАрѕГ рѕўріЋрїѕрІх, рІерЅБрЅАрѕГ рЇЅрѕГрїј рїјрЅ│рЅй
­ЪџЃ	рѕўріфріЊ, рЅБрЅАрѕГ, рЅ░рїјрЅ│рЅй, ріцрѕїріГрЅхрѕфріГ, рІерЅБрЅАрѕГ рѕўріЋрїѕрІх, рЇЅрѕГрїј
­Ъџё	рѕ║ріЋріФріЋрѕ░ріЋ, рЅБрЅАрѕГ, рІерЅБрЅАрѕГ рѕўріЋрїѕрІх, рЇѕрїБріЋ рЅБрЅАрѕГ, рЇЇрїЦріљрЅх
­ЪџЁ	рѕ║ріЋріФріЋрѕ░ріЋ, рЅБрЅАрѕГ, ріарЇЇріЋрїФрІЇ рїЦрІГрЅх рѕўрѕ│рІГ рЇѕрїБріЋ рЅБрЅАрѕГ, рІерЅБрЅАрѕГ рѕўріЋрїѕрІх, рЇЇрїЦріљрЅх
­Ъџє	рЅБрЅАрѕГ, рЅ░рѕйріерѕГріФрѕф, рІерЅБрЅАрѕГ рѕўріЋрїѕрІх
­ЪџЄ	рЅ░рѕйріерѕГріФрѕф, рІерѕўрѕгрЅх рІЇрѕхрїЦ рЅБрЅАрѕГ
­Ъџѕ	рЅђрѕІрѕЇ рЅБрЅАрѕГ, рЅ░рѕйріерѕГріФрѕф, рІерЅБрЅАрѕГ рѕўріЋрїѕрІх
­ЪџЅ	рЅБрЅАрѕГ, рЅ░рѕйріерѕГріФрѕф, рІерЅБрЅАрѕГ рѕўріЋрїѕрІх, рїБрЅбрІФ
­Ъџі	рЅБрЅАрѕГ рѕўрѕ░рѕЇ ріарІЇрЅХрЅАрѕх, рЅ░рѕйріерѕГріФрѕф
­ЪџЮ	рЅ░рѕйріерѕГріФрѕф, рІерЅБрЅАрѕГ рѕўрѕёрїЃ рІхрѕЇрІхрІГ
­Ъџъ	рѕўріфріЊ, рЅ░рѕФрѕФ, рЅ░рѕйріерѕГріФрѕф, рІерЅБрЅАрѕГ рѕљрІ▓рІх рІФрѕѕрІЇ рЅ░рѕФрѕФ, рІерЅБрЅАрѕГ рѕўріЋрїѕрІх
­ЪџІ	рѕўріфріЊ, рЅБрЅАрѕГ рѕўрѕ░рѕЇ ріарІЇрЅХрЅАрѕх, рЅ░рѕйріерѕГріФрѕф, рЅ░рїјрЅ│рЅй, рІерЅБрЅАрѕГ рѕўрѕ░рѕЇ ріарІЇрЅХрЅАрѕх рЇЅрѕГрїј
­Ъџї	рЅ░рѕйріерѕГріФрѕф, ріарІЇрЅХрЅАрѕх
­ЪџЇ	рѕўрїф, рѕўрїф ріарІЇрЅХрЅАрѕх, рЅ░рѕйріерѕГріФрѕф, ріарІЇрЅХрЅАрѕх
­Ъџј	рЅаріцрѕїрЅхрѕфріГ рІерѕџрїјрЅ░рЅх ріарІЇрЅХрЅАрѕх, рЅаріцрѕїріГрЅхрѕфріГ рІерѕџрїјрЅ░рЅх, рЅ░рѕйріерѕГріФрѕф, рЅ░рїјрЅ│рЅй, ріарІЇрЅХрЅАрѕх
­Ъџљ	рѕџріњрЅБрѕх, рЅ░рѕйріерѕГріФрѕф, ріарІЇрЅХрЅАрѕх
­ЪџЉ	рЅ░рѕйріерѕГріФрѕф, ріарѕЮрЅАрѕІріЋрѕх
­Ъџњ	рѕърЅ░рѕГ, рЅ░рѕйріерѕГріФрѕф, ріЦрѕ│рЅх, рІеріЦрѕ│рЅх ріарІ░рїІ рѕўріфріЊ, рІерїГріљрЅх рѕўріфріЊ
­ЪџЊ	рѕўріфріЊ, рЅ░рѕйріерѕГріФрѕф, рІерЇќрѕірѕх рѕўріфріЊ, рЇЊрЅхрѕ«рѕЇ, рЇќрѕірѕх
­Ъџћ	рѕўріфріЊ, рѕўрїф, рѕўрїф рІерЇќрѕірѕх рѕўріфріЊ, рЅ░рѕйріерѕГріФрѕф, рЇќрѕірѕх
­ЪџЋ	рЅ░рѕйріерѕГріФрѕф, рЅ│ріГрѕ▓
­Ъџќ	рѕўрїф, рѕўрїф рЅ│ріГрѕ▓, рЅ░рѕйріерѕГріФрѕф, рЅ│ріГрѕ▓
­ЪџЌ	рѕўріфріЊ, рЅ░рѕйріерѕГріФрѕф, ріарІЇрЅХрѕърЅбрѕЇ
­Ъџў	рѕўріфріЊ, рѕўрїф, рѕўрїф ріарІЇрЅХрѕърЅбрѕЇ, рЅ░рѕйріерѕГріФрѕф, ріарІЇрЅХрѕърЅбрѕЇ
­ЪџЎ	рЅ░рѕйріерѕГріФрѕф, рІерѕўрІЮріЊріЏ, рІерѕўрІЮріЊріЏ рѕўріфріЊ
­Ъџџ	рѕЏрІхрѕерѕ╗, рЅ░рѕйріерѕГріФрѕф, рІерІЋрЅЃ рѕЏрІхрѕерѕ╗ рѕўріфріЊ, рІерїГріљрЅх рѕўріфріЊ
­ЪџЏ	рѕйрЇЇріЋ рІерїГріљрЅх рѕЏрѕўрѕІрѕѕрѕ╗ рѕўріфріЊ, рЅ░рѕйріерѕГріФрѕф, ріаріљрѕхрЅ░ріЏ рІерїГріљрЅх рѕўріфріЊ, ріерЇірѕЇ, рІерїГріљрЅх рѕўріфріЊ
­Ъџю	рЅ░рѕйріерѕГріФрѕф, рЅхрѕФріГрЅ░рѕГ
­Ъџ▓	рЅЦрѕхріГрѕїрЅх, рЅ░рѕйріерѕГріФрѕф
­ЪЏ┤	рѕўрїЇрЇІрЅх, рѕ│рІГріГрѕЇ, рІерїЇрЇі рѕ│рІГріГрѕЇ
­ЪЏ╣	рѕхрігрЅхрЅдрѕГрІх, рЅдрѕГрІх
­ЪЏх	рѕърЅ░рѕГ, рѕ│рІГріГрѕЇ, рЅђрѕІрѕЇ рѕърЅ░рѕГ рѕ│рІГріГрѕЇ
­ЪџЈ	ріарЅЂрѕЮ, ріарІЇрЅХрЅАрѕх, ріарІЇрЅХрЅАрѕх рѕЏрЅєрѕџрІФ, рІеріарІЇрЅХрЅАрѕх рѕЏрЅєрѕџрІФ
­ЪЏБ	рѕўріЋрїѕрІх, ріарІЇрѕФ рїјрІ│ріЊ, рІерѕўріфріЊ рѕўріЋрїѕрІх
­ЪЏц	рЅБрЅАрѕГ, рІерЅБрЅАрѕГ рѕљрІ▓рІх
­ЪЏб	ріерЅарѕ«, рІўрІГрЅх, рІерІўрІГрЅх ріерЅарѕ«
РЏй	рѕўрЅЁрІ│рЅх, рЅцріЋрІџріЋ, ріљрІ│рїЁ, рІеріљрІ│рїЁ рѕўрЅЁрїЃ, рїБрЅбрІФ
­Ъџе	рѕўрЅЦрѕФрЅх, рѕўріфріЊ, рЅцріеріЋ, рІерѕџрѕйріерѕеріерѕГ, рІерЇќрѕірѕх рѕўріфріЊ рѕўрЅЦрѕФрЅх
­ЪџЦ	рѕўрЅЦрѕФрЅх, рѕ▓рїЇріЊрѕЇ, рЅхрѕФрЇіріГ, ріарїЇрІхрѕЏрІі рІерЅхрѕФрЇіріГ рѕўрЅЦрѕФрЅх
­Ъџд	рѕўрЅЦрѕФрЅх, рѕ▓рїЇріЊрѕЇ, рЅ░рЅєрѕЇрЅІрІГ рІерЅхрѕФрЇіріГ рѕўрЅЦрѕФрЅх, рЅхрѕФрЇіріГ
­ЪЏЉ	рѕЮрѕЇріГрЅх, рѕхрѕЮріЋрЅх рѕЏрІЋрІўріЋ, рЅЂрѕЮ, рІерЅЂрѕЮ рѕЮрѕЇріГрЅх
­ЪџД	рѕўрѕ░ріЊріГрѕЇ, рїЇріЋрЅБрЅ│
РџЊ	рѕўрѕЇрѕЁрЅЁ, рѕўрѕБрѕфрІФ, рѕўрѕГріерЅЦ
РЏх	рЅБрѕЋрѕГ, рЅ░рѕйріерѕГріФрѕф, рЅ│ріЋрі│, ріЦріЋрїЇрІ│ рѕЏрѕерЇірІФ, рїђрѕЇрЅБ
­ЪЏХ	рЅ│ріЋрі│, рїђрѕЇрЅБ
­Ъџц	рЅ░рѕйріерѕГріФрѕф, рїђрѕЇрЅБ, рЇѕрїБріЋ рїђрѕЇрЅБ
­ЪЏ│	рѕўрѕГріерЅЦ, рѕўріЋрїѕрІ░ріЏ, рЅ░рѕйріерѕГріФрѕф, рІерѕўріЋрїѕрІ░ріърЅй рѕўрѕГріерЅЦ
РЏ┤	ріерЅБрІх рІерѕўріЋрїѕрІ░ріърЅй рѕўрѕГріерЅЦ, рїђрѕЇрЅБ
­ЪЏЦ	рѕърЅ░рѕГ рїђрѕЇрЅБ, рЅБрѕѕрѕърЅ░рѕГ рїђрѕЇрЅБ, рЅ░рѕйріерѕГріФрѕф, рїђрѕЇрЅБ
­Ъџб	рѕўрѕГріерЅЦ, рЅ░рѕйріерѕГріФрѕф
Рюѕ	рЅ░рѕйріерѕГріФрѕф, ріарІГрѕ«рЇЋрѕІріЋ
­ЪЏЕ	рЅ░рѕйріерѕГріФрѕф, рЅхріЋрѕй ріарІГрѕ«рЇЋрѕІріЋ, ріарІГрѕ«рЇЋрѕІріЋ
­ЪЏФ	рѕўріљрѕ│рЅх, рЅ░рѕўрІЮрїЇрЅд рѕўрїЇрЅБрЅх, рЅ░рѕйріерѕГріФрѕф, ріарІГрѕ«рЇЋрѕІріЋ, рІеріарІГрѕ«рЇЋрѕІріЋ ріаріљрѕ│рѕх
­ЪЏг	рЅарѕЏрѕерЇЇ рѕІрІГ, рЅ░рѕйріерѕГріФрѕф, ріарІГрѕ«рЇЋрѕІріЋ, ріЦрІерІ░рѕерѕ░ ріљрІЇ, рІеріарІГрѕ«рЇЋрѕІріЋ ріарѕхрЅ░рѕФрѕерЇЇ
­Ъњ║	рІѕріЋрЅарѕГ
­ЪџЂ	рѕёрѕірі«рЇЋрЅ░рѕГ, рЅ░рѕйріерѕГріФрѕф
­ЪџЪ	рЅаріарІерѕГ рѕІрІГ рІерѕџрїјрЅ░рЅх рЅБрЅАрѕГ, рЅ░рѕйріерѕГріФрѕф, рЅ░рїјрЅ│рЅй, рІерЅБрЅАрѕГ рѕљрІ▓рІх
­Ъџа	рЅ░рѕФрѕФ, рЅ░рѕйріерѕГріФрѕф, рІерЅ░рѕФрѕФ рІерЅБрЅАрѕГ рѕўрѕ│рЅбрІФ рїѕрѕўрІх, рїѕрѕўрІх, рїјріЋрІ│рѕІ
­ЪџА	рѕўріфріЊ, рЅаріарІерѕГ рѕІрІГ рІерѕџрїјрЅ░рЅх рЅБрЅАрѕГ рѕўрѕ░рѕЇ ріарІЇрЅХрЅАрѕх, рЅБрЅАрѕГ рѕўрѕ░рѕЇ ріарІЇрЅХрЅАрѕх, рІеріарІерѕГ, рІерїѕрѕўрІх рѕўріЋрїѕрІх, рїјріЋрІ│рѕІ
­ЪЏ░	рѕЁрІІ, рѕ│рЅ░рѕІрІГрЅх, рЅ░рѕйріерѕГріФрѕф
­Ъџђ	рѕЁрІІ, рѕ«рігрЅх, рЅ░рѕйріерѕГріФрѕф
­ЪЏИ	рЅарѕФрѕф рІ▓рѕхріГ
­ЪЏј	рѕєрЅ┤рѕЇ, рІерѕєрЅ┤рѕЇ рѕ╗ріЋрїБ рЅ░рЅђрЅБрІГ рІ░рІѕрѕЇ, рІ░рІѕрѕЇ
­ЪД│	рѕўрѕИріерЇЇ, рѕўрїЊрІЮ, рѕ╗ріЋрїБ
РїЏ	рѕ░рІЊрЅх рЅєрїБрѕф, ріарѕИрІІ, рІерѕ░рІЊрЅх рЅєрїБрѕф рЅЦрѕГрїГрЅє
РЈ│	рѕ░рІЊрЅх рѕўріљрїйрѕГ, рѕ░рІЊрЅх рЅєрїБрѕф, ріарѕИрІІ, рІерѕ░рІЊрЅх рЅєрїБрѕф рЅЦрѕГрїГрЅє ріерЇѕрѕ│рѕй ріарѕИрІІ рїІрѕГ
Рїџ	рѕ░рІЊрЅх, рІеріЦрїЁ рѕ░рІЊрЅх
РЈ░	рѕЏріЋрЅѓрІФ, рѕЏріЋрЅѓрІФ рІ░рІѕрѕЇ рІФрѕѕрІЇ рѕ░рІЊрЅх, рѕ░рІЊрЅх
РЈ▒	рѕ░рІЊрЅх, рІерѕЕрїФ рѕ░рІЊрЅх
РЈ▓	рѕ░рІЊрЅх, рѕ░рІЊрЅх рЅєрїБрѕф, рїірІю рЅєрїБрѕф рѕ░рІЊрЅх
­ЪЋ░	рѕ░рІЊрЅх, рІерЅЦрЇї рѕ░рІЊрЅх
­ЪЋЏ	00, 12, 12:00, рѕ░рІЊрЅх, ріарѕхрѕФ рѕЂрѕѕрЅх рѕ░рІЊрЅх
­ЪЋД	12, 12:30, 30, рѕ░рІЊрЅх, ріарѕхрѕФ рѕЂрѕѕрЅх рЅ░ріЕрѕЇ
­ЪЋљ	00, 1, 1:00, рѕ░рІЊрЅх, ріаріЋрІх, ріаріЋрІх рѕ░рІЊрЅх
­ЪЋю	1, 1:30, 30, рѕ░рІЊрЅх, рЅ░ріЕрѕЇ, ріаріЋрІх рѕ░рІЊрЅх рЅ░ріЕрѕЇ
­ЪЋЉ	00, 2, 2:00, рѕЂрѕѕрЅх, рѕЂрѕѕрЅх рѕ░рІЊрЅх, рѕ░рІЊрЅх
­ЪЋЮ	2, 2:30, 30, рѕЂрѕѕрЅх, рѕЂрѕѕрЅх рѕ░рІЊрЅх рЅ░ріЕрѕЇ, рЅ░ріЕрѕЇ
­ЪЋњ	00, 3, 3:00, рѕ░рІЊрЅх, рѕХрѕхрЅх, рѕХрѕхрЅх рѕ░рІЊрЅх
­ЪЋъ	3, 30, 3:30, рѕХрѕхрЅх, рѕХрѕхрЅх рѕ░рІЊрЅх рЅ░ріЕрѕЇ, рЅ░ріЕрѕЇ
­ЪЋЊ	00, 4, 4:00, рѕ░рІЊрЅх, ріарѕФрЅх, ріарѕФрЅх рѕ░рІЊрЅх
­ЪЋЪ	30, 4, 4:30, рЅ░ріЕрѕЇ, ріарѕФрЅх, ріарѕФрЅх рѕ░рІЊрЅх рЅ░ріЕрѕЇ
­ЪЋћ	00, 5, 5:00, рѕ░рІЊрЅх, ріарѕЮрѕхрЅх, ріарѕЮрѕхрЅх рѕ░рІЊрЅх
­ЪЋа	30, 5, 5:30, рЅ░ріЕрѕЇ, ріарѕЮрѕхрЅх, ріарѕЮрѕхрЅх рѕ░рІЊрЅх рЅ░ріЕрѕЇ
­ЪЋЋ	00, 6, 6:00, рѕ░рІЊрЅх, рѕхрІхрѕхрЅх, рѕхрІхрѕхрЅх рѕ░рІЊрЅх
­ЪЋА	30, 6, 6:30, рѕ░рЅБрЅх, рѕхрІхрѕхрЅх рѕ░рІЊрЅх рЅ░ріЕрѕЇ
­ЪЋќ	00, 7, 7:00, рѕ░рЅБрЅх, рѕ░рЅБрЅх рѕ░рІЊрЅх, рѕ░рІЊрЅх
­ЪЋб	30, 7, 7:30, рѕ░рЅБрЅх, рѕ░рЅБрЅх рѕ░рІЊрЅх рЅ░ріЕрѕЇ, рЅ░ріЕрѕЇ
­ЪЋЌ	00, 8, 8:00, рѕ░рІЊрЅх, рѕхрѕЮріЋрЅх, рѕхрѕЮріЋрЅх рѕ░рІЊрЅх
­ЪЋБ	30, 8, 8:30, рѕхрѕЮріЋрЅх, рѕхрѕЮріЋрЅх рѕ░рІЊрЅх рЅ░ріЕрѕЇ, рЅ░ріЕрѕЇ
­ЪЋў	00, 9, 9:00, рѕ░рІЊрЅх, рІўрїаріЮ, рІўрїаріЮ рѕ░рІЊрЅх
­ЪЋц	30, 9, 9:30, рЅ░ріЕрѕЇ, рІўрїаріЮ, рІўрїаріЮ рѕ░рІЊрЅх рЅ░ріЕрѕЇ
­ЪЋЎ	00, 10, 10:00, рѕ░рІЊрЅх, ріарѕхрѕГ, ріарѕхрѕГ рѕ░рІЊрЅх
­ЪЋЦ	10, 10:30, 30, рЅ░ріЕрѕЇ, ріарѕхрѕГ, ріарѕхрѕГ рѕ░рІЊрЅх рЅ░ріЕрѕЇ
­ЪЋџ	00, 11, 11:00, ріарѕхрѕФ ріаріЋрІх, ріарѕхрѕФ ріаріЋрІх рѕ░рІЊрЅх
­ЪЋд	11, 11:30, 30, рЅ░ріЕрѕЇ, ріарѕхрѕФ ріаріЋрІх рѕ░рІЊрЅх рЅ░ріЕрѕЇ
­ЪїЉ	рѕЁрІІ, ріарІ▓рѕх рїерѕерЅЃ, рІеріарІерѕГ ріЋрЅЦрѕерЅх, рїерѕѕрѕЏ, рїерѕерЅЃ
­Ъїњ	рѕЁрІІ, рЅхріЋрѕй рІерЅарѕФрЅй рїЇрѕЏрѕй рїерѕерЅЃ, рІерЅарѕФрЅй, рІеріарІерѕГ ріЋрЅЦрѕерЅх
­ЪїЊ	рѕЁрІІ, рѕЕрЅЦ, рІерѕўрїђрѕўрѕфрІФ рѕЕрЅЦ рїерѕерЅЃ, рІеріарІерѕГ ріЋрЅЦрѕерЅх, рїерѕерЅЃ
­Ъїћ	рѕЁрІІ, рЅхріЋрѕй рІерЅ░рЅђрЅБ, рЅхріЋрѕй рІерїарЅєрѕе, рЅхріЋрѕй рІерїарЅєрѕерЅй, рЅхріЋрѕй рІерїарЅєрѕерЅй рїЇрѕЏрѕй рїерѕерЅЃ
­ЪїЋ	рѕЁрІІ, рѕЎрѕЅ, рѕЎрѕЅ рїерѕерЅЃ, рІеріарІерѕГ ріЋрЅЦрѕерЅх, рїерѕерЅЃ
­Ъїќ	рѕЁрІІ, рЅарЅђріЮ рЅаріЕрѕЇ рЅхріЋрѕй рІерїарЅєрѕерЅй рїЇрѕЏрѕй рїерѕерЅЃ, рЅхріЋрѕй рІерїарЅєрѕе, рІеріарІерѕГ ріЋрЅЦрѕерЅх
­ЪїЌ	рѕЁрІІ, рѕЕрЅЦ, рІерѕўрїерѕерѕ╗ рѕЕрЅЦ рїерѕерЅЃ, рІеріарІерѕГ ріЋрЅЦрѕерЅх, рїерѕерЅЃ
­Ъїў	рѕЁрІІ, рЅарїЇрѕФ рЅаріЕрѕЇ рЅхріЋрѕй рІерЅарѕФрЅй рїЇрѕЏрѕй рїерѕерЅЃ, рІеріарІерѕГ ріЋрЅЦрѕерЅх, рІерІ░рЅарІўрІў, рїЇрѕЏрѕй рїерѕерЅЃ
­ЪїЎ	рѕЁрІІ, рІеріарІерѕГ ріЋрЅЦрѕерЅх, рїЇрѕЏрѕй рїерѕерЅЃ, рїерѕерЅЃ
­Ъїџ	рѕЁрІІ, ріарІ▓рѕх рїерѕерЅЃ рЇірЅх, рІеріарІерѕГ ріЋрЅЦрѕерЅх, рїерѕерЅЃ, рЇірЅх
­ЪїЏ	рѕЁрІІ, рѕЕрЅЦ, рІерѕўрїђрѕўрѕфрІФ рѕЕрЅЦ рїерѕерЅЃ ріерЇірЅх рїІрѕГ, рІеріарІерѕГ ріЋрЅЦрѕерЅх, рїерѕерЅЃ
­Ъїю	рѕЁрІІ, рѕЕрЅЦ, рІерѕўрїерѕерѕ╗ рѕЕрЅЦ рїерѕерЅЃ ріерЇірЅх рїІрѕГ, рІеріарІерѕГ ріЋрЅЦрѕерЅх, рїерѕерЅЃ
­ЪїА	рЅ┤рѕГрѕърѕюрЅхрѕГ, рІеріарІерѕГ ріЋрЅЦрѕерЅх
Рўђ	рѕЁрІІ, рЅЦрѕЕрѕЁ, рІеріарІерѕГ ріЋрЅЦрѕерЅх, рїерѕерѕ«рЅй, рЇђрѕљрІФрѕЏ, рЇђрѕљрІГ
­ЪїЮ	рѕЁрІІ, рѕЎрѕЅ, рѕЎрѕЅ рїерѕерЅЃ ріерЇірЅх рїІрѕГ, рЅЦрѕЕрѕЁ, рІеріарІерѕГ ріЋрЅЦрѕерЅх
­Ъїъ	рѕЁрІІ, рЅЦрѕЕрѕЁ, рІеріарІерѕГ ріЋрЅЦрѕерЅх, рЇђрѕљрІГ, рЇђрѕљрІГ ріерЇірЅх рїІрѕГ
РГљ	ріљрїГ рѕўріФріерѕѕріЏ рі«ріерЅЦ, рі«ріерЅЦ
­ЪїЪ	рѕЏрЅЦрѕФрЅх, рѕЏріЋрїИрЅБрѕерЅЁ, рЅЦрѕЇрїГ рІхрѕГрїЇрѕЮ, рЅЦрѕЇрїГ рІхрѕГрїЇрѕЮ рІерѕџрѕЇ рі«ріерЅЦ, ріарЅЦрѕѕрїГрѕѕрїГ
­Ъїа	рѕЁрІІ, рѕўрІѕрѕГрІѕрѕГ, рѕўрІЇрІ░рЅЁ, рЅ░рІѕрѕГрІІрѕф рі«ріерЅЦ, рі«ріерЅЦ
РўЂ	рІеріарІерѕГ ріЋрЅЦрѕерЅх, рІ░рѕўріЊ
РЏЁ	ріерІ░рѕўріЊ рїђрѕГрЅБ рІФрѕѕрЅй рЇђрѕљрІГ, рІеріарІерѕГ ріЋрЅЦрѕерЅх, рІ░рѕўріЊ, рЇђрѕљрІГ
РЏѕ	рѕўрЅЦрѕерЅЁ, ріерѕўрЅЦрѕерЅЁ ріЦріЊ рІЮріЊрЅЦ рїІрѕГ рІФрѕѕ рІ░рѕўріЊ, рІЮріЊрЅЦ, рІеріарІерѕГ ріЋрЅЦрѕерЅх, рІ░рѕўріЊ
­Ъїц	ріерЅхріЋрѕй рІ░рѕўріЊ рїђрѕГрЅБ рІФрѕѕрЅй рЇђрѕљрІГ, рІеріарІерѕГ ріЋрЅЦрѕерЅх, рІ░рѕўріЊ, рЇђрѕљрІГ
­ЪїЦ	ріерЅхрѕЇрЅЁ рІ░рѕўріЊ рїђрѕГрЅБ рІФрѕѕрЅй рЇђрѕљрІГ, рІеріарІерѕГ ріЋрЅЦрѕерЅх, рІ░рѕўріЊ, рЇђрѕљрІГ
­Ъїд	рІЮріЊрЅЦ, рІЮріЊрЅЦ ріФрѕѕрІЇ рІ░рѕўріЊ рїђрѕГрЅБ рІФрѕѕрЅй рЇђрѕљрІГ, рІеріарІерѕГ ріЋрЅЦрѕерЅх, рІ░рѕўріЊ, рЇђрѕљрІГ
­ЪїД	рІЮріЊрЅЦ, рІеріарІерѕГ ріЋрЅЦрѕерЅх, рІ░рѕўріЊ, рІ░рѕўріЊ ріерІЮріЊрЅЦ рїІрѕГ
­Ъїе	рЅђрІЮрЅЃрІЏ, рЅарѕерІХ, рІеріарІерѕГ ріЋрЅЦрѕерЅх, рІ░рѕўріЊ, рІ░рѕўріЊ ріерЅарѕерІХ рїІрѕГ
­ЪїЕ	ріљрїјрІхрїЊрІх, рІеріарІерѕГ ріЋрЅЦрѕерЅх, рІ░рѕўріЊ, рІ░рѕўріЊ ріерѕўрЅЦрѕерЅЁ рїІрѕГ
­Ъїф	рЅХрѕГріћрІХ, ріарІЇрѕј ріљрЇІрѕх, рІеріарІерѕГ ріЋрЅЦрѕерЅх, рІ░рѕўріЊ
­ЪїФ	рІеріарІерѕГ ріЋрЅЦрѕерЅх, рІ░рѕўріЊ, рїЅрѕЮ
­Ъїг	рѕўріЋрЇѕрѕх, ріљрЇІрѕх, рІеріљрЇІрѕх рЇірЅх, рІеріарІерѕГ ріЋрЅЦрѕерЅх, рІ░рѕўріЊ
­Ъїђ	рѕ│рІГріГрѕјріЋ, рЅ│рІГрЇЅріЋ, рЅхрІірѕхрЅ░рѕГ, рІеріарІерѕГ ріЋрЅЦрѕерЅх, рІ▓рІџ
­Ъїѕ	рЅђрѕхрЅ░ рІ░рѕўріЊ, рІЮріЊрЅЦ, рІеріарІерѕГ ріЋрЅЦрѕерЅх
­Ъїѓ	ріарѕЇрЅБрѕ│рЅх, рІЮріЊрЅЦ, рІБріЋрїЦрѕІ, рІерЅ│рїарЇѕ рІБріЋрїЦрѕІ, рІеріарІерѕГ ріЋрЅЦрѕерЅх
Рўѓ	ріарѕЇрЅБрѕ│рЅх, рІЮріЊрЅЦ, рІБріЋрїЦрѕІ, рІеріарІерѕГ ріЋрЅЦрѕерЅх
Рўћ	ріарѕЇрЅБрѕ│рЅх, рІЮріЊрЅЦ, рІБріЋрїЦрѕІ, рІеріарІерѕГ ріЋрЅЦрѕерЅх, рІерІЮріЊрЅЦ рїарЅЦрЅ│рІјрЅй рІФрѕЅрЅарЅх рІБріЋрїЦрѕІ
РЏ▒	рІЮріЊрЅЦ, рІБріЋрїЦрѕІ, рІерѕўрѕгрЅх рІБріЋрїЦрѕІ, рІеріарІерѕГ ріЋрЅЦрѕерЅх, рЇђрѕљрІГ
РџА	рЅ«рѕЇрЅ┤рїЁ, ріљрїјрІхрїЊрІх, ріарІ░рїІ, ріцрѕїріГрЅхрѕфріГ, ріцрѕїріГрЅхрѕфріГрѕ▓рЅ▓, ріерЇЇрЅ░ріЏ рЅ«рѕЇрЅ┤рїЁ
РЮё	рѕхріќрІЇрЇЇрѕїріГ, рЅђрІЮрЅЃрІЏ, рЅарѕерІХ, рІеріарІерѕГ ріЋрЅЦрѕерЅх
РўЃ	рЅђрІЮрЅЃрІЏ, рЅарѕерІХ, рЅарЅарѕерІХ рїЇрїЇрѕГ рІерЅ░рѕарѕФ рѕ░рІЇ, рІеріарІерѕГ ріЋрЅЦрѕерЅх
РЏё	рЅђрІЮрЅЃрІЏ, рЅарѕерІХ, рЅарЅарѕерІХ рїЇрїЇрѕГ рІерЅ░рѕарѕФ рѕ░рІЇ, рЅарЅарѕерІХ рїЇрїЇрѕГ рІерЅ░рѕарѕФ рѕ░рІЇ рІФрѕѕрЅарѕерІХ, рІеріарІерѕГ ріЋрЅЦрѕерЅх
Рўё	рѕЁрІІ, рі«рѕюрЅх
­ЪћЦ	рѕўрѕБрѕфрІФ, ріљрЅарѕЇрЅБрѕЇ, ріЦрѕ│рЅх
­ЪњД	рѕІрЅЦ, рЅђрІЮрЅЃрІЏ, ріарѕхрЅѓріЮ, рІеріарІерѕГ ріЋрЅЦрѕерЅх, рїарЅЦрЅ│
­Ъїі	рѕърїѕрІх, рІЇрѕЃ, рІЇрЅЁрІФріќрѕх, рІеріарІерѕГ ріЋрЅЦрѕерЅх, рІерІЇрѕЃ рѕърїѕрІх
­ЪјЃ	рѕЃрѕјрІіріЋ, рѕІріЋрЅ░рѕГріЋ, ріГрЅЦрѕе рЅарІЊрѕЇ, рїЃріГ, рїєріГ-рід-рѕІріЋрЅ░рѕГріЋ
­Ъјё	ріГрЅЦрѕе рЅарІЊрѕЇ, рІЏрЇЇ, рІерїѕріЊ рІЏрЇЇ, рїѕріЊ
­Ъјє	рѕГрЅйрЅх, ріГрЅЦрѕе рЅарІЊрѕЇ
­ЪјЄ	рѕГрЅйрЅх, ріГрЅЦрѕе рЅарІЊрѕЇ, рІеріЦрѕ│рЅх рЇЇріЋрїБрѕф, рІеріЦрѕ│рЅх рЇЇріЋрїБрѕф рѕўрѕЦрѕфрІФ
­ЪДе	рѕГрЅйрЅХрЅй, рІерѕџрЇѕріљрІ│, рІ░рѕЏрѕџрЅх
Рюе	рЅЦрѕЇрїГрЅ│, рі«ріерЅЦ, рІеріЦрѕ│рЅх рЇЇріЋрїБрѕфрІјрЅй
­Ъјѕ	ріарЇЅрЇІ, ріГрЅЦрѕе рЅарІЊрѕЇ
­ЪјЅ	рЅ│рІ│, ріГрЅЦрѕе рЅарІЊрѕЇ, рІерІхрїЇрѕх рі«рЇЇрІФ, рїЇрЅЦрІБ, рЇќрЇљрѕГ
­Ъјі	ріГрЅЦрѕе рЅарІЊрѕЇ, рі«ріЋрЇїрЅ▓ ріерѕерѕюрѕІ, рі│рѕх, рІеріерѕерѕюрѕІ рі│рѕх
­ЪјІ	рѕ░ріЋрІ░рЅЁ, рЅ│ріЋрЅБрЅ│ рІЏрЇЇ, ріГрЅЦрѕе рЅарІЊрѕЇ, рІЏрЇЇ, рІерїЃрЇЊріЋ
­ЪјЇ	рЅђрѕГрЅЁрѕЃ, рЅ░ріГрѕЇ, ріГрЅЦрѕе рЅарІЊрѕЇ, рІерїЃрЇЊріЋ, рІерїйрІх рїїрїЦ
­Ъјј	ріарѕ╗ріЋрїЅрѕірЅх, ріГрЅЦрѕе рЅарІЊрѕЇ, рІерїЃрЇЊріЋ, рІерїЃрЇЊріЋ ріарѕ╗ріЋрїЅрѕірЅХрЅй, рЇїрѕхрЅ▓рЅФрѕЇ
­ЪјЈ	рѕхрЅхрѕфрѕўрѕГ, ріФрѕГрЇЋ, ріФрѕГрЇЋ рЅ░рІѕрѕГрІІрѕф рІЊрѕБрІјрЅй, ріГрЅЦрѕе рЅарІЊрѕЇ
­Ъјљ	рЅ║рѕЮ, ріљрЇІрѕх, ріГрЅЦрѕе рЅарІЊрѕЇ, рІеріљрЇІрѕх рЅ║рѕЮ, рІ░рІѕрѕЇ
­ЪјЉ	ріГрЅЦрѕе рЅарІЊрѕЇ, рІерЅарІЊрѕЇ рѕЦріљ рѕЦрѕГрІЊрЅх, рІерїерѕерЅЃ рЅарІЊрѕЇ, рїерѕерЅЃ
­ЪДД	рѕўрѕЇріФрѕЮ рІЋрІхрѕЇ, рѕхрїдрЅ│, рЅђрІГ рЇќрѕхрЅ│, рІерЅ╗рІГріЊ рЇќрѕхрЅ│, рїѕріЋрІўрЅЦ
­Ъјђ	рѕфрЅБріЋ, ріГрЅЦрѕе рЅарІЊрѕЇ
­ЪјЂ	рѕБрїЦріЋ, рѕхрїдрЅ│, рЅ░рїарЅЁрѕЇрѕЈрѕЇ, ріарѕхрЅђрІхрѕъ рЅ░рѕЇрі│рѕЇ, ріГрЅЦрѕе рЅарІЊрѕЇ, рІерЅ░рїарЅђрѕѕрѕѕ рѕхрїдрЅ│
­ЪјЌ	рѕфрЅБріЋ, ріарѕхрЅ│рІІрѕй, ріГрЅЦрѕе рЅарІЊрѕЇ, рІерѕўрЅ│рѕ░рЅбрІФ рѕфрЅБріЋ
­ЪјЪ	рѕўрїЇрЅбрІФ рЇѕрЅЃрІх, рЅхрігрЅх, рІерѕўрїЇрЅбрІФ рЅхрігрЅХрЅй
­ЪјФ	рѕўрїЇрЅбрІФ рЇѕрЅЃрІх, рЅхрігрЅх
­Ъјќ	рѕюрІ│рІГ, ріГрЅЦрѕе рЅарІЊрѕЇ, рІѕрЅ│рІ░рѕФрІі, рІѕрЅ│рІ░рѕФрІі рѕюрІ│рІГ
­ЪЈє	рѕйрѕЇрѕЏрЅх, рІІріЋрїФ
­ЪЈЁ	рѕюрІ│рѕірІФ, рІерѕхрЇќрѕГрЅх рѕюрІ│рѕірІФ
­ЪЦЄ	рѕюрІ│рѕірІФ, ріаріЋрІ░ріЏ, рІѕрѕГрЅЁ, рІе1ріЏ рѕхрЇЇрѕФ рѕюрІ│рѕірІФ
­ЪЦѕ	рѕЂрѕѕрЅ░ріЏ, рѕюрІ│рѕірІФ, рЅЦрѕГ, рІе2ріЏ рѕхрЇЇрѕФ рѕюрІ│рѕірІФ
­ЪЦЅ	рѕўрІ│рЅЦ, рѕюрІ│рѕірІФ, рѕХрѕхрЅ░ріЏ, рІе3ріЏ рѕхрЇЇрѕФ рѕюрІ│рѕірІФ
Рџй	ріЦрїЇрѕГ рі│рѕх, рі│рѕх, рІеріЦрїЇрѕГ рі│рѕх
РџЙ	рЅцрІЮрЅдрѕЇ, рі│рѕх
­ЪЦј	рѕхрѕх рі│рѕх, рЅЦрЅЦрЅх, рі│рѕх, рїЊріЋрЅх
­ЪЈђ	рі│рѕх, рІерЅЁрѕГрїФрЅх рі│рѕх, рІерЅЁрѕГрїФрЅх рі│рѕх рїерІІрЅ│ рїЇрЅЦ
­ЪЈљ	рі│рѕх, рІерѕўрѕерЅЦ рі│рѕх, рїерІІрЅ│
­ЪЈѕ	ріЦрїЇрѕГ рі│рѕх, рі│рѕх, рІеріарѕюрѕфріФ, рІеріарѕюрѕфріФ ріЦрїЇрѕГ рі│рѕх
­ЪЈЅ	рѕФрїЇрЅб, ріЦрїЇрѕГ рі│рѕх, рі│рѕх, рІерѕФрїЇрЅб ріЦрїЇрѕГ рі│рѕх
­ЪјЙ	рѕФрігрЅх, рЅ┤ріњрѕх, рі│рѕх
­ЪЦЈ	рІерѕџрЅарѕГ рІ▓рѕхріГ, рїГрѕГрѕхрЅ│рІі
­Ъј│	рЅдрІЇрѕіріЋрїЇ, рі│рѕх, рїерІІрЅ│
­ЪЈЈ	рЅБрЅх, рі│рѕх, рІеріГрѕфрігрЅх рїерІІрЅ│, рїерІІрЅ│
­ЪЈЉ	рѕєріф, рѕўрѕхріГ, рі│рѕх, рІўріЋрїЇ, рІерѕюрІ│ рѕєріф, рїерІІрЅ│
­ЪЈњ	рѕєріф, рѕўрѕхріГ, рі│рѕх, рІўріЋрїЇ, рІерЅарѕерІХ рѕєріф рІўріЋрїЇ ріЦріЊ рЇЉріГ, рїерІІрЅ│
­ЪЦЇ	рѕІріГрѕ«рѕх, рѕйрѕўрѕЇ, рі│рѕх, рїјрѕЇ
­ЪЈЊ	рЅБрЅх, рі│рѕх, рїарѕерї┤рІЏ рЅ┤ріњрѕх, рїерІІрЅ│, рЇЊрІхрѕЇ
­ЪЈИ	рѕФрігрЅх, рѕ╗рЅхрѕЇрі«ріГ, рЅарѕГрІ▓, рЅБрІхрѕюріЋрЅ░ріЋ, рїерІІрЅ│
­ЪЦі	рѕхрЇќрѕГрЅх, рЅдріГрѕх, рІерЅдріГрѕх рїЊріЋрЅх, рїЊріЋрЅх
­ЪЦІ	рѕЇрЅЦрѕх, рѕЏрѕГрѕ╗рѕЇ ріарѕГрЅх, рѕхрЇќрѕГрЅх, рЅ┤ріЕрІІріЋрІХ, ріФрѕФрЅ┤, рІерѕЏрѕГрѕ╗рѕЇ ріарѕГрЅх рѕЇрЅЦрѕх
­ЪЦЁ	рѕўрѕерЅЦ, рѕхрЇќрѕГрЅх, рІерїјрѕЇ рѕўрѕерЅЦ, рїјрѕЇ
РЏ│	рЅђрІ│рІ│, рЅарЅђрІ│рІ│ рІерЅ░рѕ░ріФ рѕ░ріЋрІ░рЅЁ рІЊрѕІрѕЏ, рїјрѕЇрЇЇ
РЏИ	рѕхрігрЅх, ріарІГрѕх, рІерЅарѕерІХ рѕўріЋрѕИрѕФрЅ░рЅх
­ЪјБ	рѕхрѕЇріГ ріЦріЋрїерЅх, рІЊрѕБ, рІерІЊрѕБ рѕЏрїЦрѕўрїЃ рІўріЋрїЇ
­Ъјй	рѕўрѕ«рїФ рЅђрѕџрѕх, рѕЕрїФ, рѕ│рѕй, рѕИрѕџрІЮ
­Ъј┐	рѕхріф, рЅарѕерІХ
­ЪЏи	рІерЅарѕерІХ рѕўріЋрѕИрѕФрЅ░рЅ╗
­ЪЦї	рІерЅ░рїарѕерЅа рІхріЋрїІрІГ
­Ъј»	рѕЮрЅх, рЅђрїЦрЅ│ рІерІ│рѕГрЅх рІЇрѕГрІѕрѕФ рІЇрїцрЅх, рІњрѕІрѕЏ, рІерЅарѕг рІЊрІГріЋ, рІ│рѕГрЅх, рїерІІрЅ│
­Ъј▒	8, рѕхрѕЮріЋрЅх, ріерѕеріЋрЅдрѕІ, рі│рѕх, рІеріерѕеріЋрЅдрѕІ рІхріЋрїІрІГ, рїерІІрЅ│
­Ъћ«	рѕђрЅЦрЅх, рѕЮріЊрЅБрІі, рЅ░рѕерЅх рЅ░рѕерЅх, ріГрѕфрѕхрЅ│рѕЇ, ріГрѕфрѕхрЅ│рѕЇ рі│рѕх, рі│рѕх
­ЪД┐	рѕ░рІГрїБріЋ рІерѕџрІФрѕГрЅЁ рІхріЋрїІрІГ, ріЊрІЏрѕГ, ріЊрІЏрѕГ ріарѕЮрІЕрѕїрЅх, ріарѕхрІ░рѕ│рЅй, рІЏрїјрѕЇ
­Ъј«	рѕўрЅєрїБрїарѕфрІФ, рІерЅфрІ▓рІ« рїерІІрЅ│, рїерІІрЅ│
­ЪЋ╣	рЅфрІ▓рІ« рїерІІрЅ│, рїєрІГрѕхрЅ▓ріГ, рїерІІрЅ│
­Ъј░	рЅђрІ│рІ│, рЅарѕ│ріЋрЅ▓рѕЮ рІерѕџрѕарѕФ рѕЏрѕйріЋ, рїерІІрЅ│
­Ъј▓	рІерїерІІрЅ│ рІ│рІГ, рІ│рІГ, рІ│рІ«рЅй, рїерІІрЅ│
­ЪДЕ	рѕўрѕхрЅђрѕѕріЏ, рѕЮрѕЇріГрЅх, рЅЂрѕФрїГ, ріЦріЋрЅєрЅЁрѕЇрѕй
­ЪДИ	рѕўрїФрІѕрЅ╗, рЅ┤рІ▓ рЅбрѕГ, ріарѕ╗ріЋрїЅрѕірЅх, рІерЅ░ріљрЇІ, рІерЅ░рїарЅђрїарЅђ
РЎа	ріФрѕГрЅ│, рІеріФрѕГрЅ│ ріЦрѕйрїЇ, рІеріФрѕГрЅ│ рїдрѕГ, рїдрѕГ, рїерІІрЅ│
РЎЦ	рѕЇрЅЦ, ріФрѕГрЅ│, рІеріФрѕГрЅ│ рѕЇрЅЦ, рІеріФрѕГрЅ│ ріЦрѕйрїЇ
РЎд	ріарѕЇрѕЏрІЮ, ріФрѕГрЅ│, рІеріФрѕГрЅ│ ріарѕЇрѕЏрІЮ, рІеріФрѕГрЅ│ ріЦрѕйрїЇ, рїерІІрЅ│
РЎБ	ріарЅарЅдрЅй, ріФрѕГрЅ│, рІеріФрѕГрЅ│ ріарЅарЅБ, рІеріФрѕГрЅ│ ріЦрѕйрїЇ, рїерІІрЅ│
РЎЪ	рѕъріЮ, рЅ╝рІЮ, ріарѕІрЅѓ, рІерЅ╝рІЮ рѕўрїФрІѕрЅ╗
­ЪЃЈ	рЅарѕўрїФрІѕрЅх рѕІрІГ, ріФрѕГрЅ│, рІеріФрѕГрЅ│ рїєріерѕГ, рїерІІрЅ│
­Ъђё	рѕЏрѕЁрїєріЋрїЇ, рѕЏрѕЁрїєріЋрїЇ рЅђрІГ рІхрѕФрїјріЋ, рЅђрІГ, рїерІІрЅ│
­Ъј┤	рЅарѕўрїФрІѕрЅх рѕІрІГ, ріарЅарЅБ, ріФрѕГрЅ│, рІерїЃрЇЊріЋ, рїђрѕГрЅБрІЇ ріарЅарЅБ рѕўрїФрІѕрЅ╗ ріФрѕГрЅ│, рїерІІрЅ│
­ЪјГ	рѕЎрІџрЅЃріЊ рЅхрІФрЅхрѕГ, рѕЦріљ рїЦрЅарЅЦ, рЅ▓рІФрЅхрѕГ, рЅхрІѕріЊ, рїГріЋрЅЦрѕЇ
­Ъќ╝	рѕЮрѕхрѕЇ, рѕЦріљ рїЦрЅарЅЦ, рѕЦрІЋрѕЇ, рЅБрѕѕріГрЇѕрЇЇ, рЅБрѕѕріГрЇѕрЇЇ рѕЦрІЋрѕЇ, рЅцрЅ░ рѕўрІўріГрѕГ
­Ъје	рѕЦріљ рїЦрЅарЅЦ, рЅцрЅ░ рѕўрІўріГрѕГ, рІерѕарІЊрѕі рѕ│рѕЋріЋ, рІерѕЦрІЋрѕЇ рЅЁрЅЦ рѕЦрѕФ
­ЪДх	рѕўрѕГрЇї, рѕўрѕхрЇІрЅх, ріГрѕГ, рїѕрѕўрІх
­ЪДХ	рѕхрЇїрЅх, рі│рѕх, рІерѕхрЇїрЅх ріГрѕГ, рІ░ріЋрЅ┤рѕЇ
­ЪћЄ	рѕхрЇњріерѕГ, рѕхрЇњріерѕГ рїарЇЇрЅирѕЇ, рІЮрѕЮ рІФрѕѕ, рІхрѕЮрЇђ ріерѕЇ, рїИрїЦрЅ│
­Ъћѕ	рѕхрЇњріерѕГ, рІхрѕЮрЇЁ рѕўрїаріЋ
­ЪћЅ	рѕърїѕрІх, рѕхрЇњріерѕГ, рѕхрЇњріерѕГ рЅарѕГрЅирѕЇ, рІЮрЅЁ, рІхрѕЮрЇЁ рѕўрїаріЋ
­Ъћі	рѕхрЇњріерѕГ, рѕхрЇњріерѕГ рІхрѕЮрЇЂ ріерЇЇ рЅЦрѕЈрѕЇ, ріерЇЇрЅ░ріЏ, рІхрѕЮрЇЁ рѕўрїаріЋ, рї«ріГ
­ЪЊб	рѕІрІЇрІх рѕхрЇњріерѕГ, рІГрЇІ ріарІхрѕФрѕ╗, рї«ріГ рІФрѕѕ
­ЪЊБ	рѕюрїІрЇјріЋ, рЅ║рѕфріЋрїЇ
­ЪЊ»	рІерЇќрѕхрЅ░ріЏ рїЦрѕЕріЋрЅБ, рїЦрѕЕріЋрЅБ, рЇќрѕхрЅ│ рЅцрЅх
­Ъћћ	рІ░рІЇрѕЇ
­ЪћЋ	рІЮрѕЮ рІФрѕѕ, рІерЅ░рѕ░рѕерІў рІ░рІѕрѕЇ, рІ░рІѕрѕЇ, рІхрѕЮрїИ ріерѕЇ, рїИрїЦрЅ│ ріГрѕЇріГрѕЇ
­Ъј╝	рѕЎрІџрЅЃ, рѕЎрІџрЅЃрІі рІЇрїцрЅх, рІЇрїцрЅх
­Ъјх	рѕЎрІџрЅЃ, рѕЎрІџрЅЃрІі ріќрЅ│, рѕЏрѕхрЅ│рІѕрѕ╗
­ЪјХ	рѕЎрІџрЅЃ, рѕЎрІџрЅЃрІі ріќрЅ│рІјрЅй, рѕЏрѕхрЅ│рІѕрѕ╗, рѕЏрѕхрЅ│рІѕрѕ╗рІјрЅй
­ЪјЎ	рѕЎрІџрЅЃ, рѕЏрІГріГ, рѕЏрІГріГрѕФрЇјріЋ, рѕхрЅ▓рІ▓рІ«, рІерѕхрЅ▓рІ▓рІ« рѕЏрІГріГрѕФрЇјріЋ
­Ъјџ	рѕЎрІџрЅЃ, рѕЏрѕўрїБрїаріЏ, рѕЏрѕўрїБрїаріЏ ріаріЋрѕИрѕФрЅ│рЅй, ріаріЋрѕИрѕФрЅ│рЅй
­ЪјЏ	рѕўрЅєрїБрїарѕфрІФ, рѕўрЅєрїБрїарѕфрІФ рЅЂрѕЇрЇјрЅй, рѕЎрІџрЅЃ
­Ъјц	рѕЏрІГріГ, рѕЏрІГріГрѕФрЇјріЋ, ріФрѕ«ріг
­ЪјД	рІерїєрѕ« рѕЏрІ│рѕўрїФ, рїєрѕ« рЅ░рѕ░ріф
­ЪЊ╗	рѕгрІ▓рІ«, рЅфрІ▓рІ«
­Ъји	рѕўрѕБрѕфрІФ, рѕЎрІџрЅЃ, рѕ│ріГрѕх, рѕ│ріГрѕхрЇјріЋ
­ЪјИ	рѕўрѕБрѕфрІФ, рѕЎрІџрЅЃ, рїірЅ│рѕГ
­Ъј╣	рѕўрѕБрѕфрІФ, рѕЎрІџрЅЃ, рЅЂрѕЇрЇЇ рѕ░рѕїрІ│, рІерѕЎрІџрЅЃ рЅЂрѕЇрЇЇ рѕ░рѕїрІ│, рЇњрІФріќ
­Ъј║	рѕўрѕБрѕфрІФ, рѕЎрІџрЅЃ, рЅхрѕФрѕЮрЇћрЅх
­Ъј╗	рѕўрѕБрѕфрІФ, рѕЎрІџрЅЃ, рЅФрІ«рѕіріЋ
­ЪЦЂ	рѕЎрІџрЅЃ, ріерЅарѕ«, рІеріерЅарѕ« ріЦріЋрїерЅх
­ЪЊ▒	рѕърЅБрІГрѕЇ, рѕърЅБрІГрѕЇ рѕхрѕЇріГ, рѕхрѕЇріГ, рЅ░ріЋрЅђрѕ│рЅЃрѕй, рЅ┤рѕїрЇјріЋ
­ЪЊ▓	рѕърЅБрІГрѕЇ рѕхрѕЇріГ ріерЅђрѕхрЅх рїІрѕГ, рѕхрѕЇріГ, рЅђрѕхрЅх, рЅ░рЅђрЅарѕЇ рѕърЅБрІГрѕЇ, рїЦрѕф
Рўј	рѕхрѕЇріГ, рЅ┤рѕїрЇјріЋ
­ЪЊъ	рѕфрѕ▓рЅерѕГ, рѕхрѕЇріГ, рЅ┤рѕїрЇјріЋ, рІерЅ┤рѕїрЇјріЋ рѕўріљрїІрїѕрѕфрІФ
­ЪЊЪ	рІѕрѕерЅђрЅх
­ЪЊа	рЇІріГрѕх, рЇІріГрѕх рѕЏрѕйріЋ
­ЪћІ	рЅБрЅхрѕф
­Ъћї	рѕХрігрЅх, ріцрѕїріГрЅхрѕфріГ, ріцрѕїріГрЅхрѕфріГрѕ▓рЅ▓, рІеріцрѕїріГрЅхрѕфріГ рѕХрігрЅх
­Ъњ╗	рѕІрЇЋрЅХрЇЋ рі«рѕЮрЇњрІЇрЅ░рѕГ, рі«рѕЮрЇњрІЇрЅ░рѕГ, рІерїЇрѕЇ, рЇњрѕ▓
­ЪќЦ	рі«рѕЮрЇњрІЇрЅ░рѕГ, рІ┤рѕхріГрЅХрЇЋ, рІ┤рѕхріГрЅХрЇЋ рі«рѕЮрЇњрІЇрЅ░рѕГ
­Ъќе	рѕЏрЅ░рѕџрІФ, рі«рѕЮрЇњрІЇрЅ░рѕГ
Рїе	рі«рѕЮрЇњрІЇрЅ░рѕГ, рІерЅЂрѕЇрЇЇ рѕ░рѕїрІ│
­Ъќ▒	рі«рѕЮрЇњрІЇрЅ░рѕГ, рІері«рѕЮрЇњрІЇрЅ░рѕГ рѕўрІ│рЇірЅх
­Ъќ▓	рЅхрѕФріГрЅдрѕЇ, рі«рѕЮрЇњрІЇрЅ░рѕГ
­Ъњй	рѕџріњрІ▓рѕхріГ, рідрЇЋрЅ▓ріФрѕЇ, рі«рѕЮрЇњрІЇрЅ░рѕГ, рІ▓рѕхріГ
­ЪњЙ	рі«рѕЮрЇњрІЇрЅ░рѕГ, рІ▓рѕхріГ, рЇЇрѕјрЇњ, рЇЇрѕјрЇњ рІ▓рѕхріГ
­Ъњ┐	рѕ▓рІ▓, рідрЇЋрЅ▓ріФрѕЇ, рідрЇЋрЅ▓ріФрѕЇ рІ▓рѕхріГ, рі«рѕЮрЇњрІЇрЅ░рѕГ, рІ▓рѕхріГ
­ЪЊђ	рѕЅ-рѕгрІГ, рідрЇЋрЅ▓ріФрѕЇ, рі«рѕЮрЇњрІЇрЅ░рѕГ, рІ▓рѕхріГ, рІ▓рЅфрІ▓
­ЪД«	рѕѓрѕ│рЅЦ рѕЏрѕхрѕірІФ, ріарЅБріерѕх
­ЪјЦ	рѕ▓ріњрѕЏ, ріФрѕюрѕФ, рІерЇірѕЇрѕЮ ріФрѕюрѕФ, рЇірѕЇрѕЮ
­Ъјъ	рѕ▓ріњрѕЏ, рІерЇірѕЇрѕЮ рЇЇрѕгрѕърЅй, рЇірѕЇрѕЮ
­ЪЊй	рѕ▓ріњрѕЏ, рЅфрІ▓рІ«, рІерЇірѕЇрѕЮ рЇЋрѕ«рїёріГрЅ░рѕГ, рЇірѕЇрѕЮ, рЇЋрѕ«рїёріГрЅ░рѕГ
­Ъјг	рІерЇірѕЇрѕЮ рЅђрѕерї╗ рѕўрЅђріЋрїарЅбрІФ рѕ░рѕїрІ│, рЇірѕЇрѕЮ
­ЪЊ║	рЅфрІ▓рІ«, рЅ▓рЅф, рЅ┤рѕїрЅфрІЦріЋ
­ЪЊи	рЅфрІ▓рІ«, ріФрѕюрѕФ
­ЪЊИ	рЅБрѕѕрЇЇрѕІрѕй ріФрѕюрѕФ, рЅфрІ▓рІ«, ріФрѕюрѕФ, рЇЇрѕІрѕй
­ЪЊ╣	рЅфрІ▓рІ«, ріФрѕюрѕФ, рІерЅфрІ▓рІ« ріФрѕюрѕФ
­ЪЊ╝	рЅфрІ▓рІ«, рЅ┤рЇЋ, рІерЅфрІ▓рІ« ріФрѕ┤рЅх
­ЪћЇ	рѕўрѕБрѕфрІФ, рѕўріљрїйрѕГ, рѕЏрїЅрІФ, рїЇрѕФ рїарЅІрѕџ рѕЏрїЅрІФ рѕўріљрїйрѕГ, рЇЇрѕѕрїІ
­Ъћј	рѕўрѕБрѕфрІФ, рѕўріљрїйрѕГ, рѕЏрїЅрІФ, рЅђріЮ рїарЅІрѕџ рѕЏрїЅрІФ рѕўріљрїйрѕГ, рЇЇрѕѕрїІ
­ЪЋ»	рѕ╗рѕЏ, рЅЦрѕГрѕЃріЋ
­ЪњА	рѕљрѕ│рЅЦ, рЅЦрѕГрѕЃріЋ, ріарѕЮрЇќрѕЇ, ріарѕхрЅѓріЮ, ріцрѕїріГрЅхрѕфріГ
­Ъћд	рѕўрѕБрѕфрІФ, рЅЦрѕГрѕЃріЋ, ріцрѕїріГрЅхрѕфріГ, рІеріЦрїЁ рЅБрЅхрѕф
­ЪЈ«	рѕўрЅЦрѕФрЅх, рѕгрІх рЇћрЇљрѕГ рѕўрЅЦрѕФрЅх, рЅђрІГ, ріарѕърѕї, рІерїЃрЇЊріЋ
­ЪЊћ	рѕўрїйрѕљрЇЇ, рѕЏрѕхрЅ│рІѕрѕ╗ рІ░рЅЦрЅ░рѕГ, рѕйрЇІріЋ, рЅБрѕѕрїїрїЦ рѕйрЇІріЋ рѕЏрѕхрЅ│рІѕрѕ╗ рІ░рЅЦрЅ░рѕГ, рІФрїїрїа
­ЪЊЋ	рѕўрїйрѕљрЇЇ, рІерЅ░рІўрїІ, рІерЅ░рІўрїІ рѕўрїйрѕљрЇЇ
­ЪЊќ	рѕўрїйрѕљрЇЇ, ріГрЇЇрЅх, ріГрЇЇрЅх рѕўрїйрѕљрЇЇ
­ЪЊЌ	рѕўрїйрѕљрЇЇ, ріарѕеріЋрїЊрІ┤, ріарѕеріЋрїЊрІ┤ рѕўрїйрѕљрЇЇ
­ЪЊў	рѕўрїйрѕљрЇЇ, рѕ░рѕЏрІФрІі, рѕ░рѕЏрІФрІі рѕўрїйрѕљрЇЇ
­ЪЊЎ	рѕўрїйрѕљрЇЇ, рЅЦрѕГрЅхрі│ріЊрѕЏ, рЅЦрѕГрЅхрі│ріЊрѕЏ рѕўрїйрѕљрЇЇ
­ЪЊџ	рѕўрїйрѕљрЇЇ, рѕўрїйрѕљрЇЇрЅх
­ЪЊЊ	рѕЏрѕхрЅ│рІѕрѕ╗ рІ░рЅЦрЅ░рѕГ
­ЪЊњ	рѕўрІЮрїѕрЅЦ, рѕЏрѕхрЅ│рІѕрѕ╗ рІ░рЅЦрЅ░рѕГ
­ЪЊЃ	рѕ░ріљрІх, рѕИрЅЦрѕѕрѕЇ рІФрѕѕ рІѕрѕерЅђрЅх, рїѕрїй, рїЦрЅЁрѕЇрѕЇ
­ЪЊю	рѕйрЅЦрѕЇрѕЇ, рІѕрѕерЅђрЅх
­ЪЊё	рѕ░ріљрІх, рІѕрІ░ рѕІрІГ рІерЅ░рЅђрѕўрїа рІѕрѕерЅђрЅх, рїѕрїй
­ЪЊ░	рІѕрѕерЅђрЅх, рІюріЊ, рїІрІюрїБ
­ЪЌъ	рІѕрѕерЅђрЅх, рІюріЊ, рІерЅ░рїарЅђрѕѕрѕѕ рїІрІюрїБ, рїІрІюрїБ, рїЦрЅЁрѕЇ
­ЪЊЉ	рѕўрїйрѕљрЇЇрѕЮрѕЇріГрЅх, рѕЏрѕГріерѕГ, рѕЮрѕЇріГрЅх, рЅхрѕ«рЅй, ріЦрѕЇрЅБрЅх рѕЏрІхрѕерїірІФ рЅхрѕ«рЅй
­Ъћќ	рѕЮрѕЇріГрЅх, ріЦрѕЇрЅБрЅх
­ЪЈи	рѕўрѕѕрІФ
­Ъњ░	рЅдрѕГрѕ│, рІерїѕріЋрІўрЅЦ ріерѕерїбрЅх, рІХрѕІрѕГ, рїѕріЋрІўрЅЦ
­Ъњ┤	рѕўріГрЇѕрІФ, рѕЮріЋрІЏрѕг, рІеріЋ рІерІѕрѕерЅђрЅх рїѕріЋрІўрЅЦ, рІерІѕрѕерЅђрЅх рїѕріЋрІўрЅЦ, рїѕріЋрІўрЅЦ
­Ъњх	рѕўріГрЇѕрІФ, рѕЮріЋрІЏрѕг, рІерІѕрѕерЅђрЅх рїѕріЋрІўрЅЦ, рІХрѕІрѕГ, рІХрѕІрѕГ рІерІѕрѕерЅђрЅх рїѕріЋрІўрЅЦ, рїѕріЋрІўрЅЦ
­ЪњХ	рѕўріГрЇѕрІФ, рѕЮріЋрІЏрѕг, рІѕрѕерЅђрЅх рїѕріЋрІўрЅЦ, рІЕрѕ«, рІЕрѕ« рІерІѕрѕерЅђрЅх рїѕріЋрІўрЅЦ, рїѕріЋрІўрЅЦ
­Ъњи	рѕўріГрЇѕрІФ, рѕЮріЋрІЏрѕг, рІерІѕрѕерЅђрЅх рїѕріЋрІўрЅЦ, рїѕріЋрІўрЅЦ, рЇЊрІЇріЋрІх рІерІѕрѕерЅђрЅх рїѕріЋрІўрЅЦ
­ЪњИ	рѕўріГрЇѕрІФ, рЅЦрѕерѕГ, ріГріЋрЇЇ рІФрѕѕрІЇ рїѕріЋрІўрЅЦ, рІерІѕрѕерЅђрЅх рїѕріЋрІўрЅЦ, рїѕріЋрІўрЅЦ
­Ъњ│	рЅБріЋріГ, ріФрѕГрЅ│, ріГрѕгрІ▓рЅх, ріГрѕгрІ▓рЅх ріФрѕГрІх, рїѕріЋрІўрЅЦ
­ЪДЙ	рѕѓрѕ│рЅЦ ріарІФрІФрІЮ, рѕЏрѕерїІрїѕрїФ, рѕЏрѕхрѕерїЃ, рІерѕўрІЮрїѕрЅЦ ріарІФрІФрІЮ, рІ░рѕерѕ░ріЮ
­Ъњ╣	рѕ░ріЋрїарѕерІЦ, ріерІеріЋ рїІрѕГ рІерѕџрїерѕЮрѕГ рѕ░ріЋрїарѕерІЦ, рІЋрІхрїѕрЅх, рІеріЋ, рїѕріЋрІўрЅЦ
­Ъњ▒	рѕЮріЋрІЏрѕг, рЅБріЋріГ, рІерІЇрїГ рѕЮріЋрІЏрѕг, рїѕріЋрІўрЅЦ
­Ъњ▓	рѕЮріЋрІЏрѕг, рІѕрЇЇрѕФрѕЮ рІерІХрѕІрѕГ рѕЮрѕЇріГрЅх, рІХрѕІрѕГ, рїѕріЋрІўрЅЦ
РюЅ	рібрѕюрІГрѕЇ, ріцріЋрЅерѕјрЇЋ
­ЪЊД	рібрѕюрІГрѕЇ, рІ░рЅЦрІ│рЅц, рЇќрѕхрЅ│
­ЪЊе	рЅ░рЅђрЅарѕЇ, рібрѕюрІГрѕЇ, ріцріЋрЅгрѕјрЇЋ, рІ░рЅЦрІ│рЅц, рїѕрЅб, рїѕрЅб ріцріЋрЅерѕјрЇЋ
­ЪЊЕ	рѕюрІГрѕЇ, рЅђрѕхрЅх, рЅБрѕѕ рЅђрѕхрЅх ріцріЋрЅерѕјрЇЋ, рІѕрїф, рІ░рЅЦрІ│рЅц, рЇќрѕхрЅ│
­ЪЊц	рѕБрїЦріЋ, рЅ░рѕЇрі│рѕЇ, рІѕрїф рѕўрѕЇріЦріГрЅх рѕБрїЦріЋ, рІерІѕрїф ріцріЋрЅерѕјрЇЋ рѕЏрѕхрЅђрѕўрїФ рЅхрѕф, рІ░рЅЦрІ│рЅц, рЇќрѕхрЅ│
­ЪЊЦ	рѕБрїЦріЋ, рЅ░рЅђрЅарѕЇ, рІерїѕрЅб ріцріЋрЅерѕјрЇЋ рѕЏрѕхрЅђрѕўрїФ рЅхрѕф, рІ░рЅЦрІ│рЅц, рїѕрЅб рѕўрѕЇріЦріГрЅх рѕБрїЦріЋ, рЇќрѕхрЅ│
­ЪЊд	рѕБрїЦріЋ, рїЦрЅЁрѕЇ
­ЪЊФ	рЅБріЋрІ▓рѕФ рІерЅ░рѕ░рЅђрѕѕрЅарЅх рІерЅ░рІўрїІ рІерЇќрѕхрЅ│ рѕ│рїЦріЋ, рІерЅ░рІўрїІ, рЇќрѕхрЅ│, рЇќрѕхрЅ│ рѕБрїЦріЋ, рЇќрѕхрЅ│ рЅцрЅх рѕБрїЦріЋ
­ЪЊф	рЅБріЋрІ▓рѕФ рІерІѕрѕерІ░рЅарЅх рІерЅ░рІўрїІ рІерЇќрѕхрЅ│ рѕ│рїЦріЋ, рІЮрЅЁ рІФрѕѕ, рІерЅ░рІўрїІ, рЇќрѕхрЅ│, рЇќрѕхрЅ│ рѕБрїЦріЋ, рЇќрѕхрЅ│ рЅцрЅх рѕБрїЦріЋ
­ЪЊг	рЅБріЋрІ▓рѕФ рІерЅ░рѕ░рЅђрѕѕрЅарЅх ріГрЇЇрЅх рІерЇќрѕхрЅ│ рѕ│рїЦріЋ, ріГрЇЇрЅх, рЇќрѕхрЅ│, рЇќрѕхрЅ│ рѕБрїЦріЋ, рЇќрѕхрЅ│ рЅцрЅх рѕБрїЦріЋ
­ЪЊГ	рЅБріЋрІ▓рѕФ рІерІѕрѕерІ░рЅарЅх ріГрЇЇрЅх рІерЇќрѕхрЅ│ рѕ│рїЦріЋ, ріГрЇЇрЅх, рІЮрЅЁ рІФрѕѕ, рЇќрѕхрЅ│, рЇќрѕхрЅ│ рѕБрїЦріЋ
­ЪЊ«	рЇќрѕхрЅ│, рЇќрѕхрЅ│ рѕБрїЦріЋ, рЇќрѕхрЅ│ рѕ│рїЦріЋ
­ЪЌ│	рѕБрїЦріЋ, рІерІхрѕЮрЇЁ рѕўрѕхрїФ рѕ│рїЦріЋ ріерІхрѕЮрЇЁ рѕўрѕхрїФ ріФрѕГрІх рїІрѕГ, рІерІхрѕЮрЇЁ ріФрѕГрІх
РюЈ	ріЦрѕГрѕ│рѕх
Рюњ	ріЦрѕхріфрЅЦрѕГрЅХ, рІерЅЦрІЋрѕГ рїФрЇЇ, рїЦрЅЂрѕГ рІерЅЦрІЋрѕГ рїФрЇЇ
­ЪќІ	ріЦрѕхріфрЅЦрѕГрЅХ, рЇІрІЇріЋрЅ┤ріЋ, рЇІрІЇріЋрЅ┤ріЋ рЇћріЋ
­Ъќі	ріЦрѕхріфрЅЦрѕГрЅХ, рі│рѕхріљрїЦрЅЦ
­Ъќї	рЅЁрЅЦ рѕЦрІЋрѕЇ рѕЦрѕФ, рІерѕарІЊрѕі рЅЦрѕЕрѕй
­ЪќЇ	рІерѕўрї╗рЇірІФ ріерѕѕрѕГ
­ЪЊЮ	рѕЏрѕхрЅ│рІѕрѕ╗, ріЦрѕГрѕ│рѕх
­Ъњ╝	рЅдрѕГрѕ│
­ЪЊЂ	ріарЅЃрЇі, рІерЇІрІГрѕЇ ріарЅЃрЇі, рЇІрІГрѕЇ
­ЪЊѓ	ріарЅЃрЇі, ріГрЇЇрЅх, ріГрЇЇрЅх рІерЇІрІГрѕЇ ріарЅЃрЇі, рЇІрІГрѕЇ
­ЪЌѓ	рѕўрїЦрЅЂрѕЮ, ріерЇІрЇІрІ«рЅй, ріФрѕГрЅ│, ріФрѕГрІх рѕўрїЦрЅЂрѕЮ ріерЇІрЇІрІ«рЅй
­ЪЊЁ	рЅђріЋ рѕўрЅЂрїарѕфрІФ, рІЋрѕѕрЅх
­ЪЊє	рЅђріЋ рѕўрЅЂрїарѕфрІФ, рЅ░рЅђрІ│рїЁ рЅђріЋ рѕўрЅЂрїарѕфрІФ
­ЪЌњ	рѕЏрѕхрЅ│рІѕрѕ╗, рѕ░рѕїрІ│, рЅБрѕѕрѕйрЅд, рЅБрѕѕрѕйрЅд рѕЏрѕхрЅ│рІѕрѕ╗ рІ░рЅЦрЅ░рѕГ
­ЪЌЊ	рѕ░рѕїрІ│, рЅђріЋ рѕўрЅЂрїарѕфрІФ, рЅБрѕѕрѕйрЅд, рЅБрѕѕрѕйрЅд рЅђріЋ рѕўрЅЂрїарѕфрІФ
­ЪЊЄ	рѕўрїЦрЅЂрѕЮ, рѕ«рѕјрІ┤ріГрѕх, ріФрѕГрЅ│, ріФрѕГрІх рѕўрїЦрЅЂрѕЮ
­ЪЊѕ	рѕ░ріЋрїарѕерІЦ, ріарІЮрѕЏрѕџрІФ, рІЋрІхрїѕрЅх, рІерѕџрїерѕЮрѕГ рїѕрЅарЅ│, рїѕрЅарЅ│
­ЪЊЅ	рѕ░ріЋрїарѕерІЦ, рЅ│рЅй, ріарІЮрѕЏрѕџрІФ, рІерѕџрЅђріЋрѕх рїѕрЅарЅ│, рїѕрЅарЅ│
­ЪЊі	рѕ░ріЋрїарѕерІЦ, рЅБрѕѕ ріарѕърѕї рїѕрЅарЅ│, ріарѕърѕї, рїѕрЅарЅ│
­ЪЊІ	рІѕрѕерЅђрЅх рѕЏрѕхрІ░рїѕрЇірІФ
­ЪЊї	ріЦрѕхрЇњрѕЇ, рЇЉрѕй ріЦрѕхрЇњрѕЇ
­ЪЊЇ	ріЦрѕхрЇњрѕЇ, ріГрЅЦ рЇЉрѕй ріЦрѕхрЇњрѕЇ, рЇЉрѕй ріЦрѕхрЇњрѕЇ
­ЪЊј	рІѕрѕерЅђрЅх рѕЏрІФрІФрІБ
­ЪќЄ	ріарІФрІГрІЮ, рІерЅ░рІФрІФрІЎ рІерІѕрѕерЅђрЅх ріГрѕірЇќрЅй, рІерІѕрѕерЅђрЅх ріГрѕірЇЋ
­ЪЊЈ	рѕЏрѕхрѕўрѕфрІФ, рЅђрїЦ рІФрѕѕ рѕЏрѕхрѕўрѕфрІФ
­ЪЊљ	рѕЏрѕхрѕўрѕфрІФ, рѕдрѕхрЅх рѕЏрІЋрІўріЋ, рѕхрЅЦрѕхрЅЦ, рЅБрѕѕ рѕдрѕхрЅх рѕЏрІЋрІўріЋ рѕЏрѕхрѕўрѕфрІФ
Рюѓ	рѕўрѕБрѕфрІФ, рѕўрЅђрѕх
­ЪЌЃ	рѕБрїЦріЋ, ріФрѕГрЅ│, рІеріФрѕГрІх рЇІрІГрѕЇ рѕ│рїЦріЋ, рЇІрІГрѕЇ
­ЪЌё	ріФрЅбріћрЅх, рЇІрІГрѕЇ, рЇІрІГрѕЇ ріФрЅбріћрЅх
­ЪЌЉ	рІерЅєрѕ╗рѕ╗ рѕўрїБрІФ
­Ъћњ	рѕўрѕИрїјрїФ, рІерЅ░рІўрїІ
­ЪћЊ	рѕўріГрЇѕрЅх, рЅЂрѕЇрЇЇ, ріГрЇЇрЅх, ріГрЇЇрЅх рѕўрѕИрїјрїФ
­ЪћЈ	рѕўрѕИрїјрїФ ріерЅЦрІЋрѕГ рїІрѕГ, рЅђрѕѕрѕЮ, рЅЂрѕЇрЇЇ, ріЦрѕхріфрЅЦрѕГрЅХ, рІерЅЦрІЋрѕГ рїФрЇЇ, рїЇрѕІрІіріљрЅх
­Ъћљ	рЅЂрѕЇрЇЇ, рЅарЅЂрѕЇрЇЇ рІерЅ░рІўрїІ рѕўрѕИрїјрїФ, рІерЅ░рІўрїІ, рІ░рѕЁріЋріљрЅ▒ ріарѕхрЅ░рѕЏрѕЏріЮ
­ЪћЉ	рЅЂрѕЇрЇЇ, рІерІГрѕѕрЇЇ рЅЃрѕЇ
­ЪЌЮ	рѕйрѕЏрїЇрѕї, рЅЂрѕЇрЇЇ, ріарѕ«рїї рЅЂрѕЇрЇЇ, рЇЇріЋрїГ
­Ъће	рѕўрѕБрѕфрІФ, рѕўрІХрѕ╗
РЏЈ	рѕўрѕБрѕфрІФ, рѕЏрІЋрІхріЋ рѕЏрІЇрїБрЅх, ріаріљрѕхрЅ░ріЏ рІХрѕЏ
Рџњ	рѕўрѕБрѕфрІФ, рѕўрІХрѕ╗, рѕўрІХрѕ╗ ріЦріЊ ріаріљрѕхрЅ░ріЏ рІХрѕЏ, ріаріљрѕхрЅ░ріЏ рІХрѕЏ
­ЪЏа	рѕўрѕБрѕфрІФ, рѕўрІХрѕ╗, рѕўрІХрѕ╗ ріЦріЊ рѕўрЇЇрЅ╗, рѕўрЇЇрЅ╗
­ЪЌА	рЅбрѕІрІІ, ріаріљрѕхрЅ░ріЏ рѕ░рІГрЇЇ, рїдрѕГ рѕўрѕБрѕфрІФ
Рџћ	рѕ░рІГрЇјрЅй, рІерЅ░рїарѕІрѕѕрЇЅ рѕ░рІГрЇјрЅй, рІерЅ░рїБрѕўрѕе, рїдрѕГ рѕўрѕБрѕфрІФ
­ЪћФ	рѕўрѕБрѕфрІФ, рѕфрЅ«рѕЇрЅерѕГ, рѕйрїЅрїЦ, рїдрѕГ рѕўрѕБрѕфрІФ
­ЪЈ╣	рѕўрѕЇрѕЁрЅЁ, рѕ│рїѓрЅ│рѕфрІерѕх, рЅђрѕхрЅх, рІърІ▓рІФріГ, рІ░рїІріЋ ріЦріЊ рЅђрѕхрЅх
­ЪЏА	рїІрѕ╗, рїдрѕГ рѕўрѕБрѕфрІФ
­ЪћД	рѕўрѕБрѕфрІФ, рѕўрЇЇрЅ╗
­ЪћЕ	рѕўрѕБрѕфрІФ, рѕЏрЇѕріЏ, рІ│рІХ, рІ│рІХ ріЦріЊ рѕЏрЇѕріЏ
РџЎ	рѕўрѕБрѕфрІФ, рѕърЅ░рѕГ рїЦрѕГрѕх
­ЪЌю	рѕўрѕБрѕфрІФ, рѕўрїерЇЇрѕѕрЅѓрІФ, ріГрЇІрЅх
Рџќ	рѕірЅЦрѕФ, рѕџрІЏріЋ, ріГрЅЦрІ░рЅх, рІърІ▓рІФріГ, рІерЅ░рѕўрїБрїаріљ
­ЪћЌ	рѕЏрїѕріЊріЏ
РЏЊ	рѕ░ріЋрѕ░рѕѕрЅх, рѕ░ріЋрѕ░рѕѕрЅХрЅй
­ЪД░	рѕўрѕ│рѕфрІФ, рѕюріФріњріГ, рѕ│рїЦріЋ, рІерѕўрЇЇрЅ╗ рѕ│рїЦріЋ
­ЪД▓	рѕўрѕ│рѕ│рЅЦ, рѕЏрїЇріћрЅ▓ріГ, рѕЏрїЇріћрЅх, рІерЇѕрѕерѕх рїФрѕЏ
РџЌ	рѕўрѕБрѕфрІФ, ріарѕѕрѕЮрЅбріГ, рігрѕЮрѕхрЅхрѕф
­ЪДф	рѕўрЇѕрЅ░ріЏ рЅ▒рЅд, рѕЎріерѕФ, рѕ│рІГріЋрѕх, рЅђрѕЏрѕџ, рігрѕџрѕхрЅхрѕф, рІерѕЎріерѕФ ріГрЇЇрѕЇ
­ЪДФ	рЅБрѕЁрѕЇ, рЅБріГрЅ┤рѕфрІФ, рЅБрІ«рѕјрїѓ, рЅцрЅ░ рѕЎріерѕФ, рІерЇћрЅхрѕф рІ▓рѕй
­ЪДг	рѕЁрІГрІѕрЅх, рѕѕрІЇрїЦ, рІерЅБрІ«рѕјрїѓ рѕ░рІЇ, рІ▓ріцріЋріц, рїёріћрЅ▓ріГрѕх, рїЁріЋ
­Ъћг	рѕўрѕБрѕфрІФ, рѕЏрІГріГрѕ«рѕхрі«рЇЋ
­ЪћГ	рѕўрѕБрѕфрІФ, рЅ┤рѕїрѕхрі«рЇЋ
­ЪЊА	рѕ│рЅ░рѕІрІГрЅх, рѕ│рЅ░рѕІрІГрЅх ріаріЋрЅ┤ріЊ, ріаріЋрЅ┤ріЊ, рІ▓рѕй
­ЪњЅ	рѕЋріГрѕЮріЊ, рѕўрѕГрЇї, рѕхрѕфріЋрїЁ, рЅ░ріЕрѕх, рІерЅ│рѕўрѕў
­Ъњі	рѕЋріГрѕЮріЊ, ріГріњріЋ, рІерЅ│рѕўрѕў, рІХріГрЅ░рѕГ
­Ъџф	рЅарѕГ
­ЪЏЈ	рѕєрЅ┤рѕЇ, ріарѕЇрїІ, ріЦріЋрЅЁрѕЇрЇЇ
­ЪЏІ	рѕєрЅ┤рѕЇ, рѕўрЅЦрѕФрЅх, рѕХрЇІ, рѕХрЇІ ріЦріЊ рѕўрЅЦрѕФрЅх
­Ъџй	рѕйріЋрЅх рЅцрЅх
­Ъџ┐	рѕ╗рІѕрѕГ, рІЇрѕЃ
­ЪЏЂ	рІерїѕрѕІ рѕўрЅ│рїарЅбрІФ рїѕріЋрІ│, рїѕрѕІріЋ рѕўрЅ│рїарЅЦ
­ЪД┤	рѕ╗рѕЮрЇќ, рЅЁрЅБрЅх, рІерЅЁрЅБрЅх рїарѕГрѕЎрѕх, рІерїИрѕЃрІГ рЅЁрЅБрЅх
­ЪДи	рѕўрѕГрЇї рЅЂрѕЇрЇЇ, рІерЅ░рѕЇрЅБ ріЦрїЇрѕГ, рЇљріЋріГ рѕ«ріГ
­ЪД╣	рѕўрїЦрѕерїірІФ, рѕўрїЦрѕерїЇ, рѕЏрїйрІ│рЅх, ріарѕхрѕЏрЅ░ріЏ
­ЪД║	рѕЇрЅЦрѕх рѕЏрїарЅбрІФ, рѕйрѕГрѕйрѕГ, рЅЁрѕГрїФрЅх, ріЦрѕГрѕ╗
­ЪД╗	рѕХрЇЇрЅх, рІерІѕрѕерЅђрЅх рїЦрЅЁрѕЇ, рІерІѕрѕерЅђрЅх рЇјрїБ
­ЪД╝	рѕЏрїйрІ│рЅх, рѕ│рѕЎріЊ, рѕ╗рІѕрѕГ, ріарѕърѕї, ріарѕерЇІ, рІерѕ│рѕЎріЊ рѕ│рѕЁріЋ
­ЪДй	рѕўрѕЮрїарїЦ, рѕЏрїйрІ│рЅх, рѕхрЇќріЋрїЁ, рІѕріЋрЇірЅх
­ЪД»	рѕЏрїЦрЇірІФ, ріарїарЇІ, ріЦрѕ│рЅх, ріЦрѕ│рЅх рѕЏрїЦрЇірІФ
­ЪЏњ	рѕўрїѕрЅЦрІерЅх, рІерѕўрїѕрЅЦрІФ рїІрѕф, рїІрѕф
­Ъџг	рѕЏрїерѕх, рѕ▓рїІрѕФ
Рџ░	рѕърЅх, рѕгрѕ│ рѕБрїЦріЋ
Рџ▒	рѕЏрѕ░рѕ«, рѕърЅх, рЅђрЅЦрѕГ, рІерЅђрЅЦрѕГ рѕЏрѕ░рѕ«
­ЪЌ┐	рѕљрІЇрѕЇрЅх, рѕЏрідрІг рЇірЅх, рѕърІФрІг, рЇірЅх
­ЪЈД	рѕФрѕх-рѕ░рѕГ, рЅБріЋріГ, ріцрЅ▓ріцрѕЮ, рІеріцрЅ▓ріцрѕЮ рѕЮрѕЇріГрЅх, рїѕріЋрІўрЅЦ ріерЇІрІГ
­Ъџ«	рЅєрѕ╗рѕ╗, рЅєрѕ╗рѕ╗рѕБрїЦріЋ, рЅарЅєрѕ╗рѕ╗ рѕўрїБрІФ рїБрѕЅ рѕЮрѕЇріГрЅх
­Ъџ░	рІЇрѕЃ, рІерѕџрїарїБ, рІерѕџрїарїБ рІЇрѕЃ, рїарїБ
РЎ┐	рѕўрІ│рѕерѕ╗, рІеріаріФрѕЇ рїЅрІ│рЅ░ріЏ рІірѕЇрЅИрѕГ
­Ъџ╣	рѕўрїИрІ│рїЃ, рѕйріЋрЅх рЅцрЅх, рІѕріЋрІх, рІерІѕріЋрІх рѕўрїИрІ│рїЃ, рІ░рЅЦрѕЇрІЕ рѕ▓
­Ъџ║	рѕўрїИрІ│рїЃ, рѕ┤рЅх, рѕйріЋрЅх рЅцрЅх, рІерѕ┤рЅх рѕўрїИрІ│рїЃ, рІ░рЅЦрѕЇрІЕ рѕ▓
­Ъџ╗	рѕўрїИрІ│рїЃ рЅцрЅх, рѕйріЋрЅх рЅцрЅх, рІ░рЅЦрѕЇрІЕ рѕ▓
­Ъџ╝	рѕЋрЇЃріЋ, рѕўрѕѕрІѕрїЦ, рІерѕЋрЇЃріЋ рѕЮрѕЇріГрЅх
­ЪџЙ	рѕўрїИрІ│рїЃ, рЅЂрѕЮ рѕБрїЦріЋ, рЅБріъ рЅцрЅх, рІЇрѕЃ, рІ░рЅЦрѕЇрІЕ рѕ▓
­ЪЏѓ	рѕўрЅєрїБрїарѕфрІФ, рІерЇќрѕхрЇќрѕГрЅх рѕўрЅєрїБрїарѕфрІФ, рЇќрѕхрЇќрѕГрЅх
­ЪЏЃ	рїЅрѕЮрѕЕріГ
­ЪЏё	рѕўрїарІерЅѓрІФ, рѕ╗ріЋрїБ, рѕ╗ріЋрїБ рѕўрѕеріерЅбрІФ
­ЪЏЁ	рѕ╗ріЋрїБ, рЅ░рЅєрѕІрЇі рІерїЇрІхрїЇрІ│ рѕБрїЦріЋ, рІерЅ░рѕерѕ│ рѕ╗ріЋрїБ
Рџа	рѕЏрѕхрїаріЋрЅђрЅѓрІФ
­ЪџИ	рѕЇрїЁ, рѕЋрЇЃріЊрЅх рѕўріЋрїѕрІх рІФрЅІрѕГрїБрѕЅ, рѕўрѕ╗рїѕрѕГ, рЅхрѕФрЇіріГ, ріЦрїЇрѕеріЏ
РЏћ	рѕўрїЇрЅбрІФ, рѕўрїЇрЅБрЅх ріарІГрЅ╗рѕЇрѕЮ, рЅхрѕФрЇіріГ, ріарІГрІ░рѕѕрѕЮ, ріГрѕЇріГрѕЇ
­ЪџФ	рѕўрїЇрЅбрІФ, ріарІГ, ріарІГрІ░рѕѕрѕЮ, рІерЅ░ріерѕѕріерѕѕ
­Ъџ│	рЅЦрѕхріГрѕїрЅх, рЅЦрѕхріГрѕїрЅх ріарІГрЇѕрЅђрІхрѕЮ, рЅ░рѕйріерѕГріФрѕф, ріарІГрІ░рѕѕрѕЮ, ріГрѕЇріГрѕЇ
­ЪџГ	рѕЏрїерѕх, рѕЏрїерѕх ріГрѕЇріГрѕЇ ріљрІЇ, ріарІГрІ░рѕѕрѕЮ, ріГрѕЇріГрѕЇ, рІерЅ░ріерѕѕріерѕѕ
­Ъџ»	рЅєрѕ╗рѕ╗, рЅєрѕ╗рѕ╗ рѕўрїБрѕЇ ріГрѕЇріГрѕЇ ріљрІЇ, ріарІГ, ріарІГрІ░рѕѕрѕЮ, ріГрѕЇріГрѕЇ
­Ъџ▒	рІЇрѕЃ, рІерѕЏрІГріЋрЅђрѕ│рЅђрѕх, рІерѕЏрІГрїарїБ рІЇрѕЃ
­Ъџи	рѕѕріЦрїЇрѕеріърЅй ріарІГрЇѕрЅђрІхрѕЮ, ріарІГ, ріарІГрІ░рѕѕрѕЮ, ріЦрїЇрѕеріЏ, ріГрѕЇріГрѕЇ
­ЪЊх	рѕърЅБрІГрѕЇ, рѕърЅБрІГрѕЇ рѕхрѕЇрі«рЅй ріарІГрЇѕрЅђрІ▒рѕЮ, рѕхрѕЇріГ, рІерЅ░ріерѕѕріерѕѕ
­Ъћъ	18, ріарѕхрѕФ рѕхрѕЮріЋрЅх, ріеріарѕхрѕФ рѕхрѕЮріЋрЅх рІЊрѕўрЅх рЅарЅ│ ріарІГрЇѕрЅђрІхрѕЮ, ріеріарѕхрѕФ рѕхрѕЮріЋрЅх рІЊрѕўрЅх рЅарЅ│рЅй ріарІГрЇѕрЅђрІхрѕЮ, ріерІЋрІхрѕю рЅарЅ│рЅй, рІЋрІхрѕю рїѕрІ░рЅЦ
Рўб	рѕФрІ▓рІ«ріаріГрЅ▓рЅГ, рѕгрІ▓рІ«ріаріГрЅ▓рЅГ
РўБ	рѕЮрѕЇріГрЅх, рІерЅБрІ«рѕјрїѓріФрѕЇ ріарІ░рїѕріЏ рѕЮрѕЇріГрЅх
Ргє	рѕ░рѕюріЋ, рЅђрѕхрЅх, ріарЅЁрїБрїФ, ріФрѕГрІ▓ріЊрѕЇ, рІѕрІ░ рѕІрІГ рїарЅІрѕџ рЅђрѕхрЅх
РєЌ	рѕ░рѕюріЋ рѕЮрѕЦрѕФрЅЁ, рЅђрѕхрЅх, ріарЅЁрїБрїФ, рібріЋрЅ░рѕГріФрѕГрІ▓ріЊрѕЇ, рІѕрІ░ рѕІрІГ рЅђріЮ рїарЅІрѕџ рЅђрѕхрЅх
РъА	рѕЮрѕЦрѕФрЅЁ, рЅђрѕхрЅх, ріарЅЁрїБрїФ, ріФрѕГрІ▓ріЊрѕЇ, рІѕрІ░ рЅђріЮ рїарЅІрѕџ рЅђрѕхрЅх
Рєў	рЅђрѕхрЅх, ріарЅЁрїБрїФ, рібріЋрЅ░рѕГріФрѕГрІ▓ріЊрѕЇ, рІѕрІ░ рЅ│рЅй рЅђріЮ рїарЅІрѕџ рЅђрѕхрЅх, рІ░рЅАрЅЦ рѕЮрѕЦрѕФрЅЁ
РгЄ	рЅђрѕхрЅх, рЅ│рЅй, ріарЅЁрїБрїФ, ріФрѕГрІ▓ріЊрѕЇ, рІѕрІ░ рЅ│рЅй рїарЅІрѕџ рЅђрѕхрЅх, рІ░рЅАрЅЦ
РєЎ	рЅђрѕхрЅх, ріарЅЁрїБрїФ, рібріЋрЅ░рѕГріФрѕГрІ▓ріЊрѕЇ, рІѕрІ░ рЅ│рЅй рїЇрѕФ рїарЅІрѕџ рЅђрѕхрЅх, рІ░рЅАрЅЦ рѕЮрІЋрѕФрЅЦ
РгЁ	рѕЮрІЋрѕФрЅЦ, рЅђрѕхрЅх, ріарЅЁрїБрїФ, ріФрѕГрІ▓ріЊрѕЇ, рІѕрІ░ рїЇрѕФ рїарЅІрѕџ рЅђрѕхрЅх
Рєќ	рѕ░рѕюріЋ рѕЮрІЋрѕФрЅЦ, рЅђрѕхрЅх, ріарЅЁрїБрїФ, рібріЋрЅ░рѕГріФрѕГрІ▓ріЊрѕЇ, рІѕрІ░ рѕІрІГ рїЇрѕФ рїарЅІрѕџ рЅђрѕхрЅх
РєЋ	рЅђрѕхрЅх, рІѕрІ░ рѕІрІГ рЅ│рЅй рїарЅІрѕџ рЅђрѕхрЅх
Рєћ	рЅђрѕхрЅх, рїЇрѕФ-рЅђріЮ рїарЅІрѕџ рЅђрѕхрЅх
РєЕ	рЅђрѕхрЅх, рІѕрІ░ рїЇрѕФ рЅ│рїБрЇі рЅђріЮ рїарЅІрѕџ рЅђрѕхрЅх
Рєф	рЅђрѕхрЅх, рІѕрІ░ рЅђріЮ рЅ│рїБрЇі рїЇрѕФ рїарЅІрѕџ рЅђрѕхрЅх
Рц┤	рЅђрѕхрЅх, рІѕрІ░ рѕІрІГ рЅ│рїБрЇі рЅђріЮ рїарЅІрѕџ рЅђрѕхрЅх
Рцх	рЅђрѕхрЅх, рЅ│рЅй, рІѕрІ░ рЅ│рЅй рЅ│рїБрЇі рЅђріЮ рїарЅІрѕџ рЅђрѕхрЅх
­ЪћЃ	рЅђрѕхрЅх, рЅарѕ░рІЊрЅх ріарЅєрїБрїарѕГ ріарЅЁрїБрїФ, рЅарѕ░рІЊрЅх ріарІЪрІЪрѕГ ріарЅЁрїБрїФ рІФрѕЅ рЅђрїЦ рІФрѕЅ рЅђрѕхрЅХрЅй, рІ│рїЇрѕЮ рїФріЋ
­Ъћё	рЅђрѕхрЅх, рЅарѕ░рІЊрЅх ріарЅєрїБрїарѕГ ріарЅЁрїБрїФ рЅ░рЅЃрѕФріњ, рЅарѕ░рІЊрЅх ріарІЪрІЪрѕГ ріарЅЁрїБрїФ рЅ░рЅЃрѕФріњ рІФрѕЅ рЅђрѕхрЅХрЅй ріарІЮрѕФрѕГ, ріІрѕЇрІ«рѕй
­ЪћЎ	рЅђрѕхрЅх, рЅ░рѕўрѕѕрѕх, рЅ░рѕўрѕѕрѕх рЅђрѕхрЅх
­Ъћџ	рѕўрїерѕерѕ╗, рѕЏрЅЦрЅѓрІФ рЅђрѕхрЅх, рЅђрѕхрЅх
­ЪћЏ	рѕЮрѕЇріГрЅх, рЅђрѕхрЅх, рЅарѕГрЅирѕЇ! рЅђрѕхрЅх, ріарЅЦрѕФ
­Ъћю	рЅђрѕхрЅх, рЅарЅЁрѕГрЅА, рЅарЅЁрѕГрЅА рІГрѕўрїБрѕЇ рЅђрѕхрЅх
­ЪћЮ	рѕІрІГ, рЅђрѕхрЅх, ріерЇЇрЅ░ріЏ, ріерЇЇрЅ░ріЏ рїарЅІрѕџ рЅђрѕхрЅх
­ЪЏљ	рѕЏрѕЮрѕѕріГ, ріЃрІГрѕЏріќрЅх, рІеріарѕЮрѕЇрі« рЅдрЅ│
РџЏ	рѕўріЊрЇЇрЅЁ, ріарЅ░рѕЮ, рІеріарЅХрѕЮ рѕЮрѕЇріГрЅх
­ЪЋЅ	рѕѓріЋрІ▒, ріЃрІГрѕЏріќрЅх, рідріцрѕЮ
РюА	ріЃрІГрѕЏріќрЅх, ріарІГрѕЂрІ│рІі, ріарІГрѕЂрІх, рі«ріерЅЦ, рІерІ│рІірЅх рі«ріерЅЦ
РўИ	рѕўрІўрІЇрѕГ, рЅАрІхрѕѓрѕхрЅх, ріЃрІГрѕЏріќрЅх, рІерІ│рѕГрѕЏ рѕўрІўрІЇрѕГ, рІ│рѕЁрѕГрѕЏ
Рў»	рЅ│рід, рЅ│рідрІГрѕхрЅх, ріЃрІГрѕЏріќрЅх, рІЕріЋ рІФріЋрїЇ, рІфріЋ, рІФріЋрїЇ
РюЮ	рѕўрѕхрЅђрѕЇ, ріЃрІГрѕЏріќрЅх, ріГрѕГрѕхрЅхрІФріЋ, рІерѕІрЅ▓ріЋ рѕўрѕхрЅђрѕЇ
Рўд	рѕўрѕхрЅђрѕЇ, ріЃрІГрѕЏріќрЅх, ріГрѕГрѕхрЅхрІФріЋ, рІерідрѕГрЅХрІХріГрѕх рѕўрѕхрЅђрѕЇ
Рўф	рѕЎрѕхрѕірѕЮ, ріЃрІГрѕЏріќрЅх, ріЦрѕхрѕІрѕЮ, рі«ріерЅЦ ріЦріЊ рїЇрѕЏрѕй рїерѕерЅЃ
Рў«	рѕ░рѕІрѕЮ, рІерѕ░рѕІрѕЮ рѕЮрѕЇріГрЅх
­ЪЋј	рѕюріќрѕФрѕЃ, ріЃрІГрѕЏріќрЅх, ріФріЋрІхрѕЇрЅАрѕерѕЮ, рІерѕ╗рѕЏ рѕўрЅЁрѕерІЮ
­Ъћ»	рѕђрЅЦрЅх, рЅБрѕѕріљрїЦрЅЦ рѕхрІхрѕхрЅх ріаріЋрїЊ рі«ріерЅЦ, рі«ріерЅЦ
РЎѕ	ріцрѕфрѕх, рІѕріЋрІх рЅарїЇ, рІърІ▓рІФріГ
РЎЅ	рЅарѕг, рЅ│рІЇрѕерѕх, рі«рѕГрѕЏ, рІърІ▓рІФріГ
РЎі	рѕўріЋрЅхрІ«рЅй, рІърІ▓рІФріГ, рїёрѕџріњ
РЎІ	ріФріЋрѕ░рѕГ, ріГрѕФрЅЦ, рІърІ▓рІФріГ
РЎї	рѕірІ«, ріаріЋрЅарѕ│, рІърІ▓рІФріГ
РЎЇ	рЅфрѕГрїј, рі«рѕерІ│, рІърІ▓рІФріГ, рІхріЋрїЇрѕЇ
РЎј	рѕірЅЦрѕФ, рѕџрІЏріЋ, рІърІ▓рІФріГ, рІерЅ░рѕўрїБрїаріљ, рЇЇрЅхрѕЋ
РЎЈ	рѕхрі«рѕГрЇњрІ«, рѕхрі«рѕГрЇњрІ«ріЋ, рІърІ▓рІФріГ
РЎљ	рѕўрѕЇрѕЁрЅЁ, рѕ│рїѓрЅ│рѕфрІерѕх, рІърІ▓рІФріГ
РЎЉ	ріФрЇЋрѕфрі«рѕГріЋ, рІърІ▓рІФріГ, рЇЇрІерѕЇ
РЎњ	рЅ░рѕИріФрѕџ, ріарі│рІГрѕерѕх, рІЇрѕЃ, рІърІ▓рІФріГ
РЎЊ	рІЊрѕБ, рІърІ▓рІФріГ, рЇЊрІГрѕ▓рѕх
РЏј	рЅ░рѕИріФрѕџ, ріЦрЅБрЅЦ, рідрЇірІЕрЅ╣рѕх, рІърІ▓рІФріГ
­Ъћђ	рЅђрѕхрЅх, рЅхрѕФрі«рЅйріЋ рЅарІЇрІЮ ріарІЮрѕФрѕГ, рІерЅ░рїБрѕўрѕе
­ЪћЂ	рЅђрѕхрЅх, рЅарѕ░рІЊрЅх ріарЅєрїБрїарѕГ ріарЅЁрїБрїФ, рІхрїѕрѕЮ, рІхрїѕрѕЮ ріарІЮрѕФрѕГ
­Ъћѓ	рЅђрѕхрЅх, рЅарѕ░рІЊрЅх ріарЅєрїБрїарѕГ ріарЅЁрїБрїФ, ріљрїарѕІ рІхрїѕрѕЮ ріарІЮрѕФрѕГ, ріаріЋрІ┤
РќХ	рѕдрѕхрЅх рѕЏрІЋрІўріЋ, рЅђрѕхрЅх, рЅђріЮ, ріарїФрІЇрЅх, рІеріарїФрІЇрЅх ріарІЮрѕФрѕГ
РЈЕ	рЅђрѕхрЅх, рІѕрІ░рЇірЅх ріарѕ│рѕЇрЇЇ, рІѕрІ░рЇірЅх ріарѕ│рѕЇрЇЇ ріарІЮрѕФрѕГ, рІхрѕГрЅЦ, рЇѕрїБріЋ
РЈГ	рѕдрѕхрЅх рѕЏрІЋрІўріЋ, рЅђрѕхрЅх, рЅђрїБрІГ рЅхрѕФріГ, рЅђрїБрІГ рЅхрѕФріГ ріарІЮрѕФрѕГ, рЅђрїБрІГ рЅхрІЋрІГріЋрЅх
РЈ»	рѕІрЇЇрЅ│ рїЇрЅ│, рѕдрѕхрЅх рѕЏрІЋрІўріЋ, рЅђрѕхрЅх, ріарїФрІЇрЅх, ріарїФрІЇрЅх рІѕрІГрѕЮ рѕІрЇЇрЅ│ рїЇрЅ│ ріарІЮрѕФрѕГ
РЌђ	рѕдрѕхрЅх рѕЏрІЋрІўріЋ, рЅђрѕхрЅх, рІѕрІ░ ріІрѕІ рѕўрѕЇрѕх ріарІЮрѕФрѕГ, рїѕрѕЇрЅЦрїЦ, рїЇрѕФ
РЈф	рЅђрѕхрЅх, рІѕрІ░ ріІрѕІ ріарїаріЋрїЦріЋ, рІѕрІ░ріІрѕІ рЅарЇЇрїЦріљрЅх рѕўрѕЇрѕх ріарІЮрѕФрѕГ, рІхрѕГрЅЦ
РЈ«	рѕдрѕхрЅх рѕЏрІЋрІўріЋ, рЅђрѕхрЅх, рЅђрІ│рѕџ рЅхрѕФріГ, рЅђрІ│рѕџ рЅхрІЋрІГріЋрЅх, рІерѕўрїерѕерѕ╗рІЇ рЅхрѕФріГ рѕІрІГ рѕѓрІх ріарІЮрѕФрѕГ
­Ъћ╝	рЅђрѕхрЅх, рЅђрІГ, ріарІЮрѕФрѕГ, рІерѕІрІГ ріарІЮрѕФрѕГ
РЈФ	рЅђрѕхрЅх, рІѕрІ░ рѕІрІГ рЅарЇЇрїЦріљрЅх рѕѓрІх ріарІЮрѕФрѕГ, рІхрѕГрЅЦ
­Ъћй	рЅђрѕхрЅх, рЅђрІГ, рЅ│рЅй, ріарІЮрѕФрѕГ, рІѕрІ░ рЅ│рЅй ріарІЮрѕФрѕГ
РЈг	рЅђрѕхрЅх, рЅ│рЅй, рІѕрІ░ рЅ│рЅй рЅарЇЇрїЦріљрЅх рѕѓрІх ріарІЮрѕФрѕГ, рІхрѕГрЅЦ
РЈИ	рѕІрЇЇрЅ│ рїЇрЅ│, рѕІрЇЇрЅ│ рїЇрЅ│ ріарІЮрѕФрѕГ, рЅЂрѕЇрЅЂрѕЇ, ріарѕърѕї, рІхрѕГрЅЦ
РЈ╣	ріарЅЂрѕЮ, ріарЅЂрѕЮ ріарІЮрѕФрѕГ, ріФрѕг
РЈ║	рЅЁрІ│, рЅЁрІ│ ріарІЮрѕФрѕГ, ріГрЅЦ
РЈЈ	ріарѕхрІѕрїБ, ріарѕхрІѕрїБ ріарІЮрѕФрѕГ
­Ъјд	рѕ▓ріњрѕЏ, ріФрѕюрѕФ, рЇірѕЇрѕЮ
­ЪћЁ	рЅЦрѕЕрѕЁріљрЅх, ріарїерѕЇрѕЮ, ріарїерѕЇрѕЮ ріарІЮрѕФрѕГ, рІЮрЅЁ
­Ъћє	рЅЦрѕЕрѕЁ, рЅЦрѕЕрѕЁ ріарІхрѕГрїЇ ріарІЮрѕФрѕГ, рЅЦрѕЕрѕЁріљрЅх
­ЪЊХ	рѕърЅБрІГрѕЇ, рѕхрѕЇріГ, ріарѕърѕї, ріаріЋрЅ┤ріЊ, ріаріЋрЅ┤ріЊ ріарѕърѕїрІјрЅй
­ЪЊ│	рѕЂріљрЅ│, рѕърЅБрІГрѕЇ, рѕхрѕЇріГ, рЅ┤рѕїрЇјріЋ, ріЋрІЮрѕерЅх, рІеріЋрІЮрѕерЅх рѕЂріљрЅ│
­ЪЊ┤	рѕърЅБрІГрѕЇ, рѕърЅБрІГрѕЇ рѕхрѕЇріГ рІГрїЦрЇІ, рѕхрѕЇріГ, рЅ░ріЋрЅђрѕ│рЅЃрѕй, рЅ┤рѕїрЇјріЋ, ріарїЦрЇІ
РЎђ	рѕ┤рЅх, рІерѕ┤рЅх рѕЮрѕЇріГрЅх
РЎѓ	рѕ░рІЇ, рІѕріЋрІх, рІерІѕріЋрІх рѕЮрѕЇріГрЅх
РџЋ	рѕўрІхрѕЃріњрЅх, рІерѕўрІхрѕЃріњрЅх рѕЮрѕЇріГрЅх, рІерѕхрѕФ рЅБрѕЇрІ░рѕерЅБ
РЎЙ	ріарѕѕрѕЮ ріарЅђрЇЇ, ріЦрѕхріе рѕўрїерѕФрѕ╗рІЇ, рІѕрѕ░ріЋ рІерѕїрѕѕрІЇ, рІФрѕЇрЅ░рїѕрІ░рЅа
РЎ╗	рѕўрѕЇрѕХ рѕўрїарЅђрѕЮ, рІерѕўрѕЇрѕХ рїЦрЅЁрѕЮ рѕІрІГ рѕЏрІІрѕЇ рѕЮрѕЇріГрЅх
Рџю	рІерѕЏрїїрїФ рѕЮрѕЇріГрЅх
­Ъћ▒	рѕўрѕЇрѕЁрЅЁ, рѕўрѕБрѕфрІФ, рѕўрѕГріерЅЦ, рЅхрѕфрІ░ріЋрЅх, рЅхрѕфрІ░ріЋрЅх ріарѕГрѕЏ, ріарѕГрѕЏ
­ЪЊЏ	рѕхрѕЮ, рІерѕхрѕЮ рѕўрѕѕрІФ
­Ъћ░	рЅЁрїарѕЇ, рІерїЃрЇЊріЋ, рІерїЃрЇЊріЋ рІерїђрѕЏрѕф рѕЮрѕЇріГрЅх, рїђрѕЏрѕф рѕ╝рЅГрѕ«ріЋ
РГЋ	рід, ріГрЅЦ, рІѕрЇЇрѕФрѕЮ рїЇрІЎрЇЇ ріГрЅЦ
РюЁ	рѕЮрѕЇріГрЅх, ріљрїГ рІѕрЇЇрѕФрѕЮ рѕЮрѕЇріГрЅх рѕЏрІхрѕерїірІФ, рЇѕрЅхрѕй
РўЉ	рѕБрїЦріЋ, рІерІхрѕЮрЇЁ рѕўрѕхрїФ рѕ│рїЦріЋ ріерѕЮрѕЇріГрЅх рѕЏрІхрѕерїірІФ рїІрѕГ, рІерІхрѕЮрЇЁ ріФрѕГрІх, рЇѕрЅхрѕй
Рюћ	рѕЮрѕЇріГрЅх, рІѕрЇЇрѕФрѕЮ рѕЮрѕЇріГрЅх рѕЏрІхрѕерїірІФ, рЇѕрЅхрѕй
Рюќ	рѕЏрЅБрІЏрЅх, рЅ░рІѕрІЇ, ріарЅБрІЏ, рІѕрЇЇрѕФрѕЮ рІерѕЏрЅБрІЏрЅх рѕЮрѕЇріГрЅх
РЮї	рѕЏрЅБрІЏрЅх, рѕЮрѕЇріГрЅх, рЅ░рІѕрІЇ, ріарЅБрІЏ, рІерѕхрѕерІЏ рѕЮрѕЇріГрЅх
РЮј	рѕЮрѕЇріГрЅх, ріФрѕг, рІерѕхрѕерІЏ рѕЮрѕЇріГрЅх ріарІЮрѕФрѕГ
РъЋ	рѕњрѕ│рЅЦ, рѕ▓рІ░рѕўрѕГ, рІѕрЇЇрѕФрѕЮ рІерѕўрІ░рѕўрѕГ рѕЮрѕЇріГрЅх
Ръќ	рѕњрѕ│рЅЦ, рѕ▓рЅђріљрѕх, рІѕрЇЇрѕФрѕЮ рІерѕўрЅђріљрѕх рѕЮрѕЇріГрЅх
РъЌ	рѕњрѕ│рЅЦ, рѕЏріФрЇѕрѕЇ, рІѕрЇЇрѕФрѕЮ рІерѕЏріФрЇѕрѕЇ рѕЮрѕЇріГрЅх
Ръ░	рѕИрѕЮрЅђрЅє, рїЦрЅЁрѕЇрѕЇ, рїЦрЅЁрѕЇрѕЇ рѕИрѕЮрЅђрЅє
Ръ┐	рѕИрѕЮрЅђрЅє, рІхрѕГрЅЦ, рІхрѕГрЅЦ рїЦрЅЁрѕЇрѕЇ рѕИрѕЮрЅђрЅє, рїЦрЅЁрѕЇрѕЇ
сђй	рѕЮрѕЇріГрЅх, ріГрЇЇрѕЇ, рІеріГрЇЇрѕЇ рѕўрЅђрІерѕфрІФ рѕЮрѕЇріГрЅх
Рю│	рЅБрѕѕ рѕхрѕЮріЋрЅх рЅђрѕхрЅх ріарѕхрЅхрѕфріГрѕх, ріарѕхрЅхрѕфріГрѕх
Рю┤	рЅБрѕѕрѕхрѕЮріЋрЅх ріљрїЦрЅЦ рі«ріерЅЦ, рі«ріерЅЦ
РЮЄ	ріаріЋрїИрЅБрѕФрЅѓ
Рђ╝	рѕЮрѕЇріГрЅх, рѕЦрѕГрІЊрЅ░ ріљрїЦрЅЦ, рЅЃрѕѕ ріарїІріќ, рІхрѕГрЅЦ рЅЃрѕѕ ріарїІріќ, рІхрѕГрЅЦ рІерЅЃрѕѕ ріарїІріќ рѕЮрѕЇріГрЅх
РЂЅ	рѕЮрѕЇріГрЅх, рѕЦрѕГрІЊрЅ░ ріљрїЦрЅЦ, рЅЃрѕѕ ріарїІріќ, рЅЃрѕѕ ріарїІріќ ріерїЦрІФрЅё рѕЮрѕЇріГрЅх рїІрѕГ, рїЦрІФрЅё
РЮЊ	рѕЮрѕЇріГрЅх, рѕЦрѕГрІЊрЅ░ ріљрїЦрЅЦ, рІерїЦрІФрЅё рѕЮрѕЇріГрЅх, рїЦрІФрЅё
РЮћ	рѕЮрѕЇріГрЅх, рѕЦрѕГрІЊрЅ░ ріљрїЦрЅЦ, ріљрїГ рІерїЦрІФрЅё рѕЮрѕЇріГрЅх, рІерЅ░ріљрІ░рЇѕ, рїЦрІФрЅё
РЮЋ	рѕЮрѕЇріГрЅх, рѕЦрѕГрІЊрЅ░ ріљрїЦрЅЦ, рЅЃрѕѕ ріарїІріќ, ріљрїГ рІерЅЃрѕѕ ріарїІріќ рѕЮрѕЇріГрЅх, рІерЅ░ріљрІ░рЇѕ
РЮЌ	рѕЮрѕЇріГрЅх, рѕЦрѕГрІЊрЅ░ ріљрїЦрЅЦ, рЅђрІГ рІерЅЃрѕѕ ріарїІріќ рѕЮрѕЇріГрЅх, рЅЃрѕѕ ріарїІріќ
сђ░	рѕърїѕрІ│рѕЏ, рѕърїѕрІ│рѕЏ рѕ░рѕерІЮ, рѕЦрѕГрІЊрЅ░ ріљрїЦрЅЦ, рѕ░рѕГрІЮ
┬Е	рІерЅЁрїѓ рѕўрЅЦрЅх
┬«	рЅ░рѕўрІЮрїЇрЅДрѕЇ, рІерЅ░рѕўрІўрїѕрЅа ріЋрїЇрІх рѕЮрѕЇріГрЅх
Рёб	рѕЮрѕЇріГрЅх, ріЋрїЇрІх рѕЮрѕЇріГрЅх, рІеріЋрїЇрІх рѕЮрѕЇріГрЅх
­Ъњ»	100, рѕўрЅХ, рѕўрЅХ ріљрїЦрЅдрЅй, рѕЎрѕЅ, рІЇрїцрЅх
­Ъћа	рѕІрЅ▓ріЋ, рІЊрЅбрІГ рЇірІ░рѕЇ, рІерѕІрЅ▓ріЋ рІЊрЅбрІГ рЇірІ░рѕЇ рїЇрЅцрЅх, рїЇрЅцрЅх, рЇірІ░рѕІрЅх
­ЪћА	рѕІрЅ▓ріЋ, ріЋрІЉрѕх рЇірІ░рѕІрЅх, рІерѕІрЅ▓ріЋ ріЋрІЉрѕх рЇірІ░рѕЇ рїЇрЅцрЅх, рїЇрЅцрЅх, рЇірІ░рѕІрЅх
­Ъћб	1234, рЅЂрїЦрѕ«рЅй, рІерЅЂрїЦрѕГ рїЇрЅцрЅх, рїЇрЅцрЅх
­ЪћБ	рІерїЇрЅцрЅх рѕЮрѕЇріГрЅХрЅй, рїЇрЅцрЅх
­Ъћц	рѕІрЅ▓ріЋ, рІерѕІрЅ▓ріЋ рЇірІ░рѕІрЅх рїЇрЅцрЅх, рІерЇірІ░рѕЇ рїѕрЅарЅ│, рїЇрЅцрЅх, рЇірІ░рѕІрЅх
­ЪЁ░	ріц ріарІЮрѕФрѕГ, рІ░рѕЮ
­Ъєј	ріцрЅб ріарІЮрѕФрѕГ, рІ░рѕЮ
­ЪЁ▒	рЅб ріарІЮрѕФрѕГ, рІ░рѕЮ
­ЪєЉ	рѕўрЅєрїБрїарѕфрІФ ріФрѕг
­Ъєњ	рЅђрІЮрЅЃрІЏ ріФрѕг, ріарѕфрЇЇ
­ЪєЊ	ріљрї╗, ріљрї╗ ріФрѕг
Рё╣	рѕўрѕерїЃ, рІерѕўрѕерїЃ рѕЮріЋрїГ
­Ъєћ	рѕўрѕѕрІФ рѕЏріЋріљрЅх, ріарІГрІ▓, ріарІГрІ▓ ріФрѕг
РЊѓ	рЅаріГрЅЦ рІЇрѕхрїЦ рІФрѕѕ ріцрѕЮ рЇірІ░рѕЇ, ріГрЅЦ
­ЪєЋ	ріарІ▓рѕх, ріарІ▓рѕх ріФрѕг
­Ъєќ	ріцріЋрїѓ, ріцріЋрїѓ ріФрѕг
­ЪЁЙ	рід, рід ріарІЮрѕФрѕГ, рІ░рѕЮ
­ЪєЌ	ріЦрѕ║, рідріг ріФрѕг
­ЪЁ┐	рѕўріфріЊ рѕЏрЅєрѕџрІФ, рЇњ ріарІЮрѕФрѕГ
­Ъєў	ріцрѕхрідріцрѕх, ріцрѕхрідріцрѕх ріФрѕг, ріЦрїѕрІЏ
­ЪєЎ	рѕІрІГ, рѕЮрѕЇріГрЅх, рІѕрІ░рѕІрІГ! ріарІЮрѕФрѕГ
­Ъєџ	рЅфріцрѕх ріФрѕг, рІГрїІрїарѕЏрѕЇ ріе
­ЪѕЂ	ріФрЅ│ріФріЊ рі«рі« ріФрѕг, рІерїЃрЇЊріЋ
­Ъѕѓ	ріФрЅ│ріФріЊ рѕ│ ріФрѕг, рІерїЃрЇЊріЋ
­Ъѕи	рІерїЃрЇЊріЋ, рІерїерѕерЅЃ ріФрѕг ріарІГрІХрїЇрѕФрЇЇ
­ЪѕХ	рІерїЃрЇЊріЋ, рІФріќрѕе ріФрѕг ріарІГрІХрїЇрѕФрЇЇ
­Ъѕ»	рІерїЃрЇЊріЋ, рІерїБрЅх ріФрѕг ріарІГрІХрїЇрѕФрЇЇ
­ЪЅљ	рЅБрѕѕріГрЅЦ рІЋрІхрѕЇ ріарІГрІХрїЇрѕФрЇЇ, рІерїЃрЇЊріЋ
­Ъѕ╣	рІерЅ░ріерЇІрЇѕрѕѕ ріФрѕг ріарІГрІХрїЇрѕФрЇЇ, рІерїЃрЇЊріЋ
­Ъѕџ	рІеріарѕЅрЅ│ ріФрѕг ріарІГрІХрїЇрѕФрЇЇ, рІерїЃрЇЊріЋ
­Ъѕ▓	рІерЅ░ріерѕѕріерѕѕ ріФрѕг ріарІГрІХрїЇрѕФрЇЇ, рІерїЃрЇЊріЋ
­ЪЅЉ	ріГрЅЦ рІерЅ░рЅђрЅарѕЇ ріарІГрІХрїЇрѕФрЇЇ, рІерЅ╗рІГріЊ
­ЪѕИ	рІерЅ░рїЇрЅЦрѕГ ріФрѕг ріарІГрІХрїЇрѕФрЇЇ, рІерЅ╗рІГріЊ
­Ъѕ┤	ріаріЋрІхріљрЅх ріФрѕг ріарІГрІХрїЇрѕФрЇЇ, рІерЅ╗рІГріЊ
­Ъѕ│	рЅБрІХ ріФрѕг ріарІГрІХрїЇрѕФрЇЇ, рІерЅ╗рІГріЊ
сіЌ	ріарІГрІХрїЇрѕФрЇЇ, ріГрЅЦ рІерІ░рѕхрЅ│ рѕўрїЇрѕѕрїФ ріарІГрІХрїЇрѕФрЇЇ, рІерЅ╗рІГріЊ, рІерІ░рѕхрЅ│ рѕўрїЇрѕѕрїФ, рІерІ░рѕхрЅ│ рѕўрїЇрѕѕрїФрІјрЅй
сіЎ	рѕЮрѕхрїбрѕГ, ріарІГрІХрїЇрѕФрЇЇ, ріГрЅЦ рІерѕЮрѕхрїбрѕГ ріарІГрІХрїЇрѕФрЇЇ, рІерЅ╗рІГріЊ
­Ъѕ║	рІерѕхрѕГрІЊрЅ░ ріГрІѕріЊ ріФрѕг ріарІГрІХрїЇрѕФрЇЇ, рІерЅ╗рІГріЊ
­Ъѕх	рѕЎрѕЅ ріФрѕг ріарІГрІХрїЇрѕФрЇЇ, рІерЅ╗рІГріЊ
­Ъћ┤	рЅђрІГ, рЅђрІГ ріГрЅЦ, ріГрЅЦ, рїѓрідрѕюрЅхрѕфрІФрІі
­Ъћх	рѕ░рѕЏрІФрІі, рѕ░рѕЏрІФрІі ріГрЅЦ, ріГрЅЦ, рїѓрідрѕюрЅхрѕфрІФрІі
Рџф	ріљрїГ ріГрЅЦ, ріГрЅЦ, рїѓрідрѕюрЅхрѕфрІФрІі
РџФ	ріГрЅЦ, рїѓрідрѕюрЅхрѕфрІФрІі, рїЦрЅЂрѕГ ріГрЅЦ
Ргю	ріљрїГ рЅхрѕЇрЅЁ ріФрѕг, ріФрѕг, рїѓрідрѕюрЅхрѕфрІФрІі
РгЏ	ріФрѕг, рїѓрідрѕюрЅхрѕфрІФрІі, рїЦрЅЂрѕГ рЅхрѕЇрЅЁ ріФрѕг
РЌ╝	ріФрѕг, рїѓрідрѕюрЅхрѕфрІФрІі, рїЦрЅЂрѕГ рѕўріФріерѕѕріЏ ріФрѕг
РЌ╗	ріљрїГ рѕўріФріерѕѕріЏ ріФрѕг, ріФрѕг, рїѓрідрѕюрЅхрѕфрІФрІі
РЌй	ріљрїГ рѕўріФріерѕѕріЏ- рЅхріЋрѕй ріФрѕг, ріФрѕг, рїѓрідрѕюрЅхрѕфрІФрІі
РЌЙ	ріФрѕг, рїѓрідрѕюрЅхрѕфрІФрІі, рїЦрЅЂрѕГ рѕўріФріерѕѕріЏ-рЅхріЋрѕй ріФрѕг
РќФ	ріљрїГ рЅхріЋрѕй ріФрѕг, ріФрѕг, рїѓрідрѕюрЅхрѕфрІФрІі
Рќф	ріФрѕг, рїѓрідрѕюрЅхрѕфрІФрІі, рїЦрЅЂрѕГ рЅхріЋрѕй ріФрѕг
­ЪћХ	рЅЦрѕГрЅхрі│ріЊрѕЏ, рЅхрѕЇрЅЁ рЅЦрѕГрЅхрі│ріЊрѕЏ ріарѕЇрѕЏрІЮ, ріарѕЇрѕЏрІЮ, рїѓрідрѕюрЅхрѕфрІФрІі
­Ъћи	рѕ░рѕЏрІФрІі, рЅхрѕЇрЅЁ рѕ░рѕЏрІФрІі ріарѕЇрѕЏрІЮ, ріарѕЇрѕЏрІЮ, рїѓрідрѕюрЅхрѕфрІФрІі
­ЪћИ	рЅЦрѕГрЅхрі│ріЊрѕЏ, рЅхріЋрѕй рЅЦрѕГрЅхрі│ріЊрѕЏ ріарѕЇрѕЏрІЮ, ріарѕЇрѕЏрІЮ, рїѓрідрѕюрЅхрѕфрІФрІі
­Ъћ╣	рѕ░рѕЏрІФрІі, рЅхріЋрѕй рѕ░рѕЏрІФрІі ріарѕЇрѕЏрІЮ, ріарѕЇрѕЏрІЮ, рїѓрідрѕюрЅхрѕфрІФрІі
­Ъћ║	рЅђрІГ, рЅђрІГ рѕХрѕхрЅх рѕЏрІЋрІўріЋ рІѕрІ░ рѕІрІГ рїарЅІрѕџ, рїѓрідрѕюрЅхрѕфрІФрІі
­Ъћ╗	рЅђрІГ, рЅђрІГ рѕХрѕхрЅх рѕЏрІЋрІўріЋ рІѕрІ░ рЅ│рЅй рїарЅІрѕџ, рЅ│рЅй, рїѓрідрѕюрЅхрѕфрІФрІі
­Ъња	рЅБрѕѕ ріљрЅЂрїЦ ріарѕЇрѕЏрІЮ, ріарѕЇрѕЏрІЮ, ріарѕхрЅѓріЮ, ріерІЇрѕхрїЦ, рїѓрідрѕюрЅхрѕфрІФрІі
­Ъћў	рѕгрІ▓рІ«, ріарІЮрѕФрѕГ, рІерѕгрІ▓рІ« ріарІЮрѕФрѕГ, рїѓрідрѕюрЅхрѕфрІФрІі
­Ъћ▓	рЅарїЦрЅЂрѕГ рІерЅ░ріерЅарЅа ріФрѕг ріарІЮрѕФрѕГ, ріарІЮрѕФрѕГ, ріФрѕг, рїѓрідрѕюрЅхрѕфрІФрІі
­Ъћ│	рЅаріљрїГ рІерЅ░ріерЅарЅа ріФрѕг ріарІЮрѕФрѕГ, ріарІЮрѕФрѕГ, ріФрѕг, рІерЅ░ріљрІ░рЇѕ, рїѓрідрѕюрЅхрѕфрІФрІі
­ЪЈЂ	ріЦрѕйрЅЁрІхрІхрѕЮ, рІерІ│рѕЏ рѕ░рѕїрІ│ рѕўрѕ░рѕЇ рЅБріЋрІ┤рѕФ, рІ│рѕЏ, рІ│рѕЏ рѕ░рѕїрІ│
­ЪџЕ	рІерЇќрѕхрЅ│ рѕЮрѕЇріГрЅх рЅБріЋрІ▓рѕФ, рЇќрѕхрЅ│
­Ъјї	рѕўрѕхрЅђрѕЇ, ріГрЅЦрѕе рЅарІЊрѕЇ, рІерЅ░рїБрѕўрѕе, рІерїЃрЇЊріЋ, рїЦрѕЎрѕГ рѕ░ріЋрІ░рЅЁ рІЊрѕІрѕЏрІјрЅй
­ЪЈ┤	рѕЏрІЇрѕѕрЅЦрѕѕрЅЦ, рїЦрЅЂрѕГ рЅБріЋрІ┤рѕФ рѕЏрІЇрѕѕрЅЦрѕѕрЅЦ
­ЪЈ│	рѕЏрІЇрѕѕрЅЦрѕѕрЅЦ, ріљрїГ рЅБріЋрІ┤рѕФ рѕЏрІЇрѕѕрЅЦрѕѕрЅЦ
­ЪЈ│РђЇ­Ъїѕ	рЅђрѕхрЅ░ рІ░рѕўріЊ, рЅБріЋрІ▓рѕФ, рІерЅђрѕхрЅ░ рІ░рѕўріЊ рЅБріЋрІ▓рѕФ
­ЪЈ┤РђЇРўа	рѕЏрІЋрІхріЋ, рѕЮрѕГрі«, рІерЅБрѕЋрѕГ рІѕріЋрЅарІ┤, рІерЅБрѕЋрѕГ рІѕріЋрЅарІ┤ рѕ░ріЋрІ░рЅЁ, рїєрѕі рѕ«рїђрѕГ
