­ЪЈ╗	рјбрЈ│рЈЇрЈЌ 1РђЊ2, рјБрЈЂрјдрјИ рЈёрЈЇрЈЏрјб, рјцрЈЌрЈ┤рј│рЈў рјцрЈЂрјдрјх рЈёрЈЇрЈЏрјб
­ЪЈ╝	рјарЈ▓рЈЪрје-рјцрЈЌрЈ┤рј│рЈў рјцрЈЂрјдрјИ рЈёрј┐рЈЇрЈЏрјб, рјбрЈ│рЈЇрЈЌ 3, рјБрЈЂрјдрјИ рЈёрЈЇрЈЏрјб
­ЪЈй	рјарЈ▓рЈЪрје рјБрЈЂрјдрјИ рЈёрЈЇрЈЏрјб, рјбрЈ│рЈЇрЈЌ 4, рјБрЈЂрјдрјИ рЈёрЈЇрЈЏрјб
­ЪЈЙ	рјарЈ▓рЈЪрје-рјцрјхрЈЈрјЕ рјБрЈЂрјдрјИ рЈёрЈЇрЈЏрјб, рјбрЈ│рЈЇрЈЌ 5, рјБрЈЂрјдрјИ рЈёрЈЇрЈЏрјб
­ЪЈ┐	рјбрЈ│рЈЇрЈЌ 6, рјБрЈЂрјдрјИ рЈёрЈЇрЈЏрјб, рјцрјхрЈЈрјЕ рјБрЈЂрјдрјИ рЈёрЈЇрЈЏрјб
­Ъўђ	рјцрјДрЈЏ, рјцрЈцрЈБрЈЇрЈЌ рјцрјДрЈЏ, рјцрЈ░рЈЇрјЕ
­ЪўЂ	рјарјдрЈў, рјцрјДрЈЏ, рјцрЈцрЈБрЈЇрЈЌ, рјцрЈцрЈБрЈЇрЈЌ рјцрјДрЈЏ рјЙрЈЇрјЕ рјцрЈцрЈБрЈЇрЈЌ рЈЊрјДрЈЁрјб, рјцрЈ░рЈЇрјЕ
­Ъўѓ	рјцрјДрЈЏ, рјцрјДрЈЏрјб рјцрЈарЈ»рЈЇрЈЌ рЈџрјдрј│рЈЂрЈњ рјЙ рјцрјхрј«рјхрЈЇрЈЌ, рјцрјхрј«рјхрЈе, рјцрЈЕрЈЇрЈЅрјИ, рјцрЈ░рЈЇрјЕ
­ЪцБ	рјБрЈљрЈФрјхрЈЎрј▓, рјБрЈљрЈФрјхрЈЎрј▓ рјЦрј┐ рЈ»рЈќрЈЃ рјБрЈгрјхрЈЊрЈЂрј▓рјб, рјцрјДрЈЏ, рјцрЈ░рЈЇрјЕ, рЈ»рЈќрЈЃ
­ЪўЃ	рјарј░рјх, рјарЈЇрјбрЈЊ, рјцрјДрЈЏ, рјцрЈцрЈБрЈЇрЈЌ, рјцрЈцрЈБрЈЇрЈЌ рјцрјДрЈЏ рјЙрЈЇрјЕ рјцрЈћрјЙ рЈЌрјдрЈЎрјх
­Ъўё	рјарјдрЈў, рјарј░рјх, рјарЈЇрЈџрјбрЈЊ, рјцрјДрЈЏ, рјцрЈцрЈБрЈЇрЈЌ, рјцрЈцрЈБрЈЇрЈЌ рјцрјДрЈЏ рјЙрЈЇрјЕ рјцрЈцрЈБрЈЇрЈЌ рЈЌрјдрЈЎрјх
­ЪўЁ	рјарјх, рјарЈЇрЈџрјбрЈЊ, рјцрјДрЈЏ, рјцрЈцрЈБрЈЇрЈЌ, рјцрЈцрЈБрЈЇрЈЌ рјцрјДрЈЏ рјарјх, рјцрЈ┤рЈЮ
­Ъўє	рјарј░рјх, рјцрјДрЈЏ, рјцрјхрј«рјхрЈерјб, рјцрЈцрЈБрЈЇрЈЌ, рјцрЈцрЈБрЈЇрЈЌ рЈЇрЈѕрЈў рјцрјДрЈЏ, рјцрЈ░рЈЇрјЕ
­ЪўЅ	рјарјдрЈћрјЙрЈФрЈЇрјд, рјарЈЊрјдрЈћрЈЂ рјарјдрЈЎрјх, рјцрјДрЈЏ
­Ъўі	рјарјдрЈў, рјцрјДрЈЏ, рјцрЈцрЈБрЈЇрЈЌ, рјцрЈ░рЈЌрЈЇрјЕ рјцрјДрЈћ рјЙ рЈДрЈ░рЈЌрЈЇрјЕ рЈЌрјдрЈЎрјх, рјЕрјдрје рЈѓрјдрјхрЈЇрЈЌрј▓рјб
­ЪўІ	рјБрЈЇрЈЊ рјарјЕрЈЇрЈЌ, рјБрЈЇрЈЊрјЦрЈ░рјИрЈЇрјгрјб, рјцрјДрЈЏ, рјцрјДрЈЏрјб рјарЈЊрЈЇрЈЊрЈ┤рј▓рЈЇрјг рјцрјдрјЙрЈЇрЈЏ рјарјхрЈЇрЈЊрЈ┤рЈЌ, рјцрЈцрЈБрЈЇрЈЌ, рЈ┤рј╗
­Ъўј	рјарјдрјх, рјцрјДрЈЏ, рјцрЈЂрЈЈрЈ┤рЈъ, рјцрЈ░рЈЌрЈЇрјЕ рјцрјДрЈћ рЈЁрЈЊ рЈЌрјдрЈЏрЈЁрЈЎрЈЌ рЈЌрјдрЈЏрЈЁрЈЌрЈЇрЈЌ, рЈЁрЈЊ, рЈЁрЈЊ рЈЌрјдрЈЏрЈЁрЈЎрЈЌ
­ЪўЇ	рјарјдрЈў, рјарЈЊрјерЈ│рЈЌ, рјцрјДрЈЏ, рјцрЈцрЈБрЈЇрЈЌ, рјцрЈ░рЈЌрЈЇрјЕ рјцрјДрЈћ рјцрјхрјф рјцрЈЊрЈЁрЈЎ-рЈЌрјдрЈЎрјх
­Ъўў	рјарЈЊрЈћрЈфрЈЎрЈЌ, рјцрјДрЈЏ, рјцрјДрЈЏрјб рјарЈдрЈћрЈЇрјг рјарЈЊрЈћрЈфрЈЎрЈЌ
­ЪЦ░	рјарЈЊрјерЈ│рјГ, рјарЈЊрјгрЈЇрјЕ, рјдрјИрЈЅрЈЌ, рјГрЈ░рЈЇрјЕ рјцрјДрЈЏ рјГрЈарЈ»рЈЇрЈЌ 3 рЈЌрЈЊрЈЁрЈЎ
­ЪўЌ	рјарЈЊрЈћрЈфрЈЎрЈЇрјЕ рјцрјДрЈЏ, рјарЈЊрЈћрЈфрЈЎрЈЌ, рјцрјДрЈЏ
­ЪўЎ	рјарјдрЈў, рјарЈЊрЈћрЈфрЈЎрЈЇрјЕ рјцрјДрЈЏ рјцрЈцрЈБрЈЇрЈЌ рЈЌрјДрЈѓ, рјарЈЊрЈћрЈфрЈЎрЈЌ, рјцрјДрЈЏ, рјцрЈцрЈБрЈЇрЈЌ
­Ъўџ	рјарЈЊрЈћрЈфрЈЎрЈЇрјЕ рјцрјДрЈЏ рЈџрјдрЈћрЈЇрЈЏрјб, рјарЈћрЈфрЈЎрЈЁрјб, рјцрјДрЈЏ, рЈЊрЈЇрЈџрјГ, рЈЌрјдрЈћ
­ЪЎѓ	рјцрјДрЈЏ, рјцрЈ░рЈЦрЈЇрјд, рЈЇрЈЌрјЕрЈЊ рјцрЈ░рЈЊрЈЇрјг рјцрјДрЈЏ
­ЪцЌ	рјарЈёрјЕрЈЪрЈЌ, рјарЈёрјЕрЈбрЈЇрјЕ рјцрјДрЈЏ, рјарЈЊрЈёрјЕрЈбрЈЇрјЕ, рјцрјДрЈЏ
­ЪцЕ	рјцрјДрЈЏ, рјцрЈ░рЈБрЈЇрјЕ, рЈЃрЈѕрЈЈ, рЈЃрЈѕрЈЈ-рјцрЈ«рЈѓрјИрјб, рЈЌрјдрЈћ
­Ъцћ	рјарјДрЈЏ, рјарЈЊрјЙрЈќрЈЇрјЕ, рјарЈЊрјЙрЈќрЈЇрјЕ рјцрјДрЈЏ
­Ъце	рјарјфрј»рЈ│рј» рЈѓрјерЈњрјЙ, рјцрјДрЈЏ рјцрјхрЈїрј│рЈЌ рјцрјдрЈќрЈїрјЙрјИрјб, рјцрЈюрЈЈрЈўрЈЇрјЕ
­ЪўЉ	рјцрјДрЈЏ, рјцрјДрЈЏрјб рЈЁрЈЊрЈЂрЈЪрЈ┤рЈњрјЙ, рјцрјДрЈЏрјб рЈЁрЈЊрЈЂрЈЪрЈ┤рЈњрјЙ рјцрјДрЈЏ, рЈЁрЈЊрЈЂрЈЪрЈ┤рЈњ, рЈЁрЈЊрЈЂрЈЪрЈ┤рЈњрјЙ
­ЪўХ	рјарј░рјх, рјАрЈарЈф, рјАрЈарЈфрјб, рјцрјДрЈЏ, рјцрјДрЈЏрјб рЈёрЈарЈ»рЈЇрЈЏрјЙ рјарЈ▓рјх
­ЪЎё	рјцрјДрЈЏ, рјцрјДрЈЏрјб рјцрЈарЈ»рЈЇрЈЌ рјдрјдрЈљрЈєрј┤рјд рЈЌрјдрЈЎрјх, рЈЊрјхрЈљрЈѕрј┤, рЈЌрјдрЈў
­ЪўЈ	рјарЈцрЈБрЈЇрЈЌ, рјцрјДрЈЏ, рјцрЈ░рЈЌрЈЇрјЕ рјцрјДрЈЏ
­ЪўБ	рјцрјДрЈЏ, рјцрјхрЈЈрЈЁрЈЌ, рЈЦрјЙрЈЏрЈЂрј░рјб рјцрјДрЈЏ
­ЪўЦ	рјАрЈЇрјд, рјАрЈЇрјд рјцрЈ░рјИрЈЁрјб рјарЈјрЈЃ рјцрјхрј«рјхрЈерјб рјцрјДрЈЏ, рјцрјДрЈЏ, рјцрЈ»рЈфрЈљрЈб, рЈЌрЈЂрЈЪрЈЎрЈЌ
­Ъў«	рјарј░рјх, рјарЈЇрЈџрјбрЈЊ, рјцрјДрЈЏ, рјцрјДрЈЏ рјцрЈарЈ»рЈЇрЈЌ рјцрЈћрЈарјгрјб, рјцрЈ▓ рјарЈ░рјИрјЙ
­Ъцљ	рјарјДрЈЂрЈЇрЈЌ, рјарј░рјх, рјцрјДрЈЏ, рјЦрјДрЈЂрЈЇрЈЌ-рјарј░рјхрјцрјДрЈЊ рјцрјДрЈЏ
­Ъў»	рјарЈЦрЈјрјдрЈЇрЈЏрЈЁ, рјарЈЦрЈ░рјХрјбрЈЇрЈћрЈЁ, рјАрјХрЈф рјцрјДрЈЏ, рјАрјХрЈф рЈ»рјгрЈЂрјИрјб, рјцрјДрЈЏ
­Ъўф	рјцрјДрЈЏ, рјдрЈЪ, рјдрЈбрЈЇрјЕ рјцрјДрЈЏ
­ЪўФ	рјцрјДрЈЏ, рЈџрЈ»рЈфрјд, рЈџрЈ»рЈфрјд рјцрјДрЈЏ
­Ъў┤	рјцрјДрЈЏ, рјдрЈЪ, рјдрЈЪрј» рјцрјДрЈЏ, рЈЃрЈЃрЈЃ
­Ъўї	рјцрјДрЈЏ, рјцрЈ»рЈфрЈљрЈб, рјцрЈ»рЈфрЈљрЈб рјцрјДрЈЏ
­ЪўЏ	рјцрјДрЈЏ, рјцрјДрЈЏ рјЙрј┐ рјдрЈЁрјф, рјдрЈЁрјф
­Ъўю	рјарјдрЈћрјЙрЈФрЈЇрјд, рјарјдрЈў, рјцрјДрЈЏ, рјдрЈЁрјф, рјдрЈфрЈбрЈЁрЈЌ, рЈџрјдрЈћрЈЇрЈЊ рјцрјДрЈЏ рјЙрј┐ рјдрЈЁрјф
­ЪўЮ	рјарјдрЈў, рјарјЕрЈЇрЈЌ, рјцрјДрЈЏ, рјцрЈЂрјЕрЈЪрЈЌ, рјдрЈЁрјф, рЈЇрЈѕрЈў рјцрјДрЈЏ рјЙрј┐ рјдрЈЁрјф
­Ъцц	рјцрјДрЈЏ, рЈЌрјГрЈгрјбрјГ, рЈЌрјГрЈгрјбрјГ рјцрјДрЈЏ
­Ъўњ	рјцрјДрЈЏ, рјЙрјхрј«рјхрјгрјЙ, рЈёрЈ░рЈЌрЈЇрјгрјЙ, рЈёрЈ░рЈЌрЈЇрјгрјЙ рјцрјДрЈЏ
­ЪўЊ	рјарјх, рјцрјДрЈЏ, рјцрјДрЈЏрјб рјцрЈарЈ»рЈЇрЈЌ рјцрЈ┤рЈЪ рјарјх, рјцрЈ┤рЈЮ
­Ъўћ	рјарЈЊрЈЁрЈќрјИрЈЇрјЕ, рјарЈЊрЈЁрЈќрјИрЈЇрјЕ рјцрјДрЈЏ, рјцрјДрЈЏ, рЈЊрЈЊрЈЉрјХ
­ЪўЋ	рјцрјДрЈЏ, рјцрЈјрјЕрЈ▓рЈцрјИрјб, рјцрЈјрјЕрЈ▓рЈцрјИрјб рјцрјДрЈЏ
­ЪЎЃ	рјцрјДрЈЏ, рЈЌрЈЂрЈЇрЈѕрЈЏрЈЁ-рјАрј│рЈЌрЈю, рЈЌрЈЂрЈЇрЈѕрЈЏрЈЁ-рјАрј│рЈЌрЈю рјцрјДрЈЏ
­ЪцЉ	рјарј░рјх, рјарЈЋрј│, рјарЈЋрј│-рјарј░рјх рјцрјДрЈЏ, рјцрјДрЈЏ
­Ъў▓	рјарЈЦрЈјрјдрЈЇрЈћрЈЁрјб, рјарЈЦрЈјрјдрЈЇрЈћрЈЁрјб рјцрјДрЈЏ, рјцрјДрЈЏ, рјцрЈЇрЈєрЈѓрјдрЈў рјцрЈ░рјИрЈЁ, рјДрјхрЈг
­ЪЎЂ	рјцрјДрЈЏ, рјцрЈЊрЈЂрјфрЈ│, рЈЇрЈЌрјЕрЈЊ рјцрЈЊрЈЂрјфрЈ│рЈњ рјцрјДрЈЏ
­Ъўќ	рјцрјДрЈЏ, рјцрјГрјЙрјИ, рјцрјГрјЙрјИ рјцрјДрЈЏ
­Ъўъ	рјАрЈЇрјд рјцрЈ░рјИрЈЁрјб, рјАрЈЇрјд рјцрЈ░рјИрЈЁрјб рјцрјДрЈЏ, рјцрјДрЈЏ
­ЪўЪ	рјцрјДрЈЏ, рјцрЈфрјхрј»рЈЇрјЕ, рјцрЈфрјхрј»рЈЇрјЕ рјцрјДрЈЏ
­Ъўц	рјцрјДрЈЏ, рјцрјДрЈЏрјб рјцрЈарЈ»рЈЇрЈЌ рјЙрЈЇрјЕрјЙ рјДрЈ┤рЈљрјх, рјцрЈЊрјхрЈЂрј»рЈЏ, рјцрЈЊрЈарЈњ
­Ъўб	рјарЈарЈ▒рјГ, рјарЈарЈ▒рјГ рјцрјДрЈЏ, рјцрјДрЈЏ, рјцрЈЕрЈЇрЈЅрјИ, рјцрЈ▓рјцрЈ░рјИрЈЁ
­ЪўГ	рјарЈарЈ▒рјГ, рјарЈарЈ▒рЈЇрјЕ, рјцрјДрЈЏ, рјцрЈЕрЈЇрЈЅрјИ, рјцрЈ▓рјГрЈ░рјИрЈЁ, рЈЌрјГрј│рЈЊ рјарЈарЈ▒рЈЇрјЕ рјцрјДрЈЏ
­Ъўд	рјарј░рјх, рјарЈЇрЈџрјбрЈЊ, рјцрјДрЈЏ, рјцрЈЊрЈЂрјфрЈ│, рјцрЈЊрЈЂрјфрЈ│рј▓рјб рјцрјДрЈЏ рјцрЈћрЈарјЕ
­ЪўД	рјарјЕрЈЪрЈ▓рјгрјб, рјарјЕрЈЪрЈ▓рјгрјб рјцрјДрЈЏ, рјцрјДрЈЏ
­Ъўе	рјарЈЇрјдрјбрјГ, рјцрјДрЈЏ, рјцрјЙрЈ░рЈїрЈў, рјцрјЙрЈ░рЈїрЈў рјцрјДрЈЏ, рјцрЈЇрјдрјАрј»
­ЪўЕ	рјцрјДрЈЏ, рЈЌрјдрЈЇрЈЌрЈ░рЈЇрЈњ, рЈЌрјдрЈЇрЈЌрЈ░рЈЇрЈњ рјцрјДрЈЊ, рЈДрЈЕрЈфрјЕ
­Ъц»	рјарЈћрЈЇрјЕрЈЇрјЕ рјарјдрЈЇрЈЊрЈЏ, рјцрЈЇрјдрЈЇрЈЊрЈЂрјИрјб
­Ъўг	рјцрјДрЈЏ, рјцрЈЊрЈЂрјфрЈ│, рјцрЈЊрЈЂрјфрЈ│рј▓рјб рјцрјДрЈЏ
­Ъў░	рјарјх, рјарЈЁрЈЇрЈћрЈЁрјб, рјцрјДрЈЏ, рјцрјирјХ рјцрјДрЈЏ рјарјх, рјцрЈ┤рЈю, рЈїрјфрЈѓрје
­Ъў▒	рјарЈЇрјдрјбрјГ, рјцрјДрЈЏ, рјцрјДрЈЏрјб рјерјирј▓рЈЇрјд рјЙрЈЇрјЕ рјдрјЙрЈ░рј»рЈЇрЈЌ, рјцрЈЇрјдрјАрј», рјцрЈфрјирјд
­ЪЦх	рјарјх рЈЊрЈЊрЈЉрјХ, рјцрЈЌрј┤рјг рјцрјИрЈЊрјИрЈЁ, рјцрЈЌрј┤рј▓рЈЇрјЕ, рјцрЈЌрЈърјд, рјцрЈЌрЈърјд рјцрјДрЈЏ, рјЕрјдрје-рјцрјДрЈЏрјб
­ЪЦХ	рјцрЈ┤рЈю, рјцрЈ┤рЈю рјцрјДрЈЏ, рЈїрјфрЈѓрје-рјцрјДрЈЏрјб, рЈЋрјдрЈЂрЈЇрЈЊрј│рЈЌрја, рЈџрј┐рЈЇрЈЊрјЦ, рЈДрЈЂрЈЇрЈЊрјХрЈњ
­Ъў│	рјцрјДрЈЏ, рјцрЈјрјЕрЈ▓рЈц, рјдрЈЃрј▒рјфрЈЌ, рјдрЈЃрј▒рјфрЈЌ рјцрјДрЈЏ
­Ъцф	рјарјдрЈў, рјцрјирјХрЈе, рјцрјирјХрЈе рјцрјДрЈЏ, рјцрЈЇрЈЌ, рјцрЈћрјЙ
­Ъўх	рјцрјДрЈЏ, рјцрјИрЈЋрј»рЈЊ, рјцрјИрЈЋрј»рЈЊ рјцрјДрЈЏ
­ЪўА	рјарјхрЈЇрјдрЈЃрЈЇрјд, рјцрјДрЈЏ, рјцрјхрЈЇрјдрј«рЈЌ, рјцрј┐рјИрј», рјцрЈЊрЈЂрј»рЈ│, рјцрЈЊрЈЂрј»рЈ│ рјцрјДрЈЏ, рјЕрјдрје
­Ъўа	рјарј┐рјИрј», рјцрјДрЈЏ, рјцрј┐рјИрј», рјцрј┐рјИрј» рјцрјДрЈЏ
­Ъцг	рјарЈјрјхрЈЎрЈЌ, рјцрјДрЈЏ рјцрЈЎрЈфрјИ рјцрЈГрЈЮрјб рјарј░рјх
­Ъўи	рјарјдрјЙрјдрЈў, рјарјхрјгрЈџрјХрЈЌ, рјцрјДрЈЏ, рјцрјДрЈЏрјб рјцрЈарЈ»рЈЇрЈЌ рјдрЈЃрЈбрјЕрЈЁрЈгрЈў рјарјхрјгрЈџрјХрЈЌ, рјцрЈбрјд, рјцрЈ┤рЈю
­Ъцњ	рјцрјДрЈЏ, рјцрјДрЈЏрјб рјцрЈарЈ»рЈЇрЈЌ рјцрЈЌрЈърјг рјцрјдрЈЁрЈ« рјарЈјрј»рј», рјцрЈЊрЈѓрј│, рјцрЈЌрЈърјг рјцрјдрЈЁрЈ« рјарЈјрј»рј», рјцрЈбрјд
­ЪцЋ	рјцрјДрЈЏ, рјцрјДрЈЏрјб рјцрЈарЈ»рЈЇрЈЌ рјарЈЇрјфрј│-рјцрЈљрЈЁрЈЁ рјдрЈЄрЈЁрЈЎрЈЌ, рјцрјхрЈЄрЈЁрј», рјцрЈЦрЈЁрЈЁрјб, рјцрЈфрЈЇрЈЊрЈЂ
­Ъцб	рјцрјДрЈЏ, рјцрјИрЈЋрј│рЈЌ, рјцрјИрЈЋрј│рЈЌ рјцрјДрЈЏ, рЈДрјдрЈЇрЈўрЈѓрЈЋрјЙ
­Ъц«	рјцрјДрЈЏ рЈџрјдрЈЇрЈЌрј▓рјб, рјцрЈЊрЈѓрјИ, рЈџрјдрЈЇрЈЌрј▓рјб
­ЪцД	рјарЈЌрЈ┤рј│рЈЏрЈЇрјЕ рЈЌрЈЂрЈЪрЈЎрЈЌ, рјцрјДрЈЏ, рЈџрЈ┤рЈЇрЈЎрЈЇрјгрјб, рЈДрЈ┤рЈЇрЈЎрЈЇрјЕ рјцрјДрЈћ
­ЪўЄ	рјарЈѓрЈЊрЈфрј», рјцрјДрЈЏ, рјцрЈ░рЈЌрЈЇрјЕ рјцрјДрЈћ рјцрјхрјфрЈЊ, рј«рјХрј», рј░рЈЕрЈГ рЈѓрјерЈњрјЙ, рјЙрЈЇрјдрЈЁрјЙ
­Ъца	рјцрјДрЈЏ, рјцрјхрЈЇрЈЄрЈџрјЕ, рЈЌрЈЇрј│рЈЌрЈЇрјЕ, рЈЌрЈЇрј│рЈЌрЈЇрјЕ рјцрјхрЈЇрЈЄрЈџрјЕ рјцрјДрЈЏ
­ЪЦ│	рјарјхрЈЇрЈЄрЈћрЈг, рјцрјДрЈЏ рјцрјЙрЈЊрЈАрјерЈЇрјг, рјцрјЙрЈЊрЈАрјерЈЇрјг, рјцрјЙрЈЋрЈўрЈ░рЈЇрјг, рјцрЈ▓рјЙ
­ЪЦ┤	рјбрЈДрј│рјГ рЈѓрјерЈњрјЙ рЈЌрјдрЈЎрјх, рјцрјИрЈЋрј», рјцрјИрЈЋрЈЇрЈЌ рјцрјДрЈЏ, рјцрЈџрјЕрЈЊ, рјцрЈЦрЈѕрЈЌ рјарј░рјх, рјцрЈ┤рЈЇрЈЋрЈЏрЈЅ
­ЪЦ║	рјарЈЊрЈЎрјхрЈЇрЈЌ, рјарЈџрј│рЈЌрЈЇрјг, рјдрЈѓрј│рЈЌрја рјцрјДрЈЏ, рјЕрјх рјарЈЌ рЈЌрјдрЈЎрјх
­ЪцЦ	рјарјхрЈЇрјфрЈЁрЈЇрјд рјцрјДрЈЏ, рјарЈЊ рјарЈДрЈБ, рјарЈЏрЈЇрјфрЈЁ, рјцрјДрЈЏ
­ЪцФ	рјАрјХрЈфрјб, рјАрјХрЈфрјб рјЙрјгрЈЂрј▓рјб рјцрјДрЈЏ, рјЙрјгрЈЂрј▓
­ЪцГ	рјцрјДрЈЏ рјарј░рјх рјцрЈГрЈЮрјб, рј«рЈ»
­ЪДљ	рјарјДрјх, рЈЌрјдрЈЏрЈЁрЈЎрЈЌ рјцрјДрЈЏ
­ЪцЊ	рјарјДрјЙрЈЌ, рјцрјдрјИрЈЌ, рјцрјдрјИрЈЌ рјцрјДрЈЏ, рјцрјДрЈЏ
­Ъўѕ	рјцрјДрЈЏ, рјцрЈцрЈБрЈЇрЈЌ, рјцрЈ░рЈЌрЈЇрјЕ рјцрјДрЈћ рјцрјхрјфрЈЊ рЈџрЈ▓рјЙ, рјЦрЈЊрЈЁрЈќрЈбрЈЇрјг рј░рЈЕрЈѓрјерЈњрјЙ, рј░рЈЕрЈѓрјерЈњрјЙ, рЈДрЈ▓рјЙ
­ЪЉ┐	рјарЈЇрјЕрјЙ, рјцрјДрЈЏ, рјцрј┐рјИрјб рјцрјДрЈЏ рЈДрЈЪрјЕ, рјцрј┐рјИрјб рјцрјДрЈЏ рЈДрЈ▓рјЙ, рјцрЈЇрЈЌ рјарЈЇрјЕрјЙ, рј░рЈЕрЈѓрјерЈњрјЙ, рЈДрЈ▓рјЙ
­ЪцА	рјцрјДрЈЏ, рЈДрјдрјИрЈЊ, рЈДрјдрјИрЈЊ рјцрјДрЈЏ
­ЪЉ╣	рјарЈЈрЈ┤рЈФ, рјцрјДрЈЏ, рјЦрЈЊрЈЁрЈќрЈбрЈЇрјг рј░рЈЕрЈѓрјерЈњрјЙ, рјдрЈѓрЈ░рјЕ, рј░рЈЕрЈѓрјерЈњрјЙ, рЈ┤рЈФ рјбрЈ│рЈЇрЈЌ
­ЪЉ║	рјарЈЈрЈ┤рЈФ, рјцрјДрЈЏ, рјЦрЈЊрЈЁрЈќрЈбрЈЇрјг рј░рЈЕрЈѓрјерЈњрјЙ, рјдрЈѓрЈ░рјЕ, рјЕрјдрје рЈ┤рЈФ, рј░рЈЕрЈѓрјерЈњрјЙ
­Ъњђ	рјарЈ▓рј▒рј»рЈЇрЈЌ, рјцрјДрЈЏ, рјдрЈѓрЈ░рјЕ, рјфрј│рјГ рјцрЈЇрјд, рј░рЈЕрЈѓрјерЈњрјЙ
­ЪЉ╗	рјарЈЈрЈ┤рЈФ, рјарЈЦрЈЇрјЕрјх, рјцрјДрЈЏ, рјЦрЈЊрЈЁрЈќрЈбрЈЇрјг рј░рЈЕрЈѓрјерЈњрјЙ, рјдрЈѓрЈ░рјЕ, рј░рЈЕрЈѓрјерЈњрјЙ
­ЪЉЙ	рјарЈЈрЈ┤рЈФ, рјбрјЙ рЈѓрЈЊрЈ│рјХрЈњ, рјбрјЙ рЈѓрЈЊрЈ│рјХрЈњрјб, рјбрјЙ рЈѓрЈЊрЈ│рјХрЈњрјб рјдрЈѓрЈ░рјЕ, рјцрјДрЈЏ, рјдрЈѓрЈ░рјЕ, рјфрЈЪрЈЇрЈЌ рЈѓрјерЈњрјЙ рјдрЈЃрј»рјхрЈЎрј»
­Ъцќ	рјцрјДрЈЏ, рјдрЈѓрЈ░рјЕ, рЈћрјирјЕрЈЇрјЕ рЈ┤рЈФ, рЈћрјирјЕрЈЇрјЕ рЈ┤рЈФ рјцрјДрЈЏ
­ЪњЕ	рјбрјЕрЈЈ, рјцрјДрЈЏ, рјцрЈЇрЈЌ рјбрјЕрЈЈ, рјцрЈћрјЙ рјбрјЕрЈЈ, рјдрЈѓрЈ░рјЕ, рјдрЈњрЈЏ рјЙ рјбрјЕрЈЈ
­Ъў║	рјарј░рјх, рјарЈЇрјбрЈЊ, рјцрјДрЈЏ, рјцрЈцрЈБрЈЇрЈЌ, рјцрЈцрЈБрЈЇрЈЌ рЈфрЈї рјцрјДрЈЏ, рЈфрЈї
­ЪўИ	рјарјдрЈў, рјцрјДрЈЏ, рјцрјГрЈЂ, рјцрЈцрЈБрЈЇрЈЌ, рјцрЈцрЈБрЈЇрЈЌ рЈфрЈї рјцрјДрЈЏ рјЙрЈЇрјЕ рјцрЈцрЈБрЈЇрЈЌ рЈЊрјДрЈЁрјб, рЈфрЈї
­Ъў╣	рјцрјдрЈћрЈгрјИ, рјцрјДрЈЏ, рјцрјхрј«рјхрЈе, рЈфрЈї, рЈфрЈї рјцрјДрЈЏрјб рјарјхрј«рјхрјгрјб рјцрјДрЈЏрјб
­Ъў╗	рјарјдрЈў, рјцрјДрЈЏ, рјцрЈцрЈБрЈЇрЈЌ, рјдрјИрЈЅрЈЌ, рЈфрЈї, рЈфрЈї рјцрЈ░рЈЌрЈЇрјг рјцрјДрЈћ рЈДрјЙрЈФ-рЈЌрјДрЈѓ
­Ъў╝	рјцрјДрЈЏ, рјцрјДрЈ▓рЈЊ, рјцрЈцрЈБрЈЇрЈЌ, рЈЃрјхрЈЇрјгрјЙ, рЈфрЈї, рЈфрЈї рјцрјДрЈЏрјб рјарЈЊрЈ░рјхрја рјцрЈцрЈБрЈЇрЈЏрјб
­Ъўй	рјарјдрЈў, рјарЈЊрЈћрЈфрЈЎрЈЇрјЕ рЈфрЈї рјцрјДрЈЏ, рјарЈћрЈфрЈЎрјбрЈЇрЈЌ, рјцрјДрЈЏ, рЈфрЈї
­ЪЎђ	рјБ, рјцрјДрЈЏ, рЈЌрјдрЈЇрЈЌрЈ░рЈЇрјЕ, рЈЌрјдрЈЇрЈЌрЈ░рЈЇрјЕ рЈфрЈї рјцрјДрЈЊ, рЈДрЈЇрЈћрЈ░рЈњ, рЈфрЈї
­Ъў┐	рјарЈарј»рјГ, рјарЈарЈ▒рјГ рЈфрЈї рјцрјДрЈЏ, рјцрјдрЈћрЈгрјИ, рјцрјДрЈЏ, рјцрЈ▓ рјцрЈЊрЈЁрЈћ, рЈфрЈї
­ЪўЙ	рјцрјДрЈЏ, рјцрЈЊрЈЂрј»рЈ│, рјцрЈЊрЈЂрј»рЈ│ рЈфрЈї рјцрјДрЈЏ, рЈфрЈї
­ЪЎѕ	рјарјфрЈЕрЈЏрЈЌ, рјарЈЇрјЕрјЙ, рјарЈЊрј┤рЈЇрјЕрЈ▒рЈЇрјЕ, рјбрЈ»рЈЏрЈЂрЈЌ рЈѓрјерЈњрјЙ, рјцрјДрЈЏ, рЈЮ рјЙрјфрЈФрЈўрј▓рјЙ-рјцрЈЂрјФрЈЦрЈЊ- рјарЈЊрј┤рЈЇрјЕрЈ▒рЈЇрјЕ
­ЪЎЅ	рјарЈЇрјЕрјЙ, рјарЈЊрј┤рЈЇрјЕрЈ▒рЈЇрјЕ, рјарЈЏрјЕрЈЇрјЕ-рЈѓрјерЈњрјЙ-рјцрЈ▓ рјарЈЊрј┤рЈЇрјЕрЈ▒рЈЇрјЕ, рјарЈЏрјфрЈЌ, рјбрЈ»рЈЏрЈЂрЈЌ рЈѓрјерЈњрјЙ, рјцрјДрЈЏ
­ЪЎі	рјарЈЇрјЕрјЙ, рјарЈЊрј┤рЈЇрјЕрЈ▒рЈЇрјЕ, рјбрЈ»рЈЏрЈЂрЈЌ рЈѓрјерЈњрјЙ, рјцрјДрЈЏ, рјдрЈгрЈѓрј»рЈЇрЈЌ, рЈѓрјдрЈгрЈѓрЈЇрјгрјЙ рјцрЈ▓ рјарЈЊрј┤рЈЇрјЕрЈ▒рЈЇрјЕ
­ЪЉХ	рјарЈЊрје, рјцрЈЇрЈЌ
­ЪДњ	рјарЈЊ, рјарЈ▓рЈЪ, рјбрЈ│рЈЇрЈЌ рјерј▓-рјбрЈ│рЈЇрЈЌрЈі
­ЪЉд	рјарЈДрЈБ, рјарЈФрјЙ
­ЪЉД	рјарјерЈ», рјарјерЈ│рЈБ, рјдрЈЎрјЕ, рЈЃрЈѕрЈЈ рЈЊрЈЪрјХрЈЇрЈЌрј▓рјб
­ЪДЉ	рјбрЈ│рЈЇрЈЌ рјерј▓-рјбрЈ│рЈЇрЈЌрЈі, рјцрЈћрјЙ
­ЪЉ▒	рЈЊрјХрЈѓрје рјцрЈЇрЈўрјЕ, рЈЊрјХрЈѓрје-рјцрЈЇрЈўрјЕ рЈ┤рЈФ
­ЪЉе	рјарЈЇрјдрЈ»
­ЪЉ▒РђЇРЎѓ	рјарЈЇрјдрЈ», рЈЊрјХрЈѓрје рјцрЈЇрЈўрјЕ, рЈЊрјХрЈѓрје рјцрЈЇрЈўрјЕ-рјцрЈЇрЈўрјЕ рјарЈЇрјдрЈ»
­ЪДћ	рјарЈјрјирјИрј», рЈЌрјГрЈёрјИрј» рјарЈЇрјдрЈ»
­ЪЉЕ	рјарјерЈ»
­ЪЉ▒РђЇРЎђ	рјарјерЈ», рЈЊрјХрЈѓрје рјцрЈЇрЈўрјЕ, рЈЊрјХрЈѓрје-рјцрЈЇрЈўрјЕ рјарјерЈ»
­ЪДЊ	рјарјдрЈ┤рјх рјцрЈћрјЙ, рјбрЈ│рЈЇрЈЌ рјерј▓-рјбрЈ│рЈЇрЈЌрЈі, рјцрЈфрЈў
­ЪЉ┤	рјарјгрЈ┤рјх, рјарЈЇрјдрЈ», рјцрЈЏрЈљрЈЁ
­ЪЉх	рјарјерЈ», рјарјгрЈ┤рјх, рјарјгрЈ┤рјхрје
­ЪЉеРђЇРџЋ	рјарјдрјЙрјдрЈў, рјарЈЇрјдрЈ», рјарЈЇрјдрЈ» рЈЎрј»рЈЃрЈЏрј┐рЈЋрјгрјб рјцрјдрЈјрЈЇрЈЌ рЈДрјИрЈФрЈЇрЈЊрЈЂрј», рјарЈЊрЈЇрЈЋрјИрј»рЈЎрј», рјдрјЙрјдрЈў рјарЈЇрЈЋрјхрЈЇрјЕ, рЈЎрј»рЈЃрЈЏрј┐рЈЋрјгрјб рјцрјдрЈјрЈЇрЈЌ
­ЪЉЕРђЇРџЋ	рјарјдрјЙрјдрЈў, рјарјдрјЙрјдрЈў рјарЈЇрЈЋрјхрЈЇрјЕ, рјарјерЈ», рјарјерЈ» рЈЎрј» рЈЃрЈЏрј┐рЈЋрјгрјб рЈДрјИрЈФрЈЇрЈЊрЈЂрј», рјарЈЊрЈЇрЈЋрјИрј»рЈЎрј», рЈЎрј» рЈЃрЈЏрј┐рЈЋрјгрјб рјцрјдрЈјрЈЇрЈЌ
­ЪЉеРђЇ­ЪјЊ	рјарЈЇрјдрЈ», рјарЈЇрјдрЈ» рЈЌрЈЋрјХрЈєрЈЇрјЕ, рЈЌрЈЇрЈєрЈЌрЈЇрјЕ, рЈЌрЈЋрјХрЈєрЈЇрјЕ
­ЪЉЕРђЇ­ЪјЊ	рјарјерЈ», рјарјерЈ» рЈЌрЈЋрјХрЈєрЈЇрјЕ, рЈЌрЈЇрЈєрЈЌрЈЇрјЕ, рЈЌрЈЋрјХрЈєрЈЇрјЕ
­ЪЉеРђЇ­ЪЈФ	рјарЈЇрјдрЈ», рјарЈЇрјдрЈ» рЈЌрЈЋрЈ▓рј▓рЈЇрјЕ, рјарЈЊрЈЁрЈФрЈЇрЈЌрЈЇрјЕ, рЈёрјгрЈФрЈ│рЈњ рЈЌрЈЋрЈ▓рј▓рЈЇрјд, рЈЌрЈЋрЈ▓рј▓рЈЇрјЕ
­ЪЉЕРђЇ­ЪЈФ	рјарјерЈ», рјарјерЈ» рЈЌрЈЋрЈ▓рј▓рЈЇрјЕ, рјарЈЊрЈјрј«рј», рјцрЈћрјЙ рЈЌрЈЋрЈ▓рј▓рЈЇрјЕ, рЈЌрЈЋрЈ▓рј▓рЈЇрјЕ
­ЪЉеРђЇРџќ	рјарЈЇрјдрЈ», рјарЈЇрјдрЈ» рЈЌрјФрјфрЈЌрЈЇрјЕ, рЈЌрјдрЈЏрЈЌ, рЈЌрјДрј┐рЈЕрЈЏрЈЇрЈЌ
­ЪЉЕРђЇРџќ	рјарјерЈ», рјарјерЈ» рЈЌрјФрјфрЈЌрЈЇрјЕ, рЈЌрјдрЈЏрЈЌ, рЈЌрјФрјфрЈЌрЈЇрјЕ
­ЪЉеРђЇ­ЪїЙ	рјарЈЇрјдрЈ», рјарЈЇрјдрЈ» рЈЌрјдрјХрјЕрЈЇрјЕ, рјарЈФрЈњрЈЇрјЕ, рјцрјЙрЈЮрјЙрјб, рЈЌрјдрјХрјЕрЈЇрјЕ
­ЪЉЕРђЇ­ЪїЙ	рјарјерЈ», рјарјерЈ» рЈЌрјдрјХрјЕрЈЇрјЕ, рјарЈФрЈњрЈЇрјЕ, рјцрјЙрЈЮрјЙрјб, рЈЌрјдрјХрјЕрЈЇрјЕ
­ЪЉеРђЇ­ЪЇ│	рјарЈЇрјдрЈ», рјарЈЇрјдрЈ» рјарЈЊрЈЇрЈЊрЈ┤рј▓рЈЇрјд, рјарЈЊрЈЇрЈЊрЈ┤рј▓рЈЇрјд, рјБрј»рЈЇрЈЌ рјарЈЊрЈЇрЈЊрЈ┤рј▓рЈЇрјд
­ЪЉЕРђЇ­ЪЇ│	рјарјерЈ», рјарјерЈ» рЈЌрЈЊрЈЇрЈЊрЈ┤рј▓рЈЇрјЕ, рЈЌрЈЊрЈЇрЈЊрЈ┤рј▓рЈЇрјЕ
­ЪЉеРђЇ­ЪћД	рјарјхрјбрЈЏрј▓рЈЇрјЕ, рјарј╣ рЈДрЈфрЈЊрЈЇрЈЌрјб рјБрЈЇрЈЊ рЈ▒рЈЌрјгрЈЂрј», рјарЈЇрјдрЈ», рјарЈЇрјдрЈ» рЈЎрЈєрј┤рји рЈДрјИрЈФрЈЇрЈЊрЈЂрј», рЈЌрјЙрјдрјхрЈЇрјЕ рЈДрјИрЈФрЈЇрЈЊрЈЂрј», рЈЎрЈєрј┤рји рјБрЈЇрЈЊ рЈ▒рЈЌрјгрЈЂрј»
­ЪЉЕРђЇ­ЪћД	рјарјерЈ», рјарјерЈ» рЈЎрЈєрј┤рји рјБрЈЇрЈЊ рЈ▒рЈЌрјгрЈЂрј», рјарјхрјбрЈЏрј▓рЈЇрјЕ, рјарј╣ рЈДрЈфрЈЊрЈЇрЈЌрјб рјБрЈЇрЈЊ рЈ▒рЈЌрјгрЈЂрј», рјарјЙрјдрјхрЈЇрјЕ рЈДрјИрЈФрЈЇрЈЊрЈЂрј», рЈЎрЈєрј┤рји рјБрЈЇрЈЊ рЈ▒рЈЌрјгрЈЂрј»
­ЪЉеРђЇ­ЪЈГ	рјарЈЇрјдрЈ», рјарЈЇрјдрЈ» рјцрЈЃрЈбрЈЁрЈЌ рЈДрјИрЈФрЈЇрЈЊрЈЂрј», рјцрјЙрЈЊрЈЪрЈїрј▓, рјцрЈЃрЈбрЈЁрЈЌ, рЈДрЈѓрјИрЈФрЈЇрЈЊрЈЂрј», рЈДрЈѓрјИрЈФрЈЇрЈЊрЈЂрЈЌ
­ЪЉЕРђЇ­ЪЈГ	рјарјерЈ», рјарјерЈ» рЈЌрјдрјИрЈФрЈЇрЈЊрЈЂрЈЌ рЈДрјИрЈФрЈЇрЈЊрЈЂрј», рЈѓрјдрЈЊ рЈџрЈѓрјИрЈФрЈЇрЈЊрЈЂрј▓рјб, рЈЌрјдрјИрЈФрЈЇрЈЊрЈЂрЈЌ рјцрЈЎрј┤рЈњрјб, рЈЌрјдрјИрЈФрЈЇрЈЊрЈЂрЈЌ рЈџрЈЎрЈбрЈњрјб, рЈДрјИрЈФрЈЇрЈЊрЈЂрј»
­ЪЉеРђЇ­Ъњ╝	рјарЈЇрјдрЈ», рјарЈЇрјдрЈ» рјцрЈгрЈЪ рЈДрјИрЈФрЈЇрЈЊрЈЂрј», рјарЈЊрЈЁрЈќрЈЪрЈЎрј», рјцрЈЂрјд рјцрјдрЈЮрЈЮрјб, рЈЌрјдрјИрЈФрЈЇрЈЊрЈЂрЈЌрјб рјцрЈЎрЈбрЈњ, рЈЌрјдрјИрЈФрЈЇрЈЊрЈЌрјб, рЈЌрЈЪрјХрЈЇрЈћрЈЁрј▓рЈЇрјЕ
­ЪЉЕРђЇ­Ъњ╝	рјарјерЈ», рјарјерЈ» рЈЌрјдрјИрЈФрЈЇрЈЊрЈЂрЈЌ рЈДрЈёрЈФрЈЇрЈЊрЈЂрј», рјарЈЊрЈЁрЈќрЈЪрЈЎрј», рјцрЈЂрјд-рјцрјЕрЈЮрЈЮрјб, рЈЌрјдрјИрЈФрЈЇрЈЊрЈЂрЈЌ, рЈЌрјдрјИрЈФрЈЇрЈЊрЈЂрЈЌ рјцрЈЎрЈбрЈњрјб, рЈЌрЈЪрјХрЈЇрЈћрЈЁрј▓рЈЇрјЕ
­ЪЉеРђЇ­Ъћг	рјарЈЇрјдрЈ», рјарЈЇрјдрЈ» рјцрјдрЈЏрј▓рЈЇрјЕ, рјцрјдрЈЏрј▓рЈЇрјЕ, рјцрјдрЈЏрЈѓрЈЎрј», рЈЌрЈјрЈЇрЈЌ рЈДрјдрЈјрЈЇрЈЌ, рЈЌрЈЪрјХрЈЇрЈћрЈЁрј▓рЈЇрјЕ
­ЪЉЕРђЇ­Ъћг	рјарјерЈ», рјарјерЈ» рјцрјдрЈЏрј▓рЈЇрјЕ, рјцрјдрЈЏрј▓рЈЇрјЕ, рјцрјдрЈЏрЈѓрЈЎрј», рЈЌрЈјрЈЇрЈЌ рЈДрјдрЈјрЈЇрЈЌ, рЈЌрЈЪрјХрЈЇрЈћрЈЁрј▓рЈЇрјЕ
­ЪЉеРђЇ­Ъњ╗	рјарЈЇрјдрЈ», рјарЈЇрјдрЈ» рЈЊрЈЈрј│рЈЋрЈФрЈњрјб рЈДрјИрЈФрЈЇрЈЊрЈЂрј», рјарЈЎрјирЈЕрЈўрЈЇрјЕ, рјцрЈЋрјхрЈЊ рјДрЈЂрјЕ, рјфрЈбрЈЇрјЕ, рЈЊрЈЈрј│рЈЋрЈФрЈњрјб рЈДрјИрЈФрЈЇрЈЊрЈЂрј», рЈЕрЈѓрје рјдрЈЁрЈЌрЈЁрЈЌ
­ЪЉЕРђЇ­Ъњ╗	рјарјерЈ», рјарјерЈ» рјарЈЈрј│рЈЋрЈФрЈњрјб рЈДрјИрЈФрЈЇрЈЊрЈЂрј», рјарЈЈрј│рЈЋрЈФрЈњрјб рЈДрјИрЈФрЈЇрЈЊрЈЂрј», рјарЈЎрјирЈЕрЈўрЈЇрјЕ, рјцрЈЋрјхрЈЊ рјДрЈЂрјЕ, рјфрЈбрЈЇрјЕ, рЈЕрЈѓрје рјдрјЙрЈЌрЈЁрЈЌ
­ЪЉеРђЇ­Ъјц	рјарЈЇрјдрЈ», рјарЈЇрјдрЈ» рЈЌрјДрЈЃрјЕрЈЇрјЕ, рјарЈЏрЈЂрјхрЈЇрјЕ, рјарЈЏрЈЂрјИрЈЇрјЕ, рЈЃрЈѕрЈЈ, рЈЁрЈ», рЈЌрјДрЈЃрјЕрЈЇрјЕ
­ЪЉЕРђЇ­Ъјц	рјарјерЈ», рјарјерЈ» рЈЌрјДрЈЃрјЕрЈЇрјЕ, рјарЈЏрЈЂрјхрЈЇрјЕ, рЈЃрЈѕрЈЈ, рЈЁрЈ», рЈЌрјДрЈЃрјЕрЈЇрјЕ, рЈЌрјДрЈЃрјЕрЈЇрЈЌрЈЇрјЕ
­ЪЉеРђЇ­Ъје	рјарЈЇрјдрЈ», рјарЈЇрјдрЈ» рЈЌрЈЉрЈФрЈЇрјЕ, рЈЌрЈЉрЈФрЈЇрјЕ, рЈ»рЈќрјЙ
­ЪЉЕРђЇ­Ъје	рјарјерЈ», рјарјерЈ» рЈЌрЈЪрјХрЈЇрЈЌрЈЇрјЕ, рЈЌрЈЉрЈФрЈЇрјЕ, рЈ»рЈќрјЙ
­ЪЉеРђЇРюѕ	рјарЈЇрјдрЈ», рјарЈЇрјдрЈ» рЈЦрЈ│ рјДрЈЁрЈФрЈЇрЈЌрЈЇрјЕ, рЈЦрЈ│, рЈЦрЈ│ рјДрЈЁрЈФрЈЇрЈЌрЈЇрјЕ
­ЪЉЕРђЇРюѕ	рјарјерЈ», рјарјерЈ» рЈЦрЈ│ рјарј▓рјхрЈЎрј», рЈЦрЈ│, рЈЦрЈ│ рЈЌрј»рј┤рјЕ
­ЪЉеРђЇ­Ъџђ	рјарЈЇрјдрЈ», рјарЈЇрјдрЈ» рјдрјИрјХрј» рјАрЈЎрј», рјдрјИрјХрј» рјАрЈЎрј», рјдрјИрјХрј» рЈФрЈЎрј»
­ЪЉЕРђЇ­Ъџђ	рјарјерЈ», рјарјерЈ» рјдрјИрјХрј» рјАрЈЎрј», рјарЈЮрЈФрЈЌрЈЇрјЕ, рјдрјИрјХрј» рјАрЈЎрј»
­ЪЉеРђЇ­Ъџњ	рјарЈЇрјдрЈ», рјарЈЇрјдрЈ» рЈЌрјгрЈЮрЈЌрЈЇрјЕ, рЈЌрјгрЈЮрЈЌрЈЇрјЕ, рЈЌрјЙрЈЮрЈЌрЈЇрјЕ рјцрјЙрЈдрЈЎрЈЌ
­ЪЉЕРђЇ­Ъџњ	рјарјерЈ», рјарјерЈ» рЈЌрјдрЈЮрЈЌрЈЇрјЕ, рЈЌрјдрЈЮрЈЌрЈЇрјЕ, рЈЌрЈЁрЈЮрЈЌрЈЇрјЕ рјцрјЙрЈдрЈЎрЈЌ
­ЪЉ«	рЈЌрЈЊрЈѓрЈ▒рЈЇрјЕ
­ЪЉ«РђЇРЎѓ	рјарЈЇрјдрЈ», рјарЈЇрјдрЈ» рЈЌрЈЊрЈѓрЈ▒рЈЇрјЕ, рЈЌрЈЊрЈѓрЈ▒рЈЇрјЕ
­ЪЉ«РђЇРЎђ	рјарјерЈ», рјарјерЈ» рЈЌрЈЊрЈѓрЈ▒рЈЇрјЕ, рЈЌрЈЊрЈѓрЈ▒рЈЇрјЕ
­ЪЋхРђЇРЎѓ	рјарЈЇрјдрЈ», рјарЈЇрјдрЈ» рјцрјдрЈЏрЈѓрЈЎрј», рјцрјдрЈЏрЈѓрЈЎрј», рјцрЈЇрЈѕрЈѓрЈ░рЈЌ, рјцрЈЋрјхрЈЊ рјцрјдрЈЏрЈѓрЈЎрј»
­ЪЋхРђЇРЎђ	рјарјерЈ», рјарјерЈ» рјцрјдрЈЏрЈѓрЈЎрј», рјцрјдрЈЏрЈѓрЈЎрј», рјцрЈЇрЈѕрЈѓрЈ░рЈЌ, рјцрЈЋрјхрЈЊ рјцрјдрЈЏрЈѓрЈЎрј»
­Ъњѓ	рјарЈ»рЈФрЈЇрјЕ
­ЪњѓРђЇРЎѓ	рјарЈЇрјдрЈ», рјарЈЇрјдрЈ» рјарЈ»рЈФрЈЇрјЕ, рјарЈ»рЈФрЈЇрјЕ
­ЪњѓРђЇРЎђ	рјарјерЈ», рјарјерЈ» рјарЈ»рЈФрЈЇрјЕ, рјарЈ»рЈФрЈЇрјЕ
­ЪЉи	рјарјхрЈЇрЈЄрЈџрЈг, рЈЌрЈЂрЈЇрјерЈЇрјЕ, рЈЌрЈЂрЈЇрјерЈЇрјЕ рЈДрјИрЈФрЈЇрЈЊрЈЂрј», рЈДрјИрЈФрЈЇрЈЊрЈЂрј»
­ЪЉиРђЇРЎѓ	рјарЈЇрјдрЈ», рјарЈЇрјдрЈ» рЈЌрЈЂрЈЇрјерЈЇрјЕ рЈДрјИрЈФрЈЇрЈЊрЈЂрј», рЈЌрЈЂрЈЇрјерЈЇрјЕ, рЈДрјИрЈФрЈЇрЈЊрЈЂрј»
­ЪЉиРђЇРЎђ	рјарјерЈ», рјарјерЈ» рЈЌрЈЂрЈЇрјерЈЇрјЕ рЈДрјИрЈФрЈЇрЈЊрЈЂрј», рЈЌрЈЂрЈЇрјерЈЇрјЕ, рЈДрјИрЈБрЈЇрЈЊрЈЂрј»
­Ъц┤	рјарЈФрјЙ рјцрјгрЈгрЈ│рј»
­ЪЉИ	рјарЈћ рјцрјгрЈФрЈ│рј», рјЦрЈЊрЈЁрЈќрЈЇрјгрјб рј░рЈЕрЈѓрјерЈњрјЙ, рј░рЈЕрЈѓрјерЈњрјЙ
­ЪЉ│	рјарјхрЈЇрЈџрјХ, рЈ┤рЈФ рјдрјИрЈфрЈЇрЈЊрЈЁ рјцрјхрЈЇрЈџрј│
­ЪЉ│РђЇРЎѓ	рјарјхрЈЇрЈџрјХ, рјарЈЇрјдрЈ», рјарЈЇрјдрЈ» рјцрјхрЈЇрЈџрј│
­ЪЉ│РђЇРЎђ	рјарјерЈ», рјарјерЈ» рјцрјхрЈЇрЈџрј│, рјарјхрЈЇрЈџрјХ
­ЪЉ▓	рјарјхрЈЇрЈЄрЈћрЈг, рјарЈЇрјдрЈ», рјарЈЇрјдрЈ» рЈБрЈѓрЈЈ рјцрјхрЈЇрЈЄрЈџрјЕ, рЈє рЈѕ рј╣рјБ
­ЪДЋ	рјарјерЈ» рјцрјхрЈЇрЈєрЈЃрј», рјарјхрЈЇрЈєрЈЃрЈЇрЈЌ, рј»рЈБ, рј║рЈўрј│, рЈўрЈЦ
­Ъцх	рјарЈЇрјдрЈ», рјарЈЇрјдрЈ» рјцрЈЇрЈЊрЈ»рјгрЈЇрЈЌ рЈДрЈёрЈЕ, рјарЈЇрјдрЈ» рЈерјдрЈерЈЇрЈЌрЈЇрјЕ, рЈДрЈарЈ▒рјГрјб рЈЌрј┐рЈгрЈЇрЈЌ
­ЪЉ░	рјцрЈерЈЁрЈЎрЈЌ, рЈЊрјЙрЈЊрЈерЈЇрЈЌрЈЇрјг, рЈБрјдрЈарЈЇрЈЌрЈЇрјЕ рјарјерЈ», рЈБрјдрЈерЈЇрЈћрЈѓрЈЊ рјарјерЈ» рјцрЈерЈЁрј»
­Ъц░	рјарјерЈ», рјдрЈЂрјхрЈЊ, рјдрЈЂрјхрЈЊ рјарјерЈ»
­Ъц▒	рјцрЈЇрЈЌ, рјдрЈЂрЈЦ, рјерјХрјГ, рЈДрЈЊрЈЇрЈЊрјб
­ЪЉ╝	рјарЈЊрЈфрј» рјДрЈЃрј«рЈЊ, рјцрјДрЈЏ, рјцрЈЇрЈЌ, рјцрЈЇрЈЌ рЈЌрјДрј┐рЈЕрЈЌрЈЎрј», рј░рЈЕ рЈѓрјерЈњрјЙ, рЈЌрјДрЈЁрЈЕрЈЌрЈЎрј»
­ЪјЁ	рјарјхрј«рјхрЈЇрЈЌрјб, рјАрЈЎрЈЊ, рЈЊрЈѓрЈЇрЈЊрЈ▓рј»рј▓рјб, рЈДрЈарјдрј┤рЈЊ
­ЪцХ	рјарјерЈ» рјдрЈЂрјх., рјарјерЈ» рјдрЈЂрјх. рЈДрЈарјдрј┤рЈЊ, рјарјЙрјхрј«рјхрјгрјб, рјАрЈЦ, рЈЊрЈѓрЈЇрЈЊрЈ▓рј»рј▓рјб, рЈДрЈарјдрј┤рЈЊ
­ЪдИ	рјБрЈЇрЈЊ, рЈёрјгрЈФрЈ│рЈњрјЕ рјцрЈЪрЈѓрјЕрЈЊ, рЈёрјгрЈФрЈ│рЈњрјЕ рЈЕрЈЦрјИрЈЅрЈЏ, рЈЕрЈЦрјИрЈЅрЈЏ, рЈгрЈѓрјИрЈЅрЈЏрјб
­ЪдИРђЇРЎђ	рјарјерЈ», рјарјерЈ» рЈёрјгрЈФрЈ│рЈњрјЕ рЈЕрЈЦрјИрЈЅрЈЏ, рјБрЈЇрЈЊ, рЈёрјгрЈФрЈ│рЈњрјЕ рјцрЈЪрЈѓрјЕрЈЊ, рЈЕрЈЦрјИрЈЅрЈЏ, рЈгрЈѓрјИрЈЅрЈЏрјб
­ЪдИРђЇРЎѓ	рјарЈЇрјдрЈ», рјарЈЇрјдрЈ» рЈёрјгрЈФрЈ│рЈњрјЕ рЈЕрЈЦрјИрЈЅрЈЏ, рјБрЈЇрЈЊ, рЈёрјгрЈФрЈ│рЈњрјЕ рјцрЈЪрЈѓрјЕрЈЊ, рЈЕрЈЦрјИрЈЅрЈЏ
­Ъд╣	рјарЈЇрјдрЈѓ, рјцрЈЇрјдрЈЁрЈерј» рјерЈњрјб, рјцрЈљрЈЁрјб, рЈёрјгрЈФрЈ│рЈњрјЕ рјарЈЇрјдрЈѓ, рЈёрјгрЈФрЈ│рЈњрјЕ рјцрЈЪрЈѓрјЕрЈЊ
­Ъд╣РђЇРЎђ	рјарјерЈ», рјарјерЈ» рЈёрјгрЈФрЈ│рЈњрјЕ рјарЈЇрјдрЈѓ, рјарЈЇрјдрЈѓ, рјцрЈЇрјдрЈЁрЈерј» рјерЈњрјб, рјцрЈљрЈЁрјб, рЈёрјгрЈФрЈ│рЈњрјЕ рјцрЈЪрЈѓрјЕрЈЊ
­Ъд╣РђЇРЎѓ	рјарЈЇрјдрЈѓ, рјарЈЇрјдрЈ», рјарЈЇрјдрЈ» рЈёрјгрЈФрЈ│рЈњрјЕ рјарЈЇрјдрЈѓ, рјцрЈЇрјдрЈЁрЈерј» рјерЈњрјб, рјцрЈљрЈЁрјб, рЈёрјгрЈФрЈ│рЈњрјЕ рјцрЈЪрЈѓрјЕрЈЊ
­ЪДЎ	рјарЈЊрЈф, рЈЌрЈЊрЈЂрЈјрЈЇрјЕ, рЈЌрЈЊрЈЂрЈјрЈЇрјЕ рјарјерЈ», рЈЌрЈЎрЈѓрЈЇрјЕ
­ЪДЎРђЇРЎђ	рјарјерЈ» рјарЈЊрЈф, рЈЌрЈЊрЈЂрЈјрЈЇрјЕ, рЈЌрЈЎрЈѓрЈЇрјЕ
­ЪДЎРђЇРЎѓ	рјарЈЇрјдрЈ» рјарЈЊрЈф, рјарЈЊрЈф, рЈЌрЈЊрЈЂрЈјрЈЇрјЕ
­ЪДџ	рјБрЈЕрјЙрЈѓ, рЈІрјЕ, рЈўрЈћрЈѓрЈ», рЈ┤рЈФ рјцрЈЇрЈЌ рјдрЈЃрј»рјхрЈЎрј»
­ЪДџРђЇРЎђ	рјарјерЈ» рЈ┤рЈФ рјцрЈЇрЈЌ рјдрЈЃрј»рјхрЈЎрј», рЈўрЈћрЈѓрЈ»
­ЪДџРђЇРЎѓ	рјарЈЇрјдрЈ» рЈ┤рЈФ рјцрЈЇрЈЌ рјдрЈЃрј»рјхрЈЎрј», рјБрЈєрЈ»рЈѓ, рЈІрјЕ
­ЪДЏ	рјцрЈ▓рј▒рЈњ рЈѓрјерЈњрјЙ, рјЕрјд рјарЈЊрЈЂрјЕрјАрј», рјЕрјд рјарЈЌрЈћрЈЇрјЕ
­ЪДЏРђЇРЎђ	рјарјерЈ» рјЕрјд рјарЈЊрЈЂрјЕрјАрј», рјцрЈ▓рј▒рЈњрјб рЈѓрјерЈњрјЙ
­ЪДЏРђЇРЎѓ	рјарЈЇрјдрЈ» рјЕрјд рјарЈЊрЈЂрјЕрЈЏрј», рјцрЈ▓рј▒рЈњ рЈѓрјерЈњрјЙ, рјЕрјд рјарЈЌрЈћрЈЇрјЕ
­ЪДю	рјарјерЈ» рјарЈБрЈЌ рјцрјгрјГрЈЪ, рјарЈЇрјдрЈ» рјарЈБрЈЌ рјцрјгрјГрЈЪ, рЈ┤рЈФ рјарЈБрЈЌ рјцрјгрјГрЈЪ
­ЪДюРђЇРЎђ	рјарјерЈ» рјарЈБрЈЌ рјарј╣, рјарјерЈ» рјарЈБрЈЌ рјцрјгрјГрЈЪ
­ЪДюРђЇРЎѓ	рјарЈЇрјдрЈ» рјарЈБрЈЌ рјцрјгрјГрЈЪ, рјарЈЊрј»рЈЇрЈЎрЈЌ
­ЪДЮ	рјцрЈЋрјхрЈЏ рјгрЈЌ рјарЈЏрЈЂрјИрЈЌ, рЈ┤рЈФ рјцрЈЇрЈєрЈѓрјфрЈЌрЈ│
­ЪДЮРђЇРЎђ	рјарјерЈ» рЈ┤рЈФ рјбрЈ│рЈЇрЈЌ, рјцрЈЋрјхрЈЏ рјгрЈЌ рјарЈЏрЈЂрјИрЈЌ
­ЪДЮРђЇРЎѓ	рјарЈЇрјдрЈ» рЈ┤рЈФ рјбрЈ│рЈЇрЈЌ, рјцрЈЋрјхрЈЏ рјгрЈЌ рјарЈЏрЈЂрјИрЈЌ
­ЪДъ	рЈЦрјЙрЈ▒, рЈЦрЈѓ
­ЪДъРђЇРЎђ	рјарјерЈ» рЈЦрјЙрЈ▒, рЈЦрЈѓ
­ЪДъРђЇРЎѓ	рјарЈЇрјдрЈ» рЈЦрјЙрЈ▒, рЈЦрЈѓ
­ЪДЪ	рјарјбрЈњрјб рјцрЈ▓рј▒рЈњрјб, рјцрЈ▓рј▒рЈњ рјцрЈЌрЈЏрЈЊ, рјцрЈ▓рј▒рЈњрј» рЈѓрјерЈњрјЙ
­ЪДЪРђЇРЎђ	рјарјбрЈњрјб рјцрЈ▓рј▒рЈњрјб, рјарјерЈ» рјцрЈ▓рј▒рЈњ рјцрЈЌрЈЏрЈЊ, рјцрЈ▓рј▒рЈњрј» рЈѓрјерЈњрјЙ
­ЪДЪРђЇРЎѓ	рјарјбрЈњрјб рјцрЈ▓рј▒рЈњрјб, рјарЈЇрјдрЈ» рјцрЈ▓рј▒рЈњ рјцрЈЌрЈЏрЈЊ, рјцрЈ▓рј▒рЈњрј» рЈѓрјерЈњрјЙ
­ЪЎЇ	рјарЈјрЈЪрЈЎрј», рјцрЈЊрЈЂрјфрЈ│, рЈ┤рЈФ рјцрЈЊрЈЂрјфрЈ│
­ЪЎЇРђЇРЎѓ	рјарЈЇрјдрЈ», рјарЈЇрјдрЈ» рјцрЈЊрЈЂрјфрЈ│рјГ, рјарЈјрЈЪрЈЎрј», рјцрЈЊрЈЂрјфрЈ│рјГ
­ЪЎЇРђЇРЎђ	рјарјерЈ», рјарјерЈ» рјцрЈЊрЈЂрјфрЈ│рјГ, рјарЈјрЈЪрЈЎрЈЌ, рјцрЈЊрЈЂрјфрЈ│рјГ
­ЪЎј	рјарЈјрЈЪрЈЎрј», рјцрЈЄрЈЪрјг, рЈ┤рЈФ рјцрЈЄрЈЪрјг
­ЪЎјРђЇРЎѓ	рјарЈЇрјдрЈ», рјарЈЇрјдрЈ» рјцрЈЄрЈЪрјг, рјарЈјрЈЪрЈЎрј», рјцрЈЄрЈЪрјг
­ЪЎјРђЇРЎђ	рјарјерЈ», рјарјерЈ» рјцрЈЄрЈЪрјг, рјарЈїрЈЪрЈЎрј», рјцрЈЄрЈЪрјг
­ЪЎЁ	рјарЈЁрЈЇрЈЎрЈЇрјд, рјарЈјрЈЪрЈЎрј», рјцрЈгрЈ▒, рјЦрЈЮ, рјдрЈЁрЈЇрЈЎрЈЇрјд, рЈ┤рЈФ рјЙрЈЏрЈЂрј▓ рјЦрЈЮ
­ЪЎЁРђЇРЎѓ	рјарЈЇрјдрЈ», рјарЈЇрјдрЈ» рЈЊрЈљрЈ░рЈЇрјг рјЦрЈЮ, рјбрЈ»рЈЏрЈЂрЈЌ рЈѓрјерЈњрјЙ, рјцрЈгрЈ▒, рјЦрЈЮ, рјдрЈЁрЈЇрЈЎрЈЇрјд, рЈЊрЈљрЈ░рЈЇрјг
­ЪЎЁРђЇРЎђ	рјарјерЈ», рјарјерЈ» рЈЊрЈљрЈ░рЈЇрјг рјЦрЈЮ, рјбрЈ»рЈЏрЈЂрЈЌ рЈѓрјерЈњрјЙ, рјцрЈгрЈ▒, рјЦрЈЮ, рјдрЈЁрЈЇрЈЎрЈЇрјд, рЈЊрЈљрЈ░рЈЇрјг
­ЪЎє	рјцрЈгрЈ▒, рјГрЈЕ, рЈЊрЈљрЈ░рЈЇрјг, рЈ┤рЈФ рјарЈјрЈЪрЈЎрј▓ рјГрЈЕ
­ЪЎєРђЇРЎѓ	рјарЈЇрјдрЈ», рјарЈЇрјдрЈ» рЈЊрЈљрЈ░рЈЇрјг рјГрЈЕ, рјцрЈгрЈ▒, рјГрЈЕ, рЈЊрЈљрЈ░рЈЇрјг
­ЪЎєРђЇРЎђ	рјарјерЈ», рјарјерЈ» рЈЊрЈљрЈ░рЈЇрјг рјГрЈЕ, рјцрЈгрЈ▒, рјГрЈЕ, рЈЊрЈљрЈ░рЈЇрјг
­ЪњЂ	рјарјхрЈЇрЈЋрјИрЈЌ, рјцрјхрЈЇрјдрЈѓрЈЈ, рјцрЈўрЈїрЈЌ, рјцрЈгрЈ▒, рјгрјДрЈЃрј«рЈЌ, рЈ┤рЈФ рјгрЈѓрјерЈњ рЈѓрјгрЈЂрј▓ рЈєрЈѓрЈ▓рЈЇрЈЌ
­ЪњЂРђЇРЎѓ	рјарЈЇрјдрЈ», рјарЈЇрјдрЈ» рјцрЈўрЈїрЈЌ рјцрЈгрЈ▒, рјцрјхрЈЇрјдрЈѓрЈЈ, рјцрЈўрЈїрЈЌ рјцрЈгрЈ▒
­ЪњЂРђЇРЎђ	рјарјерЈ», рјарјерЈ» рјцрЈўрЈїрЈЌ рјцрЈгрЈ▒, рјцрјхрЈЇрјдрЈѓрЈЈ, рјцрЈўрЈїрЈЌ рјцрЈгрЈ▒рЈг
­ЪЎІ	рјцрјхрј«рјхрЈЇрЈЌ, рјцрЈїрј│рЈЌ, рјцрЈгрЈ▒, рЈЊрЈљрЈ░рЈЇрјг, рЈ┤рЈФ рјцрЈгрЈ░рјЙ рјарјхрЈїрјхрЈЏрЈЇрјгрјб
­ЪЎІРђЇРЎѓ	рјарЈїрј│рЈЌрЈЇрјг рјцрЈгрЈ░рЈѓ, рјарЈЇрјдрЈ», рјарЈЇрјдрЈ» рјцрЈјрјхрЈћ, рЈЊрЈљрЈ░рЈЇрјг
­ЪЎІРђЇРЎђ	рјарјерЈ», рјарјерЈ» рјарЈїрј│рЈЌрЈЇрјг рјцрЈгрЈ░рЈѓ, рјарЈїрј│рЈЌрЈЇрјг рјцрЈгрЈ░рЈѓ, рЈЊрЈљрЈ░рЈЇрјг
­ЪЎЄ	рјАрЈЇрјд рјарЈ░рјИрЈЁрЈЌ, рјАрЈЇрјд рјарЈ░рјИрЈЇрјд, рјцрјхрЈЇрЈѕрЈЌ, рЈЊрЈљрЈ░рЈЇрјг, рЈ┤рЈФ рјцрЈўрЈїрЈў
­ЪЎЄРђЇРЎѓ	рјарЈЇрјдрЈ» рјцрЈўрЈїрЈў, рјарЈЎрЈЇрЈѕрЈЌрја, рјАрЈЇрјд рјарЈ░рјИрЈЇрјд, рјАрЈЇрјд рјарЈ░рјИрЈЇрјг, рЈЊрЈљрЈ░рЈЇрјг, рЈ▒рЈЌрЈЊрЈЏрЈЂрЈЌ
­ЪЎЄРђЇРЎђ	рјарјерЈ», рјарјерЈ» рјцрЈўрЈїрЈў, рјарЈЎрЈЇрЈѕрЈЌрја, рјАрЈЇрјд рјарЈ░рјИрЈЇрјд, рјАрЈЇрјд рјарЈ░рјИрЈЇрјг, рЈЊрЈљрЈ░рЈЇрјг, рЈ▒рЈЌрЈЊрЈЏрЈЂрЈЌ
­Ъцд	рјцрјДрЈЏ, рјцрЈгрјГрЈЂрјдрјИ, рЈёрЈгрј»рЈ│рЈњрјЙ, рЈЕрјхрЈЇрЈєрЈЌрЈЇрјгрјб, рЈ┤рЈФ рјцрјДрЈЏрјб рјарЈЊрЈЈрЈћрЈЌрЈЇрјгрјб
­ЪцдРђЇРЎѓ	рјарЈЇрјдрЈ», рјарЈЇрјдрЈ» рјцрјДрЈЏрјб рјарЈЊрЈЈрЈћрЈЌрЈЇрјгрјб, рјцрјДрЈЏрјб рјарЈЊрЈЈрЈћрЈЌрЈЇрјгрјб, рјцрј┐рјИрј», рЈёрЈгрј»рЈ│рЈњрјЙ
­ЪцдРђЇРЎђ	рјарјерЈ», рјарјерЈ» рјцрјДрЈЏрјб рјарЈЊрЈЈрЈћрЈЌрЈЇрјгрјб, рјцрјДрЈЏрјб рјарЈЊрЈЈрЈћрЈЌрЈЇрјгрјб, рјцрј┐рјИрј», рЈёрЈгрј»рЈ│рЈњрјЙ
­Ъци	рјБрЈюрЈЈрЈЏрјА, рјфрј▒рЈЇрЈЌ рЈёрЈ░рЈЪрЈЏрјЙ, рЈЃрЈѓрЈЏрјЙ, рЈЌрјдрЈЁрЈг рЈџрЈїрј│рЈЏ, рЈ┤рЈФ рЈЌрјдрЈЁрЈг рЈџрЈїрј│рЈЏ
­ЪциРђЇРЎѓ	рјарЈЇрјдрЈ», рјарЈЇрјдрЈ» рЈЌрјдрЈЁрЈг рЈџрЈїрј│рЈЏ, рјБрЈюрЈЈрЈЏрјА, рјфрј▒рЈЇрЈЌ рЈёрЈ░рЈЪрЈЏрјЙ, рЈЃрЈѓрЈЏрјЙ, рЈЌрјдрЈЁрЈг рЈџрЈїрј│рЈЏ
­ЪциРђЇРЎђ	рјарјерЈ», рјарјерЈ» рЈЌрјдрЈЁрЈг рЈџрЈїрј│рЈЏ, рјБрЈюрЈЈрЈЏрјА, рјфрј▒рЈЇрЈЌ рЈёрЈ░рЈЪрЈЏрјЙ, рЈЃрЈѓрЈЏрјЙ, рЈЌрјдрЈЁрЈг
­Ъњє	рјарЈЊрЈЦрЈЇрјфрјхрЈ░рЈЌ, рјцрјДрЈЏ, рјцрјЙрЈЊрЈЎрЈџрЈЇрЈЎрЈЌ, рЈ┤рЈФ рјарЈЦрЈЊрЈЇрјфрјхрЈ░рЈЇрјгрјб
­ЪњєРђЇРЎѓ	рјарЈЇрјдрЈ», рјарЈЇрјдрЈ» рјарЈЦрЈЇрјфрјхрЈ░рЈЇрјгрјб, рјарЈЊрЈЦрЈЇрјфрјхрЈ░рЈЌ, рјцрјДрЈЏ
­ЪњєРђЇРЎђ	рјарјерЈ», рјарјерЈ» рјарЈЦрЈЇрјфрјхрЈ░рЈЇрјгрјб, рјарЈЊрЈЦрЈЇрјфрјхрЈ░рЈЌ, рјцрјДрЈЏ
­ЪњЄ	рјарјхрЈЇрЈЎрЈЌ, рјцрЈгрЈџрј», рјДрЈЁрЈЉрјИрјб, рЈЌрЈЊрЈЇрЈЎрЈ░рЈЇрјЕ, рЈ┤рЈФ рјЙрЈЏрЈЂрј▓ рјарјхрЈЇрЈЎрЈ░рЈЌ
­ЪњЄРђЇРЎѓ	рјарјхрЈЇрЈЎрЈЌ, рјарЈЇрјдрЈ», рјарЈЇрјдрЈ» рјарЈЦрЈЇрЈЎрЈ░рЈЇрјгрјб
­ЪњЄРђЇРЎђ	рјарјерЈ», рјарјерЈ» рјарЈЦрЈЇрЈЎрЈ░рЈЇрјгрјб, рјарјхрЈЇрЈЎрЈ░рЈЌ
­ЪџХ	рјарЈерЈЈрЈ░, рјГрЈерЈЈрЈ», рЈЊрј│рЈЇрје, рЈ┤рЈФ рјарЈерЈЈрЈ░
­ЪџХРђЇРЎѓ	рјарЈЇрјдрЈ», рјарЈЇрјдрЈ» рјарЈерЈЈрЈ░, рјГрЈерЈЈрЈ», рЈЊрј│рЈЇрје
­ЪџХРђЇРЎђ	рјарјерЈ», рјарјерЈ» рјарЈерЈЈрЈ░, рјГрЈерЈЈрЈ», рЈЊрј│рЈЇрје
­ЪЈЃ	рјарЈЏрЈЪрЈњрјб, рјфрј»рЈЊ, рЈ┤рЈФ рјарЈЏрЈЪрЈњрјб
­ЪЈЃРђЇРЎѓ	рјарЈЇрјдрЈ», рјарЈЇрјдрЈ» рјарЈЏрЈЪрЈњрјб, рјарЈЎрјЕрЈ», рјарЈЏрЈЪрЈњрјб, рјфрј»рЈЊ
­ЪЈЃРђЇРЎђ	рјарјерЈ», рјарјерЈ» рјарЈЏрЈЪрЈњрјб, рјарЈЎрјЕрЈ», рјарЈЏрЈЪрЈњрјб, рјфрј»рЈЊ
­ЪњЃ	рјарјерЈ», рјарјерЈ» рјарјхрЈЇрјЕрЈЇрјЕ, рјарјхрЈЇрјЕрЈЇрјЕ
­ЪЋ║	рјарјхрЈЇрјЕрЈЇрЈЌ, рјарЈЇрјдрЈ», рјарЈЇрјдрЈ» рјарјхрЈЇрјЕрЈЇрјг
­ЪЉ»	рјарјхрЈЇрјЕрЈЇрјЕ, рјБрЈЇрЈЊ рјцрЈЇрЈєрјИрјАрј▓рјб, рЈЦрЈЇрЈџ рЈЌрјдрј┤, рЈ┤рЈФ рЈЦрЈЇрЈџ рЈЌрјдрј┤ рјцрЈѓрЈЇрЈєрјИрјАрј▓рјб
­ЪЉ»РђЇРЎѓ	рјарјхрЈЇрјЕрЈЇрјЕ, рјарЈЇрјдрЈ», рјарЈЇрјдрЈ» рЈЦрЈЇрЈџ рЈЌрјдрј┤ рјБрЈЇрЈЊ рјцрЈЇрЈєрјИрјАрј▓рјб, рјБрЈЇрЈЊ рјцрЈЇрЈєрјИрјАрј▓рјб, рЈЦрЈЇрЈџ рЈЌрјдрј┤
­ЪЉ»РђЇРЎђ	рјарјерЈ», рјарјерЈ» рЈЦрЈЇрЈџ рЈЌрјдрј┤ рјБрЈЇрЈЊ рјцрЈЇрЈєрјИрјАрј▓рјб, рјарјхрЈЇрјЕрЈЇрјЕ, рјБрЈЇрЈЊ рјцрЈЇрЈєрјИрјАрј▓рјб, рЈЦрЈЇрЈџ рЈЌрјдрј┤
­ЪДќ	рјарЈћрјХрј┤рјг рјДрЈЁрЈЉрјИ, рјЕрјХ рјарЈ»рја рјарЈћрјХрј┤рјг рјДрЈЁрЈЉрјИ, рЈїрјЙ
­ЪДќРђЇРЎђ	рјарјерЈ» рјарЈ»рја рјарЈћрјХрј┤рјг рјДрЈЁрЈЉрјИ, рјарЈћрјХрј┤рјг рјДрЈЁрЈЉрјИ, рЈїрјЙ
­ЪДќРђЇРЎѓ	рјарЈЇрјдрЈ» рјарЈ»рја рјарЈћрјХрј┤рјг рјДрЈЁрЈЉрјИ, рјарЈћрјХрј┤рјг рјДрЈЁрЈЉрјИ, рЈїрјЙ
­ЪДЌ	рјФрј┤рјд, рЈ┤рЈФ рјдрјхрЈЎрјГ
­ЪДЌРђЇРЎђ	рјарјерЈ» рјдрјхрЈЎрјГ, рјФрј┤рјд
­ЪДЌРђЇРЎѓ	рјарЈЇрјдрЈ» рјдрјхрЈЎрјГ, рјФрј┤рјд
­ЪДў	рјцрЈ»рЈфрЈљрјИрЈбрјб рјарЈЊрЈЁрЈќрЈбрЈЇрјгрјб, рЈ▓рјд, рЈ┤рЈФ рЈџрЈЊрЈЮрЈЌрЈЇрЈЌ
­ЪДўРђЇРЎђ	рјарјерЈ» рЈџрЈЊрЈЮрЈЌрЈЇрЈЌ, рјцрЈ»рЈфрЈљрјИрЈбрјб рјарЈЊрЈЁрЈќрЈбрЈЇрјгрјб, рЈ▓рјд
­ЪДўРђЇРЎѓ	рјарЈЇрјдрЈ» рЈџрЈЊрЈЮрЈЌрЈЇрЈЌ, рјцрЈ»рЈфрЈљрјИрЈбрјб рјарЈЊрЈЁрЈќрЈбрЈЇрјгрјб, рЈ▓рјд
­ЪЏђ	рјарЈЊрЈгрЈЇрЈЌ, рјцрјЙрЈЎрЈгрЈЇрЈЌ, рЈ┤рЈФ рјарЈЊрЈгрЈЇрјгрјб
­ЪЏї	рјдрЈбрЈЁрЈЌ, рЈДрЈѓрЈњрЈЇрЈЌ, рЈ┤рЈФ рјдрЈѓрЈЪ рјдрЈЁрјг
­ЪЉц	рјцрЈЎрЈбрЈњрјб, рјцрЈ▓рЈерјб, рјцрЈ▓рЈерјб рјЦрј┐ рјцрЈЎрЈбрЈњрјб
­ЪЉЦ	рјарЈ▓рјфрјб рјЦрј┐ рјцрЈЎрЈбрЈњрјб, рјцрЈЎрЈбрЈњрјб, рјцрЈ▓рЈерјб
­Ъц║	рјарЈЈрј│рЈЏрЈЇрјЕ, рјарЈ░рј│рЈЇрЈЌ рјдрЈЁрј»рЈЊ, рЈЌрЈЈрј│рЈЏрЈЇрјЕ, рЈ┤рЈФ рјГрЈ░рјхрЈЇрЈЌ рјгрЈЌ рјдрЈЂрЈдрЈЇрЈЌрј▓
­ЪЈЄ	рЈљрЈѕрјх, рЈљрЈѕрјх рјарЈЎрјЕрЈ»рЈЇрјЕ, рЈљрЈѕрјх рЈЊрјЙрЈЎрјЕрЈ»рЈЇрјгрјб, рЈљрЈѕрјх рЈЌрјЕрјИрЈЌрЈЇрјЕ, рЈЊрјЙрЈЎрјЕрЈ»рЈЇрјгрјб
­ЪЈїРђЇРЎѓ	рјарЈЇрјдрЈ», рјарЈЇрјдрЈ» рјфрЈЇрЈЏрЈѓрј▓рјб рЈЇрЈєрЈърЈЇрЈЌ, рјфрЈЇрЈЏрЈѓрј▓рјб рЈЇрЈєрЈърЈЇрЈЌ
­ЪЈїРђЇРЎђ	рјарјерЈ», рјарјерЈ» рјфрЈЇрЈЏрЈѓрј▓рјб рЈЇрЈєрЈърЈЇрЈЌ, рјфрЈЇрЈЏрЈѓрЈЇрЈЌ рЈЇрЈєрЈърЈЇрЈЌ
­ЪЈёРђЇРЎѓ	рјарј╣ рЈЊрЈЇрЈЌрј│рЈЂрјг рјАрЈЂрЈЎрј», рјарЈЇрјдрЈ», рјарЈЇрјдрЈ» рјарј╣ рЈЊрЈЇрЈЌрј│рЈЂрјг рјАрЈЂрЈЎрј»
­ЪЈёРђЇРЎђ	рјарјерЈ», рјарјерЈ» рјарј╣ рЈЊрЈЇрЈЌрј│рЈЂрјг рјАрЈЂрЈЎрј», рјарј╣ рЈЊрЈЇрЈЌрј│рЈЂрјг рјАрЈЎрј»
­ЪџБ	рјдрјдрЈфрЈЇрјд рЈЦрЈ│, рЈЦрЈ│, рЈ┤рЈФ рјдрјдрЈфрЈЇрјд рЈЦрЈ│
­ЪџБРђЇРЎѓ	рјарЈЇрјдрЈ», рјарЈЇрјдрЈ» рЈЦрЈ│ рјдрјдрЈфрЈЇрјд, рЈЦрЈ│, рЈЦрЈ│ рјдрјдрЈфрЈЇрјд
­ЪџБРђЇРЎђ	рјарјерЈ», рјарјерЈ» рЈЦрЈ│ рјдрјдрЈфрЈЇрјд, рјдрјдрЈфрЈЇрјд рЈЦрЈ│, рЈЦрЈ│
­ЪЈіРђЇРЎѓ	рјарЈЇрјдрЈ», рјарЈЇрјдрЈ» рјарЈЊрЈг, рјарЈЊрЈг
­ЪЈіРђЇРЎђ	рјарјерЈ», рјарјерЈ» рјарЈЊрЈг, рјарЈЊрЈг
РЏ╣РђЇРЎѓ	рјарЈЇрјдрЈ», рјарЈЇрјдрЈ» рЈЇрЈєрЈърЈЇрЈЌ рјарЈЊрЈЊрЈЋрјг, рЈЇрЈєрЈърЈЇрЈЌ
РЏ╣РђЇРЎђ	рјарјерЈ», рјарјерЈ» рЈЇрЈєрЈърЈЇрЈЌ рјарЈЊрЈЊрЈЋрјг, рЈЇрЈєрј┤рЈЇрЈЌ
­ЪЈІРђЇРЎѓ	рјарЈЇрјдрЈ», рјарЈЇрјдрЈ» рЈЊрјхрЈїрј│рЈЌрЈЇрјг рЈДрЈЊрјерЈЊ, рЈДрЈЊрјерЈЊ рјарјхрЈїрј│рЈЌрЈЇрјг
­ЪЈІРђЇРЎђ	рјарјерЈ», рјарјерЈ» рЈЊрјхрЈїрј│рЈЌрЈЇрјгрјб рЈДрЈЊрјерЈЊ, рЈДрЈЊрјерЈЊ рЈЌрЈїрј│рЈЌрЈЇрјЕ
­Ъџ┤	рЈћрјх рЈЌрјдрЈЕрЈў, рЈћрјх рЈЌрјдрЈЕрЈў рјцрјЕрјИрЈЌ, рЈ┤рЈФ рЈЊрЈЮрЈ▒рЈЇрјгрјб
­Ъџ┤РђЇРЎѓ	рјарЈЇрјдрЈ», рјарЈЇрјдрЈ» рЈћрјх рЈЌрјдрЈЕрЈў рјцрјЕрјИрЈЌ, рј│рјх рЈЌрјдрЈЕрЈў рјцрјЕрјИрЈЌ, рЈћрјх рЈЌрјдрЈЕрЈў, рЈћрјх рЈЌрјдрЈЕрЈў рјцрјЕрјИрЈЌ
­Ъџ┤РђЇРЎђ	рјарјерЈ», рјарјерЈ» рЈћрјх рЈЌрјдрЈЕрЈў рјцрјЕрјИрЈЌ, рЈћрјх рЈЌрјдрЈЕрЈў, рЈћрјх рЈЌрјдрЈЕрЈў рјцрјЕрјИрЈЌ
­Ъџх	рјцрЈЁрЈЊрЈб, рЈћрјх рЈЌрјдрЈЕрЈў, рЈћрјх рЈЌрјдрЈЕрЈў рјцрјЕрјИрЈЌ, рЈ┤рЈФ рјцрЈЁрЈЊрЈб рЈћрјх рЈЌрјдрЈЕрЈў рјцрјЕрјИрЈЌ
­ЪџхРђЇРЎѓ	рјарЈЇрјдрЈ», рјарЈЇрјдрЈ» рјцрЈЁрЈЊрЈб рЈћрјх рЈЌрјдрЈЕрЈў рјцрјЕрјИрЈЌ, рјцрЈЁрЈЊрЈб, рЈћрјх рЈЌрјдрЈЕрЈў, рЈћрјх рЈЌрјдрЈЕрЈў рјцрјЕрјИрЈЌ
­ЪџхРђЇРЎђ	рјарјерЈ», рјарјерЈ» рјцрЈЁрЈЊрј┤ рЈћрјх рЈЌрјдрЈЕрЈў рјцрјЕрјИрЈЌ, рјарЈЇрјдрЈ», рЈћрјх рЈЌрјдрЈЕрЈў, рЈћрјх рЈЌрјдрЈЕрЈў рјцрјЕрјИрЈЌ
­ЪцИ	рЈЊрјЙрјхрЈћрЈЋрЈЈрЈЎрј▓рјб, рЈЊрЈЂрЈЇрЈєрЈЋрјг, рЈ┤рЈФ рЈЊрЈЂрЈЇрЈєрЈЋрјг
­ЪцИРђЇРЎѓ	рјарЈЇрјдрЈ», рјарЈЇрјдрЈ» рЈЊрЈЂрЈЇрЈєрЈЋрјг, рЈЊрјЙрјхрЈћрЈЋрЈЈрЈЎрј▓рјб, рЈЊрЈЂрЈЇрЈєрЈЋрјг
­ЪцИРђЇРЎђ	рјарјерЈ», рјарјерЈ» рЈЊрЈЂрЈЇрЈєрЈЋрјг, рЈЊрјЙрјхрЈћрЈЋрЈЈрЈЎрј▓рјб, рЈЊрЈЂрЈЇрЈєрЈЋрјг
­Ъц╝	рјарЈЂрЈЇрЈЌ, рјарЈѓрЈ┤рЈФ рЈЊрЈЂрј»рј▓, рЈЌрЈЂрј»рј»
­Ъц╝РђЇРЎѓ	рјарЈЂрЈЇрЈЌ, рјарЈѓрЈЇрјдрЈ», рјарЈѓрЈЇрјдрЈ» рЈЊрЈЂрј»рј▓
­Ъц╝РђЇРЎђ	рјарјерЈ», рјарјерЈ» рЈЊрЈЂрј»рј▓, рјарЈЂрЈЇрЈЌ
­Ъцй	рјарј│рЈЇрјдрјхрЈЎрЈЌ, рјарј╣, рЈ┤рЈФ рЈЊрЈЂрјХрј▓рЈЇрјг рјарј╣ рјарј│рЈЇрјдрјхрЈЎрЈЌ
­ЪцйРђЇРЎѓ	рјарј╣ рјарј│рЈЇрјдрјхрЈЎрЈЌ, рјарЈЇрјдрЈ», рјарЈЇрјдрЈ» рјарј╣ рјарј│рЈЇрјдрјхрЈЎрЈЌ
­ЪцйРђЇРЎђ	рјарјерЈ», рјарјерЈ» рјарј╣ рјарј│рЈЇрјдрјхрЈЎрЈЌ, рЈљрЈѕрјх рЈДрјЙрјЕрјИрЈЌ рјарј│рЈЇрјдрјхрЈЎрЈЌ
­ЪцЙ	рјарј│рЈЇрјдрјхрЈЎрЈЌ, рјдрЈѓрЈ┤рЈЎрЈЌ, рЈ┤рЈФ рЈЊрЈЂрјХрј▓рЈЇрјг рЈЇрЈєрЈърЈЇрЈЌ рјдрјИрЈЏрЈѓрЈЇрЈЎрЈЌ
­ЪцЙРђЇРЎѓ	рјарЈЇрјдрЈ», рјарЈЇрјдрЈ» рЈЊрЈЂрјХрј▓рЈЇрјгрјб рјдрЈѓрЈ┤рЈЎрЈЌ рјарј│рЈЇрјдрјхрЈЎрЈЌ, рјдрЈѓрЈ┤рЈЎрЈЌ рјарј│рЈЇрјдрјхрЈЎрЈЌ
­ЪцЙРђЇРЎђ	рјарјерЈ», рјарјерЈ» рЈЊрЈЂрјХрј▓рЈЇрјгрјб рјдрЈѓрЈ┤рЈЎрЈЌ рјарј│рЈЇрјдрјхрЈЎрЈЌ, рјдрЈѓрЈ┤рЈЎрЈЌ
­Ъц╣	рјгрјдрЈћрј▓рЈГ, рј»рјИрЈЇрјЕ рЈДрЈЊрј┤рЈЁрЈЊ рјбрЈ»рЈЏрЈЂрЈЌ, рЈЊрЈЇрЈєрЈъ, рЈЌрјФрЈЕрЈЊрјерЈЊ, рЈ┤рЈФ рЈЊрЈЇрЈєрЈърЈЈрЈЎрј▓рјб
­Ъц╣РђЇРЎѓ	рјарЈЇрјдрЈ», рјарЈЇрјдрЈ» рЈЊрЈЇрЈєрЈърЈЈрЈЎрј▓рјб, рј»рјИрЈЇрјЕ рЈДрЈЊрј┤рЈЁрЈЊ рјбрЈ»рЈЏрЈЂрЈЌ, рЈЊрЈЇрЈєрЈърЈЈрЈЎрј▓рјб
­Ъц╣РђЇРЎђ	рјарјерЈ», рјарјерЈ» рЈЊрЈЇрЈєрЈърЈЈрЈЎрј▓рјб, рј»рјИрЈЇрјЕ рЈДрЈЊрј┤рЈЁрЈЊ рјбрЈ»рЈЏрЈЂрЈЌ, рЈЊрЈЇрЈєрЈърЈЈрЈЎрј▓рјб
­ЪЉФ	рјарјерЈ», рјарЈЇрјдрЈ», рјарЈЇрјдрЈ» рјарј┤ рјарјерЈ» рЈЌрјЙрЈЎрј»рЈЂрјЕ, рјцрЈѓрЈ┤рјГ, рјцрЈгрЈ▒, рЈЌрјЙрЈцрј»
­ЪЉг	рјарЈѓрЈћрјх, рјарЈѓрЈћрјх рјарЈѓрЈЇрјдрЈ» рЈџрјЙрЈЎрЈ»рЈѓрЈ», рјарЈЇрјдрЈ», рјцрЈѓрЈ┤рјГ, рјцрЈгрЈ▒, рЈЃрЈѕрЈЈ рЈЊрЈЪрјХрЈЇрЈЌрј▓рјб, рЈЌрЈѓрЈЮрЈФ, рЈЌрЈѓрЈЮрЈФ рЈДрјЙрЈдрЈЪ
­ЪЉГ	рјарјерЈ», рјарЈѓрЈћрјх, рјарЈѓрЈћрјх рјарЈѓрјерЈ» рЈџрјЙрЈЎрЈ»рЈѓрја, рјцрЈѓрЈ┤рјб, рјцрЈгрЈ▒
­ЪњЈ	рјарЈћрЈфрЈЎрјбрЈЇрЈЌ, рЈЌрјЙрЈцрј»
­ЪњЉ	рјарЈЊрјерЈ│рЈЌ, рЈЌрјЙрЈцрј», рЈЌрјЙрЈцрј» рЈДрЈѓрј┐рЈФ
­Ъц│	рјБрЈ«рЈї рЈЌрЈЊрЈЪрјХрЈЇрЈћрЈЁрјб, рЈЌрЈЪрјХрЈЌрЈЇрјЕрЈЇрјЕ, рЈЌрЈЪрЈЃрј«рЈЌрјб
­Ъњф	рјБрЈЄрЈЊрЈб, рјцрЈгрЈЪрЈЌ, рЈЌрјДрЈЃрјерЈѓ рјдрјИрј│рЈЌрЈб, рЈЌрЈЊрЈЂрЈЇрЈЌ, рЈФрјдрј│рјд рјцрЈЪрјИрЈЏ рјдрјИрј│рЈЌрЈЪ рјДрЈЃрјерјЙ
­Ъдх	рјарЈЊрЈ┤рЈќрЈЇрЈЌ, рјарЈ░рјИрјб, рјдрЈЁрЈЇрјерЈѓ
­ЪдХ	рјарЈЊрЈ┤рЈќрЈЇрЈЌ, рјцрј│рЈЈрЈЋрЈѓ, рЈЇрЈЊрЈ» рЈгрј│рЈЈрЈЁ
­ЪќЋ	рјарЈ░рЈЪ рјдрЈ░рЈїрЈЏ, рјцрЈгрЈ▒, рјдрЈ░рЈїрЈЏ
­Ъцъ	рјцрЈбрЈ▒рЈЋрЈЊ, рјцрЈгрЈ▒, рјдрЈ░рЈїрЈЏ, рЈДрЈЊрј┐рЈФрЈЊ, рЈДрЈЊрј┐рЈФрЈЊ рЈЋрјдрЈ░рЈїрЈЏ
­Ъќќ	рјцрЈгрЈ▒, рјдрЈ░рЈїрЈЏ, рЈЌрјфрЈЇрЈЊрЈ▒рЈЌрјдрјхрЈЪрјЕ, рЈЌрјфрЈЇрЈЊрЈ▒рЈЌрјдрјхрЈЪрјЕ рјарЈЊрЈ▓рјхрЈЇрЈЌ, рЈДрјхрЈЇрЈєрјЙрјхрЈџрјдрЈќрЈїрјЙрјИ
­Ъцў	рјцрЈгрЈ▒, рјцрЈ▓рјЙ рЈЊрЈЪрјХрЈЇрЈЏ, рјдрЈ░рЈїрЈЏ, рЈЁрЈ»-рЈёрЈЇрЈЌ, рЈДрЈ▓рјЙ
­ЪцЎ	рјцрЈгрЈ▒, рЈЌрЈЇрЈЊрЈЂрјИрјЕ, рЈЌрЈЇрЈЊрЈЂрјИрјЕ рјцрЈгрЈ▒
РюІ	рјБрЈгрЈ░рјЙ рјарЈїрјхрЈЏрЈЁрјб, рјцрЈгрЈ▒
­ЪЉї	рјБрЈЇрЈЊ, рјБрЈЈрЈі рјфрЈ»рЈЏ, рјцрЈгрЈ▒
Рюі	рјарјхрЈЄрЈЁ рјарЈњрјхрЈЏрЈЁрјб, рјцрЈѓрЈ┤рј▓рјб, рјцрЈгрЈ▒, рЈЇрЈѕрјЙ, рЈЇрЈѕрјЙ рјгрЈЌ рјарјгрЈѓрјИрјб
­ЪЉі	рјцрЈѓрЈ┤рј▓рјб, рјцрЈгрЈ▒, рЈѓрЈЊрЈ│рЈЇрЈЌрЈЏ рјарјхрЈЄрЈЁ, рЈЇрЈѕрјЙ, рЈЇрЈѕрјЙ рјгрЈЌ рјарјгрЈѓрјИрјб
­ЪцЏ	рјарјдрЈЇрјдрЈѓ-рЈЇрЈѕрјЙ рјцрјдрЈЎрЈЇрЈЊ, рјарјдрЈЇрјдрЈѓрЈЌрЈю, рЈЇрЈѕрЈЁ
­Ъцю	рјарјдрЈўрЈЈ-рЈЕрјдрЈўрј▓ рјарјхрЈЄрЈЁ, рјарјдрЈўрЈЈрЈЌрЈю, рЈЇрЈѕрЈЁ
­Ъцџ	рјарЈњрјхрЈЏрЈЁ рјБрЈѓрЈЌрЈб рјБрЈгрЈ░рјЙ, рјБрЈгрЈ░рЈѓрјБрЈѓрЈЌрЈю, рјцрјхрЈїрј│рЈЊрЈЁрјб
­ЪЉІ	рјарЈљрЈ░рјГ, рјарЈљрЈ░рЈЇрјгрјб, рјарЈ▓рјхрјГ, рјцрЈгрЈ▒
­ЪцЪ	ILY, рјцрЈгрЈ░рЈѓ, рјгрјерЈ│рјб рјцрЈгрЈ»рЈѓрЈЇрјЕ
­ЪЉЈ	рЈЊрЈЇрЈЏ, рЈЊрЈЈрЈЏрЈѓрј▓рјб, рЈЏрЈѓрјГ
­ЪЉљ	рјарЈЇрЈџрјбрЈЊ, рјцрЈгрЈ▒, рЈЌрЈџрјбрЈЊ рЈЎрЈгрЈ░рјЙ
­ЪЎї	рјарјхрј«рјхрЈЇрЈЌ, рјБрЈЇрЈЊ рј┐рЈЏрјд, рјцрјхрЈїрј│рЈЊ, рјцрЈгрЈ▒, рЈЊрЈљрЈ░рЈЇрјг, рЈЌрјфрЈ░рјЙ рЈЌрЈїрјхрЈЏрЈЁрјб, рЈџрјхрЈїрј│рЈЏрјб
­Ъц▓	рјарЈЊрЈЎрјхрЈЇрЈЌ, рЈџрјЙрЈЎрЈ»рЈѓрја рјдрјИрј│рЈЌ рјарЈњрЈЁрЈЇрЈЌ
­ЪЎЈ	рјарјхрј«рјхрЈцрЈЌ, рјарЈЊрЈЎрјхрЈЇрЈЌ, рјарЈЏрЈЏрЈЌ, рјарЈ┤рЈѕрЈЏрјб, рјАрјхрЈірЈД, рјцрјхрЈЇрЈѕрЈЌ, рЈЊрЈљрЈ░рЈЇрјгрјб, рЈџрЈєрЈ░рЈЁрЈЇрЈЏ, рЈДрЈгрЈ▒
­ЪцЮ	рјарЈЊрЈ▓рјхрј▓рјб, рјарЈЊрЈ▓рјхрЈЇрЈЌ, рјарЈќрјИрЈЌ, рјцрЈгрЈ▒, рЈЊрјЙрЈарЈЇрјгрјб, рЈЌрЈЊрЈЂрЈцрјИрјб
­ЪњЁ	рјарјдрЈјрЈЇрЈЎрЈЌ, рјарЈЊрЈЁрјхрЈ░рЈЎрЈЌ, рјцрЈЉрјдрЈб, рјцрЈЉрјдрЈб рјдрЈЁрјхрЈ░рЈЌ, рјдрЈЁрјхрЈ░рЈЌ, рЈЌрЈЇрЈЎрЈ░рЈЌ
­ЪЉЃ	рјЦрЈ░рјИрјб, рјДрЈ┤рЈљрјх
­ЪЉБ	рЈЌрј┐рЈг, рЈџрј│рЈЈрЈЁ рЈџрЈЎрЈфрјИрјб, рЈџрј│рЈЈрЈЁрјб рЈџрЈЎрЈфрјИрјб, рЈџрЈЎрЈфрјИрјб
­ЪЉђ	рјцрјДрЈЏ, рЈЌрјдрЈћ
­ЪЉЂРђЇ­ЪЌе	рјарјдрЈћрј», рјарјдрЈў, рјарјдрЈў рјЦрј┐ рјЦрјДрЈЂрјгрјб рјцрЈєрјирЈњ, рјЦрјДрЈЂрјгрјб рјцрЈєрјирЈњ
­ЪДа	рјарјДрјЙрЈЌ, рјцрЈЁрЈЦрЈЊ
­Ъд┤	рјцрјфрј│рјГ, рјфрј│
­Ъди	рјдрЈЁрЈЎрјг, рЈЌрЈЊрЈЁрЈЋрЈЇрјЕ
­ЪЉЁ	рјЦрЈ░рјИрјб, рјдрЈѓрјф
­ЪЉё	рјарј░рјх, рЈџрјГрЈЂрјдрјИрјб
­Ъд░	рјЕрјдрје рјарЈЇрјфрјх, рјЕрјдрје рјцрЈЇрЈўрјд, рјЕрјдрје рјцрЈЇрЈўрЈ░рЈЁрјб
­Ъд▒	рјцрјхрЈЦрЈЇрЈєрЈЂрЈЊ, рјцрјхрЈЦрЈЇрЈєрЈЂрЈЊ рјцрЈЇрЈўрјд, рЈЎрЈ│ рјцрјхрЈЦрЈЇрјфрЈЂрЈЊ, рЈДрЈЃрЈЊрЈірЈњрјхрЈЇрЈЌ
­Ъд│	рјарјдрЈ┤рјх, рјарЈЇрЈўрЈ░рЈЁ, рјцрЈЂрјд, рјцрЈЂрјд рјцрЈЇрЈўрјд, рјцрЈЇрјфрјИ рЈїрјфрЈѓрје
­Ъд▓	рјарЈЊрЈ░рЈЇрјЕ рЈ│рјЙрјхрЈЇрЈЊрЈЂрј» рјерЈЦрЈЁрЈгрЈЎрЈЌ, рјцрјерЈгрЈЌ, рјцрјхрЈЇрЈЎрЈ░рЈЊ, рЈёрЈЇрЈўрјгрјЙ, рЈЮ рЈ│рЈЇрЈўрјд
­ЪњІ	рјарЈћрЈфрЈЎрЈЁрјб, рјарЈћрЈфрЈЎрЈЁрјб рјцрЈЎрЈфрјИрјб, рјцрјГрЈЂрјдрјИрјб
­Ъњў	рјцрј┐рЈФ рјдрЈЮрЈЌ рјгрЈЌ, рјдрЈЮрЈЌ, рјФрЈѕрЈЏ
­ЪњЮ	рјарЈЄрЈАрЈЇрЈЌ, рјцрјЙрЈЊрјИрЈЅрЈЎрЈЌ, рјцрј┐рЈФ рјарЈЄрЈАрЈЇрЈЌ
­Ъњќ	рјарЈћрјирјЕрја, рјарЈћрјирјЕрЈЇрјЕ рјарЈЊрЈЁрЈЎ, рјцрј│рјЙрјЕрЈЇрјг
­ЪњЌ	рјарјхрЈїрј│рЈЌрј▓рјб рјцрј┐рЈФ, рјарЈЊрј┐рЈФрЈЇрјг, рјарЈЏрЈЇрјгрјб, рјцрј│рјЙрјЕрЈЇрјг, рјцрЈЊрЈЁрЈќрЈЌрЈЇрјЕ
­ЪњЊ	рјарЈЊрј┐рЈФрЈЇрјд, рјарЈЊрЈЁрЈФрЈЇрјд, рјцрј┐рЈФ рјарЈЊрјЙрЈФрЈЇрјг, рјцрј┐рЈФ рјарЈЊрј┐рЈФрЈЇрјд
­Ъњъ	рЈЌрЈЋрЈ▓, рЈЌрЈЋрЈ▓ рЈџрЈЊрЈЁрЈЏ
­ЪњЋ	рјарЈЊрјерЈ│рЈЌ, рЈћрјх рЈЌрЈЊрЈЁрЈЎ
­Ъњї	рјарЈЊрјерЈ│рЈЌ, рјарЈЊрјИрЈЅрјфрЈфрј│рЈЁ, рјцрј┐рЈФ, рјфрЈфрјх
­Ъњћ	рјцрЈ▓рЈерјб, рјцрЈ▓рЈерјб рјцрј┐рЈФ, рј»рЈ▓рЈЇрЈЊ
­ЪДА	рјарЈЊрјХрЈѓрје, рјарЈЊрјХрЈѓрје рјцрј┐рЈФ
­ЪњЏ	рЈЊрјХрЈѓрје, рЈЊрјХрЈѓрје рјцрј┐рЈФ
­Ъњџ	рјбрЈцрЈ│рЈЇрЈЌ, рјбрЈцрЈ│рЈЇрЈЌ рјцрј┐рЈФ
­ЪњЎ	рЈїрјфрЈѓрје, рЈїрјфрЈѓрје рјцрј┐рЈФ
­Ъњю	рјарЈЊрј▓рјхрје, рјарЈЊрј▓рјхрје рјцрј┐рЈФ
­Ъќц	рјцрЈ▓, рјцрЈ▓рјбрЈ│рјб, рјгрј┐рје, рјгрј┐рје рјцрјЙрЈФ
­ЪњЪ	рјцрј┐рЈФ, рјцрј┐рЈФ рЈЌрЈЪрјХрЈЇрЈћрЈЁ
­Ъњц	рјцрЈгрЈЪрЈЌ, рјдрЈЪ, рЈЃрЈЃрЈЃ
­Ъњб	рјцрј┐рјИрј», рјцрј┐рјИрј» рЈЊрЈЪрјХрЈЇрЈЏрјб, рјцрЈгрЈЪрЈЌ
­ЪњЦ	рјцрЈгрЈЪрЈЌ, рЈЇрЈЊрЈ▒ рјцрЈЃрЈ┤рјЕ, рЈџрјЙрЈЊрЈЏрЈѓрјИ
­Ъњд	рјарјх, рјарјх рЈДрЈЕрЈгрЈе, рјцрЈгрЈЪрЈЌ, рЈЌрЈЇрЈџрЈЪрЈЦрЈЎрј▓рјб
­Ъње	рјарЈЊрјЙрЈФрЈЇрЈЌрЈЇрјгрјб, рјарЈЊрЈФрЈЇрЈЌрЈЇрјгрјб, рјарЈЌрЈЪ, рјцрЈгрЈЪрЈЌ
­ЪњФ	рјцрјИрЈЋрј»рЈЊ, рјцрЈгрЈЪрЈЌ, рЈЃрЈѕрЈЈ
­Ъњг	рјцрЈЃрј┤ рјарЈ▓рЈЎрЈЌ, рјцрЈєрјирЈњ, рјцрЈгрЈЪрЈЌ, рјдрЈгрЈѓрј»рЈЇрЈЌрјб, рјдрЈгрЈѓрј»рЈЇрЈЌрјб рјцрЈЃрј┤ рјарЈ▓рЈЎрЈЌ, рЈЌрЈЪрЈЃрј«рЈЌрјб
­ЪњГ	рјарЈЊрјЙрЈќрјИрЈЇрјЕ рјцрЈЃрј┤ рјарЈдрЈћрЈЇрЈЎрЈЌ, рјарЈЊрЈЁрЈќрЈбрјб, рјцрЈЃрј┤ рјарЈ▓рЈЎрЈЌ, рјцрЈєрјирЈњрјб, рјцрЈгрЈЪрЈЌ
­ЪЦй	рјарЈѓрјФрјдрјх, рјарЈЊрЈгрЈЇрјг, рЈЋрјДрЈЁрЈФрја, рЈерЈЎрјх рјарЈЊрјхрЈЇрјдрЈЇрЈЎрЈЌ
­ЪЦ╝	рјарјдрЈЏрЈѓрЈЊрЈЇрЈЌ, рјарјдрЈЏрЈЎрЈЌ рјДрЈЁрЈЉрјИ рјдрЈїрј┤рјЙ, рјарЈЈрјЙрЈЇрЈЈ рјарјдрЈћрј┐рјб, рјдрјЙрјдрЈў
­ЪЉћ	рјарјГрЈбрЈЌ, рЈЌрј┐рЈг
­ЪЉЋ	рјарј┐рЈг, рјГрЈФрјЙ-рјарј┐рЈгрЈЇрЈЌ, рЈЌрј┐рЈг
­ЪЉќ	рјарј┐рЈг, рЈЌрЈЉрјХ
­ЪДБ	рјарЈ»рЈа, рјарЈ┤рЈцрЈѓ
­ЪДц	рјцрЈгрЈ▒, рЈЌрјхрЈ░рЈЉрјХ
­ЪДЦ	рјдрЈїрј┤рјЙ, рЈ┤рЈФ рјдрЈїрј┤рјЙ
­ЪДд	рјарЈѓрјерЈ┤ рЈДрјЙрјхрЈ▓, рЈЌрјхрЈ▓
­ЪЉЌ	рјарЈїрЈЃ, рЈЌрј┐рЈг
­ЪЉў	рјЕрј╝рЈЃ, рЈЌрј┐рЈг
­ЪЉЎ	рјарЈЊрЈг, рјЦрЈЊрЈгрЈЇрјгрјб рЈЌрј┐рЈгрЈЇрЈЌ, рЈЌрј┐рЈгрЈЇрЈЌ
­ЪЉџ	рјарјерЈ», рјарјерЈ» рЈДрјЙрЈгрЈЇрЈЌ, рЈЌрј┐рЈгрЈЇрЈЌ
­ЪЉЏ	рјарЈћрЈЂрЈїрЈЪрЈЌ, рјарЈЋрј│, рЈЌрј┐рЈгрЈЇрЈЌ
­ЪЉю	рјарЈћрЈЂрЈїрЈЪрЈЌ, рЈЋрјдрјхрЈЪрЈЌ, рЈЋрјдрјхрЈЪрЈЌ рјДрЈѓрЈЊрЈЇрЈЌ, рЈЌрј┐рЈгрЈЇрЈЌ
­ЪЉЮ	рјцрЈЇрЈЌ рЈЋрјдрјхрЈЪрЈЌ, рјдрЈѓрЈ┤рЈЎрЈЌ рЈЋрјдрјХрЈЌ, рЈЋрјдрјхрЈЪрЈЌ, рЈЌрј┐рЈгрЈЇрЈЌ
­Ъјњ	рЈЋрјдрјхрЈЪрЈЌ, рЈЌрЈЋрјХрЈєрЈЇрЈЌ рјдрјхрЈњрЈЇрЈЊ, рЈДрјЙрЈЋрјХрЈєрЈЇрЈЌ
­ЪЉъ	рјарј│рЈЉрјХ, рјарЈЇрјдрЈ», рјарЈЇрјдрЈ» рјцрј│рј▒рјХрјб, рЈЌрј┐рЈгрЈЇрЈЌ
­ЪЉЪ	рјарј│рЈЉрјХ, рјарЈЪрЈЊрЈЇрЈЌ рјарј│рЈЉрјХрј», рЈЂрЈдрЈЌ, рЈЌрј┐рЈг
­ЪЦЙ	рјарјхрЈЈрЈЊрЈЇрЈЌ рјдрјхрЈћрЈЁрЈЎрЈЌ, рјцрЈерЈЈрЈ░рЈЇрјг, рјцрЈерЈЈрЈ░рЈЇрјг рјгрЈЕрјхрЈ▓рЈЇрЈЌ, рјдрјхрЈдрЈЏрјб, рјгрЈЕрјхрЈ▓рЈЇрЈЌ
­ЪЦ┐	рјарЈЇрјЕрЈЇрЈЊ рјарЈ»рЈЏрЈї, рјарЈ»рЈЏрЈї рЈЌрј│рЈЉрјХ, рЈЌрјДрЈЂрЈЇрЈЌ рЈѓрјерЈњрјЙ рЈЌрј│рЈЉрјХ, рЈЌрјДрЈЂрЈЇрЈЌ-рЈѓрјерЈњрјЙ
­ЪЉа	рјарјерЈ», рјарј│рЈЉрјХ, рјбрјЙ рЈДрЈЇрЈЊрЈЪ, рјбрјЙ-рјбрЈЌрјдрЈў рјарј│рЈЉрјХ, рЈЌрј┐рЈг
­ЪЉА	рјарјерЈ», рјарјерЈ» рЈДрј│рЈЉрјХ, рјарј│рЈЉрјХ, рЈЌрј┐рЈг
­ЪЉб	рјарјерЈ», рјарјерЈ» рјцрј│рЈЉрјХрјб, рјарј│рЈЉрјХ, рЈЌрјдрјхрЈ▓рЈЇрЈЌ, рЈЌрј┐рЈг
­ЪЉЉ	рјцрјгрЈФрЈ│рј», рјцрјгрЈФрЈ│рј» рјарјерЈ», рјцрјгрЈФрЈ│рј» рјарјхрЈЇрЈџрјХ, рЈЌрј┐рЈгрЈЇрЈЌ
­ЪЉњ	рјарјерЈ», рјарјерЈ» рјцрјхрЈџрјХ, рјарјхрЈЇрЈЄрЈћрЈг, рЈЌрј┐рЈгрЈЇрЈЌ
­ЪјЕ	рјарјхрЈЇрЈЄрЈћрЈг, рјбрЈѓрјдрЈўрјарјхрЈЇрЈЄрЈћрЈг, рјдрЈџ, рјдрЈџ рјарјхрЈЇрЈЄрЈџрЈг, рЈЌрј┐рЈгрЈЇрЈЌ
­ЪДб	рјцрјгрЈБрЈў рјарјхрЈЇрЈџрјХ, рјЦрЈЂрЈдрЈЇрјгрјб рјарјхрЈЇрЈџрјХ
­ЪЊ┐	рјарЈЊрЈЎрјхрЈЇрЈЌ, рјарЈЊрЈЎрјхрЈЇрЈЎрЈЌ рЈЌрЈЋрј│, рјарЈЋрј│ рЈЌрЈ»рЈЪрЈЌ, рјарЈ»рЈЪрЈЌ, рЈЌрј┐рЈг, рЈДрјЙрЈЂрЈЪрЈЌ
­Ъњё	рјарЈЊрЈЁрјдрЈЪрЈЎрЈЌ, рјарЈЊрЈЁрјхрЈ░рЈЌ, рјБрјГрЈЂрјдрјИ рјдрЈЁрјхрЈ░рЈЌ
­ЪњЇ	рјарјхрЈ░рЈЉрЈћрЈФ, рјцрЈЦрЈЇрЈЊрјирјЕрЈЇрјЕ рЈЁрЈ»
­Ъњј	рјдрјИрЈЅрЈЌ рЈЁрЈ», рЈЦрј╗, рЈДрјх
­Ъљх	рјарЈЊрј┤рЈЇрјЕрЈ▒рЈЇрјЕ, рјарЈЊрј┤рЈЇрјЕрЈ▒рЈЇрјЕ рјцрјДрЈЏ, рјцрјДрЈЏ
­Ъљњ	рјарЈЊрј┤рЈЇрјЕрЈ▒рЈЇрјЕ
­ЪдЇ	рјцрЈћрјЙ рјарЈЊрј┤рЈЇрјЕрЈ▒рЈЇрјЕ
­ЪљХ	рјцрјДрЈЏ, рјдрјЙрЈбрЈЌ, рјЕрјх, рјЕрјх рјцрјДрЈЏ
­ЪљЕ	рјЕрјх, рјЕрјх рЈДрјхрЈЦрЈЇрЈєрЈЂрЈЌ
­Ъљ║	рјцрјДрЈЏ, рЈЕрјГрЈ▒, рЈЕрЈ» рјцрјДрЈЏ
­Ъді	рјцрјДрЈЏ, рЈДрЈЪ, рЈДрЈЪ рјцрјДрЈЏ
­ЪдЮ	рјцрЈЇрЈєрЈѓрјфрЈЇрјд, рјцрЈЊрЈЋрјхрЈЇрЈЌ, рјгрјх
­Ъљ▒	рјцрјДрЈЏ, рјдрјЙрЈбрЈЌ, рЈфрЈї, рЈфрЈї рјцрјДрЈЏ
­ЪдЂ	рјцрјДрЈЏ рјхрЈ▓, рјхрЈ▓, рЈЃрЈѕрЈЈ рЈЊрЈЪрјХрЈЇрЈЌрј▓рјб, рЈбрЈЊрЈЦ, рЈбрЈЊрЈЦ рјцрјДрЈЏ
­Ъљ»	рјцрјДрЈЏ, рјгрј«, рјгрј« рјцрјДрЈЏ
­ЪљЁ	рјгрј«
­Ъљє	рЈфрЈї рЈДрЈЁрЈБ
­Ъљ┤	рјцрјДрЈЏ, рЈљрЈѕрјх, рЈљрЈѕрјх рјцрјДрЈЏ
­Ъљј	рјарЈЎрјЕ, рЈљрЈѕрјх, рЈ»рЈЇрјЕ
­Ъдё	рјцрјДрЈЏ, рЈљрЈѕрјх рјцрјирјЕ
­ЪдЊ	рЈДрјХрЈЌ, рЈДрјХрЈЪрЈЌ рЈљрЈѕрјх
­Ъдї	рјарјГрЈФ
­Ъљ«	рјцрјДрЈЏ, рЈЕрјд, рЈЕрјд рјцрјДрЈЏ
­Ъљѓ	рЈЃрЈѕрЈЈ рЈЊрЈЪрјХрЈЇрЈЌрј▓рјб, рЈћрЈЕрЈЈ, рЈДрјДрЈЁрЈЇрЈЋрјЙ, рЈЕрјд рЈДрјДрЈЁрЈЇрЈЋрјЙ
­ЪљЃ	рјарј╣, рЈ»рјЙрЈЈ, рЈ»рјЙрЈЈ рјарј╣
­Ъљё	рЈЕрјд
­Ъљи	рјцрјДрЈЏ, рЈЈрЈє, рЈЈрЈє рјцрјДрЈЏ
­Ъљќ	рЈЈрЈє, рЈЈрЈє рјарјЕрЈЈ
­ЪљЌ	рЈЈрЈє, рЈЈрЈє рЈДрјДрЈЁрЈЇрЈЋрјЙ
­Ъљй	рјцрјДрЈЏ, рјДрЈ┤рЈљрјх, рЈЈрЈє, рЈЈрЈє рјДрЈ┤рЈљрјх
­ЪљЈ	рјцрЈЃрЈЋрјХрјЙ рЈДрјДрЈЁрЈЇрЈЋрјЙ, рјцрЈЃрЈЋрјЙ, рјцрЈЃрЈЋрјЙ рЈДрјДрЈЁрЈЇрЈЋрјЙ, рЈЃрЈѕрЈЈ рЈЊрЈЪрјХрЈЇрЈЌрј▓рјб, рЈДрјгрЈЋрјЙ
­ЪљЉ	рјарјЕрЈЈ, рјцрЈЃрЈЋрјЙ, рјцрЈЃрЈЋрјЙ рјарЈЊ
­Ъљљ	рјцрјдрЈљрЈБрЈЂрЈЊ, рјцрјдрЈљрЈБрЈЂрЈЊ рЈџрЈЊрЈЪрјХрЈЇрЈЊ, рЈЃрЈѕрЈЈ рЈЊрЈЪрјХрЈЇрЈЌрј▓рјб
­Ъљф	рјдрЈљрЈєрЈў, рјерј╗рјх
­ЪљФ	рјдрЈљрЈєрЈў, рјерј╗рјх, рЈћрјх-рјцрЈЕрЈљрј»рЈЪ рјерј╗рјх, рЈЌрјдрЈљрЈєрЈў
­ЪдЎ	рјАрјхрЈєрјд, рјцрЈЕрјЙ, рјерј╗рјх рЈ│рЈЇрЈЌ, рјФрјЙрјф, рЈѕрјФрјЙ
­Ъдњ	рјцрЈЊрЈЊрјИ, рЈЌрјдрјхрЈЇрЈџрјЕрЈЇрјЕ
­Ъљў	рјцрЈћрјЙ рјДрј╣рј╣
­ЪдЈ	рј│рЈЃрЈЈрј│
­ЪдЏ	рЈЌрЈєрј┤рЈѓ рЈЈрЈєрЈ│рЈЇрЈЌ
­ЪљГ	рјцрјДрЈЏ, рЈЦрЈЇрЈЋрЈЦ, рЈЦрЈЇрЈЋрЈЦ рјцрјДрЈЏ
­ЪљЂ	рЈЦрЈЇрЈЋрЈЦ
­Ъљђ	рјцрЈћрјЙ рЈЦрЈЇрЈЋрЈЦ
­Ъљ╣	рјцрјДрЈЏ, рјдрјЙрЈЮрјб, рЈјрј│рЈѕрЈЈ рЈЌрјДрЈЃрЈЌрјб
­Ъљ░	рјцрјДрЈЏ, рјдрјЙрЈЮрјб, рЈЦрЈЇрЈџ, рЈЦрЈЇрЈџ рјцрјДрЈЏ
­ЪљЄ	рјдрјЙрЈЮрјб, рЈЦрЈЇрЈџ
­Ъдћ	рј»рЈБрЈ▓рјГ, рЈџрЈЕрЈ▒рЈбрјАрј»рЈЈрЈє
­ЪдЄ	рјЕрјд рјарЈЊрЈЂрјЕрјАрј», рЈюрј║рјГ
­Ъљ╗	рјцрјДрЈЏ, рЈ▓рјЙ, рЈ▓рјЙ рјцрјДрЈЏ
­Ъље	рјфрјарј│, рЈ▓рјЙ
­Ъљ╝	рјцрјДрЈЏ, рЈ▓рјЙ, рЈ▓рјЙ рјцрјДрЈЊ
­Ъдў	рјАрј│рЈЌрЈю, рјДрјЙрјдрЈГ, рј╣рЈЉрЈѕрЈ»рјх, рЈћрјхрЈћрЈџрјд, рЈдрЈФ
­ЪдА	рјарЈЊрЈЋрЈ»рЈЎрЈЌрЈЇрјЕ, рјарЈЊрЈдрЈјрЈЌрЈЇрјЕ, рЈЕрЈџрјхрЈЈ рјарЈЊрЈЋрЈ»рЈЎрЈЌрЈЇрјЕ
­ЪљЙ	рјцрј│рЈЈрЈЁ рјцрЈЎрЈфрјИ, рјцрј│рЈЈрЈЋрјЙ, рјцрЈгрЈ▒, рЈџрј│рЈЈрЈЁ рЈџрЈЎрЈфрјИрјб
­ЪдЃ	рјгрЈѓ, рЈЦрЈЇрЈє
­Ъљћ	рЈБрЈћрјд, рЈЦрЈЇрЈє
­ЪљЊ	рЈБрЈћрјд рјарЈерЈ», рЈЦрЈЇрЈє
­ЪљБ	рјарЈБрјб, рјцрЈЇрЈЌ, рЈБрЈћрјд рјцрЈЇрЈЌ, рЈБрЈћрјЕ рјарЈБрјб, рЈЦрЈЇрЈє
­Ъљц	рјцрЈЇрЈЌ, рјцрЈЇрЈЌ рЈБрЈћрјд, рјцрЈЇрЈЌ рЈБрЈћрјЕ, рЈЦрЈЇрЈє
­ЪљЦ	рјбрјгрЈ▒-рЈЌрЈю рјцрЈЇрЈЌ рЈЦрЈћрјд, рјцрЈЇрЈЌ, рјцрЈЇрЈЌ рЈБрЈћрјд, рЈЦрЈЇрЈє
­ЪљД	рЈЦрЈЇрЈє, рЈДрЈ┤рЈЮ рјАрј» рЈЦрЈЇрЈє
­ЪдЁ	рЈЦрЈЇрЈє, рЈгрјГрјх
­Ъдє	рјДрЈгрЈё, рЈЦрЈЇрЈє
­Ъдб	рјарЈЊрје рјарЈЊ, рјцрЈЂрјЕрјИрЈЌ рјДрЈгрЈё рјарЈЊ, рЈЇрјерЈє, рЈЦрЈЇрЈє
­ЪдЅ	рјарЈЊрЈф, рјцрјФрјФ, рЈЦрЈЇрЈє
­Ъдџ	рјцрјЙрЈбрЈЅрЈЌ, рјдрјЙрЈёрјфрЈФрЈЇрјд, рјгрјЙ рЈДрЈєрЈћрјх рЈДрјирјЕ рјарјЕрЈЈ, рјгрјЙ рЈДрЈєрЈћрјх рЈДрјирјЕ рјарЈерЈ»рјб, рЈЦрЈЇрЈє
­Ъдю	рј»рЈгрЈѓрј», рЈЦрЈЇрЈє, рЈЦрЈЇрЈє рјдрЈгрЈѓрЈЇрјЕ, рЈЦрЈ│рјАрЈЎрј» рјарЈЊрЈїрј▓рЈЇрјЕ
­ЪљИ	рјцрјДрЈЏ, рЈЕрјХрЈЈ, рЈЕрјХрЈЈ рјцрјДрЈЏ
­Ъљі	рЈДрј│рЈЇрјЕ
­Ъљб	рјарј╣рЈ▒ рјАрј» рЈЊрјдрЈЈ, рЈЊрјдрЈЈ, рЈЊрјдрЈЈ рјАрЈє
­Ъдј	рјарјЙрЈЊрЈЈрЈѓрЈЎрј», рЈўрЈ▓рјГрјх
­ЪљЇ	рјарЈЇрјдрЈ» рјбрјЙрЈЊ рјДрЈѓрЈЎрј», рјбрјЙрЈЊ, рЈЃрЈѕрЈЈ рЈЊрЈЪрјХрЈЇрЈЌрј▓рјб, рЈЌрјДрЈѓрЈЎрј»
­Ъљ▓	рјарЈЊрЈфрј», рјбрјЙрЈЊ рЈЌрјфрЈ»рЈЌ, рјбрјЙрЈЊ рЈЌрјфрЈ»рЈЌ рјцрјДрЈЏ, рјцрјДрЈЏ
­ЪљЅ	рјарЈЊрЈфрј», рјбрјЙрЈЊ рЈЌрјфрЈ»рЈЌ
­ЪдЋ	рјбрЈЁ рјбрјдрЈў рЈўрЈ▓рјГрјх, рјцрј│рЈЈрЈЋрјЙ рЈўрЈ▓рјГрјх, рјДрЈЃрјерЈѓ рЈўрЈ▓рјГрјх, рЈћрјх рјдрЈќрЈЇрје, рЈўрЈ▓рјГрјх рјцрј│рЈЈрЈЋрјЙ
­Ъдќ	рјц-рјцрјгрЈФрЈ│рј», рјцрјхрЈЇрјдрЈѓ рЈўрЈ▓рјГрјх рјцрјгрЈФрЈ│рј»
­Ъљ│	рјцрјДрЈЏ, рјДрЈгрјхрЈЋрЈЇрјг, рјДрЈгрјхрЈЋрЈЇрјг рЈЊрЈє, рЈЊрЈє
­ЪљІ	рЈЊрЈє
­Ъљг	рјарј╣ рјДрјирЈєрЈЋрјЕ, рјДрјирЈєрЈЋрјЕ
­Ъља	рјарЈБрЈЌ, рЈДрјдрЈЃрЈ« рјарЈБрЈЌ, рЈДрјдрЈЁрЈ«
­ЪљА	рјарЈБрЈЌ, рјарЈдрЈћрЈЇрјЕрјарЈБрЈЌ
­Ъдѕ	рјарЈБрЈЌ, рјцрјхрЈЇрјдрЈјрЈЇрЈЌ, рјцрјхрЈЇрјдрЈјрЈЇрЈЌ рјарЈБрЈЊ
­ЪљЎ	рјарЈЊрЈбрјб
­Ъљџ	рјарЈЋрЈ▓рј», рјарЈЋрЈ▓рј» рјарЈ»рЈЇрјдрјИрјб, рјарЈ»рЈЇрјдрјИрјб
­Ъдђ	рјарЈЊрЈ░рЈЇрјЕ, рјцрЈ»рЈЇрјдрЈгрЈЌ, рЈЃрЈѕрЈЈ рЈЊрЈЪрјХрЈЇрЈЌрј▓рјб
­Ъдъ	рјАрЈЅрЈѓ рјАрј» рјарјЕрЈЇрЈЌ, рјцрјдрј╣, рјцрЈћрјЙ рЈЦрЈЇрЈЏрјЙ, рЈџрЈЉрјдрЈб
­Ъдљ	рјарјхрЈЇрЈЊрЈ┤рЈЌ, рјцрјЙрЈ»рЈЇрјдрЈЪ рјарЈБрЈЌ, рјцрЈЇрЈЌ, рЈЦрЈЁрЈЁ
­ЪдЉ	рјарјхрЈЇрЈЊрЈ┤рЈЌ, рј╝рјИрЈЇрјЕ, рЈЇрЈѕрЈЌ
­Ъљї	рјАрј│рЈє
­ЪдІ	рјцрЈЇрЈЌ рјДрј╣рј╣, рјцрЈгрЈџрј», рјДрј╣рј╣, рЈЦрЈЇрјфрЈ»
­ЪљЏ	рЈЦрЈЇрјфрЈ»
­Ъљю	рЈЎрЈњрЈЊрјх, рЈЦрЈЇрјфрЈ»
­ЪљЮ	рјдрЈЇрјфрЈ│, рЈЦрЈЇрјфрЈ»
­Ъљъ	рјарјерЈ» рЈДрјхрЈЇрјФрЈЕ, рјарјЕрЈЈ рЈДрјхрЈЇрјФрЈЕ, рЈЦрЈЇрјфрЈ», рЈДрјхрЈЇрјФрЈЕ
­ЪдЌ	рЈћрј│рЈџ, рЈЎрј│рЈДрјд
­Ъдѓ	рЈЃрЈѕрЈЈ рЈЊрЈЪрјХрЈЇрЈЌрј▓рјб, рЈЦрЈЇрЈЏрјЙ рјарЈЊрЈерЈЇрјЕ, рЈДрЈЂрјхрЈЂ
­ЪдЪ	рјцрЈЌрј┤рј▓рЈЇрјЕ, рјЦрЈ│рјЕ, рјЦрЈ│рјЕ рјарЈ▒рјхрЈЎ, рЈЊрјХрЈѓрје рјцрЈЌрЈърј▓рЈЇрјг, рЈЎрЈї, рЈерЈЇрјфрЈ▒
­Ъда	рјцрЈЁрЈЦрЈЊ рјарјЕрЈЇрјЕ, рјЦрЈ│рјЕ рјарЈЊрЈарјЕ, рјЦрЈ│рјЕ рјарЈ▒рјхрЈЎ, рЈгрЈЇрЈЌрјг рјгрЈЃрЈЌ рјЦрЈ│рјЕ
­Ъњљ	рјцрЈЦрјИрЈЇрјЕ, рЈДрЈѓрЈЦрјИрЈЇрјЕ
­ЪїИ	рјцрЈЦрјИрЈЁ, рјцрЈЦрјИрЈЇрјЕ, рјЕрЈћрЈ», рјЕрЈћрЈ» рјцрЈЦрјИрЈЁ
­Ъњ«	рјцрЈЂрјд рјцрЈЦрјИрЈЇрјЕ, рјцрЈЦрјИрЈЇрјЕ
­Ъї╣	рјцрЈЦрјИрЈЇрјЕ, рјХрЈЈ
­ЪЦђ	рјцрјДрЈ┤рј░рЈЁ, рјцрЈЦрјИрЈЇрјЕ, рјцрЈЕрЈЁрЈгрЈњ рјарЈЦрјИрЈЇрјЕ
­Ъї║	рјцрЈЦрјИрЈЇрјЕ, рјГрЈѕрЈЇрјгрЈЈ
­Ъї╗	рјцрЈЦрјИрЈЇрјЕ, рЈЁрЈЊ рјбрјд рјАрј», рЈЁрЈЊрЈЌрјДрЈЁрЈЕрЈЌрЈЎрј»
­Ъї╝	рјцрЈЦрјИрЈЁ, рјцрЈЦрјИрЈЇрјЕ
­Ъїи	рјцрЈЦрјИрЈЇрјЕ, рЈџрјхрЈѕ
­Ъї▒	рјарЈЊ, рјцрјдрЈћрЈЏрЈЁ
­Ъї▓	рјарЈЦрјЙ рјбрЈАрјгрјб, рјбрЈАрјгрјб
­Ъї│	рјарЈџрЈЕрЈѓрјЕрЈЇрЈЌ, рјбрЈАрјгрјб, рјдрјхрЈЇрЈџрЈгрЈЇрјгрјб, рјдрјхрЈЇрЈџрЈгрЈЇрјгрјб рјбрЈАрјгрјб
­Ъї┤	рјбрЈАрјгрјб, рЈДрјдрЈёрЈЊрЈЁрј»рЈЏ, рЈДрјдрЈёрЈЊрЈЁрј»рЈЏ рјбрЈАрјгрјб
­Ъїх	рјцрјхрјАрЈЇрјЕ, рјдрјфрЈЌ
­ЪїЙ	рјарЈЇрЈЊрЈ┤рЈЊрЈЁ рјЙ рЈЊрјхрЈє, рјцрјдрЈћрЈЏрЈЁрјб, рјдрј┤рЈѓ, рЈЊрјхрЈє
­Ъї┐	рјцрјдрјХрјд, рјцрј┐рЈЇрЈЋрј│
­ЪЇђ	4, рјцрјдрјХрјд, рјЕрјдрје рјарЈЦрјИрЈЇрјЕ, рЈЁрјЕ, рЈЁрјЕ рЈДрјдрјХрјЕ рјЕрјдрје рјарЈЦрјИрЈЇрјЕ
­ЪЇЂ	рјцрјдрјХрјд, рјфрј░рЈЇрјЕ, рЈбрЈЕрјЕ, рЈбрЈЕрјЕ рјцрЈєрјХрјЕ
­ЪЇѓ	рјцрјдрјХрјд, рјцрјхрЈЇрЈџрјфрЈњрјЕ, рјфрј░рЈЇрјд
­ЪЇЃ	рјарЈдрЈћрЈЇрЈЌ, рјцрјдрјХрјд, рјцрјдрјХрјд рјдрЈЃрЈ░ рјдрЈЃрјИрЈЇрјгрјб, рјдрЈЃрјИрЈЇрјд, рЈЊрјхрЈљрЈ░
­ЪЇЄ	рјцрЈѓрЈќрјИрј│рЈЌ, рјцрЈЊрЈћрЈЁрјб, рЈќрјИрј│рЈЌ
­ЪЇѕ	рјцрЈЊрЈћрЈЁрјб, рјгрјЕрЈЇрЈЌ
­ЪЇЅ	рјарј╣ рјгрјЕрЈЇрЈЌ, рјцрЈЊрЈћрЈЁрјб
­ЪЇі	рјарЈЊрјХрЈѓрје рјарјЕрЈЇрЈЌ, рјБрЈѓрЈЦ, рјцрЈЊрЈћрЈЁрјб
­ЪЇІ	рјцрЈЊрЈћрЈЁрјб, рјхрј╣рЈѓ, рЈДрјЙрЈдрјбрЈЇрЈЌ
­ЪЇї	рјцрЈЊрЈћрЈЁрјб, рЈєрЈЂрјЙ
­ЪЇЇ	рјцрЈЊрЈћрЈЁрјб, рЈЃрЈБ рЈњрјдрЈћ рјарјЕрЈЇрЈЊ
­ЪЦГ	рјарЈЊрЈЏрЈЇрјЕ, рјдрЈџрјхрЈЊ, рј║рЈѓрјф
­ЪЇј	рјцрЈЊрЈћрЈЁ, рјЕрјдрје, рјЕрјдрје рЈњрјдрЈћ, рЈњрјдрЈћ
­ЪЇЈ	рјбрЈц рјбрЈ│рЈЇрЈЌ, рјбрЈцрЈ│рЈЇрЈЌ рЈњрјдрЈћ, рјцрЈЊрЈћрЈЁ, рЈњрјдрЈћ
­ЪЇљ	рјцрЈЊрЈћрЈЁрјб, рјдрЈЏрЈЌ
­ЪЇЉ	рјцрЈЊрЈћрЈЁрјб, рЈєрјЙ
­ЪЇњ	рјцрЈЊрЈЏрЈЁрјб, рјЕрЈћрЈ»
­ЪЇЊ	рјарЈѓ, рјцрЈЊрЈћрЈЁ
­ЪЦЮ	рјарјхрЈЇрЈЊрЈ┤рЈЌ, рјцрЈЊрЈЏрЈЁрјб, рјЕрЈФ, рјЕрЈФ рјцрЈЊрЈћрЈЁрјб
­ЪЇЁ	рјарЈФрЈњрЈЁ рјцрЈЏрЈњ, рјцрЈЊрЈћрЈЁ, рЈЊрј╣рЈЪ
­ЪЦЦ	рјГрЈфрјЙрЈЌрЈб рјцрЈгрЈ░рЈѓ, рЈѕрјЙ рјфрј│рЈЊ, рЈљрЈѕ рјцрЈфрЈЦ
­ЪЦЉ	рјарјхрЈЇрЈЊрЈ┤рЈЌ, рјцрЈЊрЈћрЈЁрјб, рЈДрј│рЈЇрјЕ рјцрЈфрЈЦ
­ЪЇє	рјарЈЊрј▓рјхрје рјарЈЊрЈЏрЈЇрјЕ, рјарЈФрЈњрЈЁ рјцрЈЏрЈњ, рјцрЈфрЈЦрјдрјфрЈЌ
­ЪЦћ	рјарјхрЈЇрЈЊрЈ┤рЈЌ, рјарЈФрЈњрЈЁ рјцрЈЏрЈњрјб, рЈёрјЙ
­ЪЦЋ	рјарјхрЈЇрЈЊрЈ┤рЈЌ, рјарЈЊрјХрЈѓрје, рјарЈФрЈњрЈЁ рјцрЈЏрЈњрјб, рЈЊрјХрЈѓрје рјдрЈбрЈЇрјЕ
­Ъїй	рјарји, рјарЈЊрј┤рјЙрЈЇрЈЌрЈЇрјЕ, рјдрј┤, рЈјрји, рЈјрји рјдрјхрЈЪрјг
­ЪЦњ	рјарјхрЈЇрЈЊрЈ┤рЈЌ, рјарЈФрЈњрЈЁ рјцрЈЏрЈњрјб, рјдрјдрј╣, рјдрјдрј╣ рЈЌрјДрЈЁрЈдрјбрЈЇрЈћрЈЁ
­ЪЦг	рјарјфрЈЇрЈЊрјЕрЈЇрЈЌ, рјбрЈцрјбрЈ│рЈЇрЈЌ рјцрјдрјХрјд, рјцрЈћрјЙ рЈДрјдрјХрјд рЈДрјдрЈЁрЈЋрјЙ, рЈЊрјХрЈѓрјерЈЇрЈЏ рЈѓрЈЊрЈ│рјХрЈњ рЈДрјдрЈЁрЈЋрјЙ, рЈДрјдрЈЁрЈЋрјЙ
­ЪЦд	рЈБрјдрЈЁрЈЋрјЙ рјбрјЙрје рјАрј», рЈДрјдрЈЁрЈЋрјЙ рјцрЈЇрЈЌ
­ЪЇё	рЈЊрЈгрјх, рЈЕрјХрЈЈ рЈЊрЈгрјх
­ЪЦю	рјарјхрЈЇрЈЊрЈ┤рЈЌ, рјарЈѓрЈЁрј»рЈЊ рЈџрЈ», рјарЈФрЈњрЈЁ рјцрЈЏрЈњрјб, рЈљрј», рЈџрЈ» рјарЈѓрј│рЈЌрЈЇрјЕ
­Ъї░	рјдрјфрЈЌ, рЈўрјх
­ЪЇъ	рјдрЈџ, рјдрЈџрЈЁ
­ЪЦљ	рјарјхрЈЇрЈЊрЈ┤рЈЌ, рјдрјИрЈЦ, рјдрјИрЈЦ рјдрЈџ, рјдрЈљрЈєрј│ рјдрЈџ, рјдрЈџ
­ЪЦќ	рјарјхрЈЇрЈ┤рЈЌ, рјдрјИрЈЦ, рјдрЈЁрј»рЈЊ рЈїрје рјдрЈџ, рјдрЈџ, рјдрЈџ рјдрЈЁрј»рЈЏ
­ЪЦе	рјцрЈЇрЈЊрјдрЈ┤рј»рЈЊ рјдрЈџ, рјдрЈёрЈќрЈ▓рјИрјб
­ЪЦ»	рјцрЈБрј┤рЈЇрЈЌрјцрјдрЈћ рјдрЈџ, рјдрЈџ рјдрЈЁрјхрЈ░рЈЌ, рЈДрЈѓрЈЁрЈўрЈ▒
­ЪЦъ	рјарјхрЈЇрЈЊрЈ┤рЈЌ, рјцрЈЌрЈърјд, рјдрЈџ рјцрјдрјЙрЈЇрЈЊ, рЈїрје рјдрЈџ, рЈћрјирјЕрЈЇрјЕ рјдрЈџ
­ЪДђ	рјцрЈЁрЈЌ рјдрЈџрЈЁ, рјцрЈЁрЈЌ рјдрЈџрЈЁ рјарјдрЈ»рјирЈ┤рјб
­ЪЇќ	рјфрј│, рјГрЈФрЈ», рјГрЈФрЈ» рјдрЈЂрјдрјИ рјфрј│
­ЪЇЌ	рјдрЈЁрЈЇрјерјЙ, рјфрј│, рЈБрЈћрјд, рЈЦрЈћрјд рјдрјдрјИ
­ЪЦЕ	рјцрЈЃрЈЋрјЙ рјГрЈФрЈ», рјдрјирЈ┤, рјГрЈФрЈ», рјГрЈФрЈ» рјарјгрјГрјирЈ┤рјб, рЈЈрЈє рјГрЈФрЈ»
­ЪЦЊ	рјарјхрЈЇрЈЊрЈ┤рЈЌ, рјГрЈФрЈ», рјГрЈФрЈ» рЈЌрјдрЈњрЈЇрЈћрЈЁ
­ЪЇћ	рјГрЈФрЈ» рјарЈЇрЈЏрјГрЈЪ, рЈЕрјД рјарЈЇрЈЏрјГрЈЪ
­ЪЇЪ	рјдрјИрЈЦрЈЁрјЙ, рјдрјИрЈЦрЈЁрјЙ рЈЌрјгрЈБрј│рЈЁрј», рЈЌрјгрЈБрј│рЈЁрј»
­ЪЇЋ	рјарЈЇрЈЊрј▓рЈбрЈЁ рјарјЕрЈЇрЈЌ, рјцрЈЁрЈЌ рјдрЈџрЈЁ, рјдрјгрјГрјирЈ┤
­ЪїГ	рјарЈњрЈЁрЈЎрЈЌ рјГрЈФрЈ», рјГрЈФрЈ», рЈЈрЈє рјГрЈФрЈ»
­ЪЦф	рјарЈЇрЈЏрјГрЈЪ, рјдрЈџ
­Ъї«	рјарЈЇрЈєрЈѓ, рЈјрји рјдрЈџ рјцрЈѓрЈЇрЈЏрјдрЈ▒рЈЊ
­Ъї»	рјарЈЇрЈєрЈѓ, рјдрЈЄрЈЁ
­ЪЦЎ	рјарјхрЈЇрЈ┤рЈЌ, рјарЈЇрЈЊрЈЁрЈЁрјб рјдрЈџ, рјдрЈєрЈЁрЈЊрЈЁ, рјдрЈєрЈЁрЈЊрЈЁ рјарЈЇрЈЊрЈЁрЈЁрјб рјдрЈџ, рјерЈєрЈє, рЈЦрјХ, рЈЕрј│рЈфрјх
­ЪЦџ	рјарјхрЈЇрЈЊрЈ┤рЈЌ, рјцрЈфрЈЦ
­ЪЇ│	рјарЈЊрЈЇрЈЊрЈ┤рј▓рЈЇрјЕ, рјарЈЊрЈЇрЈЎрЈЌ, рјцрЈфрЈЦ, рјгрЈБрЈбрЈЇрјд
­ЪЦў	рјарјхрЈЇрЈ┤рЈЌ, рјцрЈЁрЈфрЈЊ, рјцрЈЕрЈќрЈїрЈў, рјдрЈЊрјФрјЕ, рЈЁрЈгрЈџ рјцрЈЕрЈќрЈїрЈЊ рјЙ рјарјхрЈЇрЈЊрЈ┤рЈЌ
­ЪЇ▓	рјарЈЪрЈЇрЈЏ, рјцрјдрј╣, рЈДрј│рЈЇрјЕ рјДрјх рјарјхрЈЇрЈЊрЈ┤рЈЌ
­ЪЦБ	рјцрЈЁрЈфрЈЊ рјЙрЈЇрјЕ рјгрЈЕрЈарЈ»рЈЇрЈЌ рјарЈЌрЈЎрЈў, рјгрЈФрЈЇрЈЊ, рЈЉрјЙрј┤рјб рјарјхрЈЇрЈЊрЈ░рЈЌ, рЈЊрјхрЈє рјгрЈФрЈЇрЈћрЈЁ
­ЪЦЌ	рјарјхрЈЇрЈЊрЈ┤рЈЌ, рјбрЈц рЈ│рЈЇрЈЌ, рјбрЈцрЈ│рЈЇрЈЌ рјфрЈЇрЈЊ рјарјЕрЈЇрЈЌ, рјфрЈЇрЈЊрјЕрЈЇрЈЌ
­ЪЇ┐	рЈјрји рјарЈћрЈЇрјЕрЈЇрјЕ
­ЪДѓ	рјарј╣, рјарЈќрјИрЈЌ, рЈДрЈЊрј┤рЈЁрЈЊ рЈЌрЈєрЈ▓рЈЎрЈЊ рјЦрЈЊрЈЇрЈЊрЈ┤рј▓рЈЇрјгрјб
­ЪЦФ	рјдрЈЪрЈћрЈЁрјб рјарјхрЈЇрЈЊрЈ░рЈЌ, рЈћрјирјЕрЈЇрјЕ рјдрЈЪрЈЎрЈЌ
­ЪЇ▒	рјцрјхрЈЇрЈЊрЈ░рЈЌ, рЈБрЈ▒рЈѓрЈЈ, рЈБрЈ▒рЈѓрЈЈ рјцрјхрЈЇрЈЊрЈ░рЈЌ
­ЪЇў	рјдрЈџ рјцрЈЇрЈЊрјгрЈ┤рј»рЈЊ, рЈЊрјхрЈє, рЈЊрјхрЈє рјдрЈџ рјцрЈЇрЈЊрјгрЈ┤рј»рЈЊ
­ЪЇЎ	рјдрЈљрЈєрјИ, рЈЊрјхрЈє, рЈЊрјхрЈє рЈЇрЈєрЈърЈЇрЈЌ, рЈБрЈ▒рЈѓрЈЈ
­ЪЇџ	рјгрЈѓрЈЇрЈћрЈЁрјб, рЈЊрјхрЈє, рЈЊрјхрЈє рјгрЈѓрЈЇрЈћрЈЁрјб
­ЪЇЏ	рјцрјдрј╣, рЈЊрјхрЈє, рЈЊрјхрЈє рјцрјдрј╣
­ЪЇю	рјарЈЦрј│ рјдрЈїрЈЎрЈ»рЈЇрјЕ рЈЌрЈЕрјх, рјцрЈЁрЈфрЈЊ, рјцрЈЌрЈърјЕ, рјдрјИрЈЁ, рј┤рј╣рЈѓ
­ЪЇЮ	рјдрјИрЈЁ, рЈЇрЈєрјерЈў
­ЪЇа	рјарЈњрјЙрЈћрЈЁрјб, рјцрјдрјЙрЈЇрЈЌ, рјдрЈџрЈЁ рЈёрјЙ рјарЈѓрЈЁрј»рЈЊ, рЈёрјЙ
­ЪЇб	рјарј╣рј║рЈЅ рЈЊрЈ│рјХрЈњ рјарјхрЈЇрЈЊрЈ░рЈЌ, рјБрЈЌрЈѓ, рјдрЈЁрЈЇрЈЊ, рјдрЈЁрЈЇрЈЌ, рјерЈєрЈє
­ЪЇБ	рјарЈЉрЈ┤рјЙ рјарјЕрЈЇрЈЌ
­ЪЇц	рјАрЈє рЈЦрЈЁрЈЁ, рјгрЈБрј│рЈЁрјб рЈЦрЈЁрЈЁ, рјгрЈБрЈбрЈЁрјб, рјгрЈерЈЮрЈЁ, рЈЦрЈЁрЈЁ
­ЪЇЦ	рјарЈЌрЈєрјИрЈЋрЈ▓рј», рјарЈБрЈЌ, рјарЈБрЈЌ рјдрЈџ рјцрјдрјЙрЈЇрЈЊ рјцрЈарЈ»рЈЇрЈЌ рјарЈЌрЈєрјИрЈЋрЈ▓рј», рјдрЈџ, рјдрЈџ рјцрЈѓрјдрјЙрЈЇрЈЊ
­ЪЦ«	рјцрј│рјфрј▓рЈЇрјЕ, рјцрЈЊ рјдрЈџ рјцрјдрјЙрЈЇрЈЊ, рјцрЈгрЈЌ рјцрЈѓрЈЇрЈєрјИрј«рј▓рјб, рЈЊрјХрЈѓрјерЈЇрЈЏ рЈѓрЈЊрЈ│рјХрЈњ рјцрЈЊ рјдрЈџ рјцрјдрјЙрЈЇрЈЊ
­ЪЇА	рјцрјдрјЙрЈЇрЈЊ, рјцрјдрјЙрЈЇрЈЊ рјарјЕрЈЇрЈЌ, рјдрЈЁрЈЇрЈЊ, рЈЋрЈѓрјф, рЈБрЈ▒рЈѓрЈЈ
­ЪЦЪ	рјАрј╗рЈєрјЙрЈЊ, рјдрјИрЈЁрјб, рјЕрЈ▓рЈї, рЈѕрјХрјЕ, рЈЦрЈ»рјБрЈЈ, рЈДрј│рЈЇрјЕ рјарјЕрЈЇрЈЌ
­ЪЦа	рјцрЈЕрјФрЈЌрЈЌрЈњ рјДрЈЃрј«рЈЊ, рЈБрЈѓрЈЈ рјдрЈџ рјцрјдрјЙрЈЇрЈЊ
­ЪЦА	рјарЈФрЈЏрЈЌ рјДрЈЂрЈї, рјфрј»рЈЁрЈЇрЈЌ
­ЪЇд	рјцрјдрјЙрЈЇрЈЊ, рјцрјдрјЙрЈЌрЈЊ рјарјЕрЈЇрЈЌ, рјцрјдрЈЏрЈбрЈЊ, рјцрЈЂрЈЇрЈЊрј│, рјцрЈЁрЈЌ рјдрЈЂрЈЇрЈЊрј│рЈЌрЈЇрЈћрЈЁ, рјдрЈЂрЈЇрЈЊрјхрЈЌрЈЇрЈЊрЈЁ рјцрЈЁрЈЌ, рЈЕрЈѓрје
­ЪЇД	рјарЈЇрЈЎрЈ░рЈЊ, рјцрјдрјЙрЈЇрЈЊ, рјцрЈЂрЈЇрЈЊрј│, рјцрЈЂрЈЇрЈЊрј│ рјарЈЇрЈЎрЈ░рЈЊ
­ЪЇе	рјцрјдрјЙрЈЇрЈЊ, рјцрјдрјЙрЈЇрЈЊ рјарјЕрЈЇрЈЌ, рјцрјдрЈЊрЈбрЈЊ, рјцрЈЂрЈЇрЈЊрј│, рјцрЈЁрЈЌ рјдрЈЂрЈЇрЈЊрј│рЈЌрЈЇрЈћрЈЁ
­ЪЇЕ	рјарЈћрј┤рЈЊ рјдрЈџ, рјцрјдрјЙрЈЇрЈЊ, рјцрјдрјЙрЈЇрЈЊ рјарјЕрЈЇрЈЌ, рјдрЈџ рјцрјдрјЙрЈЇрЈЊ
­ЪЇф	рјцрјдрјЙрЈЇрЈЊ, рјцрјдрјЙрЈЇрЈЊ рјарјЕрЈЇрЈЌ, рјдрЈџ рјцрјдрјЙрЈЇрЈЌ
­Ъјѓ	рјарјЙрјхрј«рјхрјгрјб, рјцрјдрјЙрЈЇрЈЊ, рјцрјдрјЙрЈЇрЈЊ рјарјЕрЈЇрЈЌ, рјцрЈЋрЈўрЈ▒рЈЇрјгрјб, рјцрЈЋрЈўрЈ▒рЈЇрјгрјб рјдрЈџ рјцрјдрјЙрЈЇрЈЊ, рјдрЈџ рјцрјдрјЙрЈЇрЈЊ, рјдрЈџ рјцрЈѓрјдрјЙрЈЇрЈЊ
­ЪЇ░	рјарјгрЈ»рјирЈ┤рјб, рјцрјдрјЙрЈЇрЈЊ, рјцрјдрјЙрЈЇрЈЊ рјарјЕрЈЇрЈЌ, рјдрЈџ рјцрјдрјЙрЈЇрЈЊ, рјдрЈџ рјцрЈѓрјдрјЙрЈЇрЈЊ
­ЪДЂ	рјцрјдрјЙрЈЇрЈЊ, рјцрјхрЈЇрЈѕрЈЌ рјдрЈџ рјцрјдрјЙрЈЇрЈЌ, рЈДрЈѓрЈЁрЈўрЈ▒
­ЪЦД	рјцрЈЇрЈЌ рјерјхрЈЇрјЕ, рјерјхрЈЇрјЕ, рјГрЈФрјЙрЈЌрЈю
­ЪЇФ	рјарЈ»рЈћрјЙрјИ, рјцрјдрјЙрЈЇрЈЌ, рјцрјдрјЙрЈЇрЈЌ рјарјЕрЈЇрЈЌ, рјцрЈгрЈЌрје рјДрјхрЈјрЈЦ
­ЪЇг	рјцрјдрјЙрЈЇрЈЊ, рјцрјдрјЙрЈЇрЈЊ рјарјЕрЈЇрЈЌ, рјДрјхрЈјрЈЦ
­ЪЇГ	рјцрјдрјЙрЈЇрЈЊ, рјцрјдрјЙрЈЇрЈЊ рјарјЕрЈЇрЈЌ, рјДрјхрЈјрЈЦ, рјДрјхрЈјрЈЦ рјдрЈЁрј»рЈЊ
­ЪЇ«	рјарЈЉрЈ░рјЦрјб, рјцрјдрјЙрЈЇрЈЊ, рјцрјдрјЙрЈЇрЈЊ рјарјЕрЈЇрЈЌ, рјерјхрЈЇрЈћрЈЁ
­ЪЇ»	рјарЈЪрЈЇрЈЎрЈЌ, рјцрјдрјЙрЈЇрЈЊ, рЈЕрЈџрјхрЈЈ, рЈЕрЈџрјхрЈЈ рјарЈЪрЈЇрЈЎрЈЌ
­ЪЇ╝	рјарЈЌрЈћрЈЇрЈЌ, рјцрЈЁрЈЌ, рјцрЈЇрЈЌ, рјцрЈЇрЈЌ рјцрЈЇрЈЏрЈЇрЈЌ, рјФрјЕ
­ЪЦЏ	рјарЈЌрЈћрЈЇрЈЌ, рјцрјИрЈїрЈЌ, рјцрЈЁрЈЌ, рјцрЈЁрЈЌ рјцрјИрЈїрЈЌ рјарЈЪрЈЇрЈЏрјб
­ЪЇх	рјарЈЌрЈћрЈЇрЈЌ, рјцрјдрјХрјд, рјцрјдрјХрјдрјцрјхрЈЇрЈѕрЈў, рјцрјхрЈЇрЈѕрЈў, рјцрјхрЈЇрЈѕрЈў рјдрЈѓрЈ┤рЈЎрЈЌ рЈёрЈЇрЈЏрјЙ
­ЪЇХ	рјарЈЌрЈћрЈЇрЈЌ, рјарЈ»рЈћрјЙрјИ, рјцрјхрЈЇрЈѕрЈў, рјФрјЕ
­ЪЇЙ	рјарЈЇрЈџрЈЎрЈЌ, рјарЈћрЈЇрјЕрЈЇрјг, рјарЈЌрЈћрЈЇрЈЌ, рјарЈ»рЈћрјЙрјИ, рјФрјЕ, рјФрјЕ рјгрЈЕрЈарЈ»рЈЇрЈЌ рјарЈћрЈЇрјЕрЈЇрјЕ
­ЪЇи	рјарЈЌрЈћрЈЇрЈЌ, рјарЈ»рЈћрјЙрјИ, рјцрјИрЈїрЈЌ, рјЕрјдрје рјарЈЌрЈћрЈЇрЈЌ, рјЕрјдрје рјарЈЌрЈћрЈЇрЈЌ рјФрјЕ
­ЪЇ╣	рјарЈЌрЈћрЈЇрЈЌ, рјарЈ»рЈћрјЙрјИ, рЈЌрјдрЈЇрјЕ, рЈДрјдрЈЃрЈЕ рјарЈЌрЈћрЈЇрЈЌ
­ЪЇ║	рјарЈЌрЈћрЈЇрЈЌ, рјарЈгрјЕрЈбрЈЇрјЕ, рјарЈгрјЕрЈбрЈЇрјЕ рјарЈЪрЈЇрЈЎрЈЌ, рјарЈ»рЈћрјЙрјИ, рјдрЈЊрјФрјЕ
­ЪЇ╗	рјарЈЌрЈћрЈЇрЈЌ, рјарЈгрјЕрЈбрЈЇрјЕ, рјарЈ»рЈћрјЙрјИ, рјдрЈЊрјФрјЕ, рЈЊрЈЊрЈњрЈЁрЈЇрЈЌрј▓ рјарЈгрјЕрЈбрЈЇрјЕ рЈЌрЈЪрЈЎрЈЌ, рЈЊрЈЊрЈњрЈЇрЈЌрЈЇрјгрјб
­ЪЦѓ	рјарјхрј«рјхрЈЇрЈЌ, рјарЈЌрЈћрЈЇрЈЌ, рјцрјИрЈјрЈЌ, рЈЊрЈЊрЈњрЈЁрЈЇрЈЌрј▓ рЈДрјИрЈїрЈЌ, рЈДрЈЊрЈњрЈЁрЈЇрЈћрЈЁ
­ЪЦЃ	рјарЈЊрЈ┤рЈЇрЈЋрЈЇрЈЌрЈЇрјЕ, рјцрјИрЈїрЈЌ, рјФрјЕ рјарЈЪрЈЇрЈЎрЈЌ, рЈЇрЈџрјЕрЈЇрЈЌ, рЈФрЈЇрјЕ
­ЪЦц	рјарЈЌрЈћрЈЇрЈЌ, рјцрјхрЈЇрЈѕрЈў рјЙрЈЇрјЕ рјгрЈЕрЈарЈ»рЈЇрЈЌ рјарј╣рЈЌрЈЎрЈЌ, рјфрјИрЈЇрЈћрЈЁ
­ЪЦб	рјдрјирЈЇрЈЌрјдрЈЁрЈЇрЈЌ, рј«рЈЈ
­ЪЇ┤	рјарЈЊрЈЇрЈЊрЈ┤рј▓рЈЇрјЕ, рјарЈ░рј│рЈЇрЈЌ, рЈ│рјЕ рјарј┤ рјГрЈ░рјхрЈЇрЈЌ, рЈ┤рјЕ
­ЪЦё	рјарЈЌрЈЎрЈЌ, рјдрЈЇрјЕрјХрјарЈбрЈЁрЈЌ
­Ъћф	рјарјхрЈЇрЈЋрјИрЈЎрЈЌ, рјарЈЊрЈЇрЈЊрЈ▒рЈЌрјб рјарЈ░рј│рЈЇрЈЌ, рјарЈЊрЈЇрЈЊрЈ┤рј▓рЈЇрјгрјб, рјарЈ░рј│рЈЇрЈЌ, рјгрЈћрЈѓрЈЊрЈЇрЈЌ, рј░рЈд
­ЪЈ║	рјарјхрЈЇрЈЋрјИрЈЎрЈЌ, рјарј╣ рјдрЈЁрЈЦрЈЎрј», рјарЈЊрЈЇрЈЊрЈ┤рј▓рЈЇрјЕ, рјарЈЌрЈћрЈЇрЈЌ, рјдрЈЊ рјФрјЕ, рјЕрјдрје рјарЈЌрЈћрЈЇрЈЌ рЈЌрЈЪрЈЇрЈЎрЈЌ, рЈЃрЈѕрЈЈ рЈЊрЈЪрјХрЈЇрЈЌрј▓рјб
­ЪїЇ	рјАрјХрј», рјАрјХрј» рЈЌрЈЪрјХрЈЇрЈћрЈЁ, рјАрјХрј» рЈЌрЈЪрјХрЈЇрЈћрЈЁрјб рјгрЈѓрјерЈњрјб рЈѓрјгрЈЂрј» рЈ│рј│рЈѕрЈ▒-рјгрј┐рјерјб, рјгрј┐рјерЈЇрЈЏрјб, рЈЇрЈєрЈѓрЈ┤
­ЪїЈ	рјАрј│рЈЌрЈбрјб, рјАрјХрј», рјАрјХрј» рЈЌрЈЪрјХрЈЇрЈћрЈЁ, рјАрјХрј» рЈЌрЈЪрјХрЈЇрЈћрЈЁрјб рјгрЈѓрјерЈњрјб рЈѓрјгрЈЂрј» рјАрЈЈрЈ▒рја-рЈЌрјЙрјхрЈћрЈЋрјЕрјб, рЈЊрјХрЈѓрјерЈЇрЈЏ
­Ъїљ	рјАрјХрј», рјАрјХрј» рЈЌрЈЪрјХрЈЇрЈћрЈЁ, рјАрјХрј» рЈЌрЈЪрјХрЈЇрЈћрЈЁрјб рјЙрЈЇрјЕ рјгрЈЕрЈарЈ»рЈЇрЈЌ рј╣рјхрЈЌрЈѓрЈ▒рЈЈ, рј╣рјхрЈЌрЈ»рЈѓрјб
­ЪЌЙ	рјАрјХрј» рЈЊрЈЪрјХрЈЇрЈЏ, рЈБрЈЕрЈѓрЈЈрјб, рЈцрЈЄрјЙ рјарЈЇрЈЊрЈФрЈЏрЈЇрЈЌ рЈЌрЈЪрјХрЈЇрЈЊрЈЁрјб
­ЪДГ	рјарј│рЈѓ рјарјдрЈЎрЈЌ, рјарјЙрЈЊрјфрјЙрЈЌрЈЇрјг рјАрјХрј» рјарЈЪрјХрјЦрјб рјгрЈћрЈЁрјб, рјарЈЊрЈўрЈѓрЈЎрј», рЈћрјирјЕрЈЇрјЕ рјдрЈїрЈЂрЈЇрјЕ
­ЪїІ	рјарЈБрјирЈўрЈЇрјгрјб, рјБрЈЊрјИрјб, рјдрЈЎ рјарЈћрј┤рЈњ рјарЈћрЈЇрјЕрЈЇрјЕ
­ЪЌ╗	рЈџрЈЁрЈЊрЈбрјб, рЈАрЈЦ, рЈАрЈЦ рјБрЈЊрјИ
­ЪД▒	рјцрЈЇрЈєрј│рЈўрјд, рјдрЈЊрЈєрј│, рјДрЈЉрјДрЈАрјб, рЈЁрЈ»рјарЈЏрЈЊрЈћрЈЁрј», рЈЁрЈ»рЈЌрЈЏрЈЊрЈЁрјб
­ЪЈА	рјарЈЊрЈЂрјИрјб, рјарЈФрЈњрЈЁрјб, рјБрЈфрЈЁрЈњрјб, рјдрјхрЈдрЈЋ рјгрЈЕрЈарЈ»рЈЇрЈЌ рјарЈФрЈњрЈЁрјб
­ЪЈб	рјарЈЊрЈЂрјИрјб, рЈЌрјдрјХрЈФрЈЇрЈЊрЈЂрЈЌ рјарЈЊрЈЂрјИрјб
­ЪЈБ	рјцрЈфрЈЊрЈЇрЈЌрјб, рЈБрЈЕрЈѓрЈЈ рјфрЈфрјх рЈДрЈѓрЈЇрЈџрјбрЈЇрЈЌ, рЈБрЈ▒рЈѓрЈЈ
­ЪЈц	рјфрЈфрјх рЈЌрјдрЈЂрЈЇрЈЌрјб, рјфрЈфрјх рЈДрЈѓрЈЇрЈџрјбрЈЇрЈЌ, рЈЇрЈєрЈѓрЈ▒
­ЪЈЦ	рјдрјЙрјдрЈў, рЈЁрЈгрЈў, рЈДрЈѓрЈбрјЕ
­ЪЈд	рјарЈЊрЈЂрјИрјб, рјарЈЋрј│рЈДрЈѓрЈЌ рјцрјЙрЈЋрЈўрЈ▒рЈЇрјг
­ЪЈе	рјарЈЊрЈЂрјИрјб, рЈДрЈѓрЈњрЈЇрЈЌ
­ЪЈЕ	рјарЈЊрјИрЈЅрЈЌ рјарЈњрЈЇрЈЌ, рјдрјИрЈЅрЈЌ, рЈДрЈѓрЈњрЈЇрЈЌ
­ЪЈф	рјарј»рЈЊрЈЃ, рјарј»рЈЊрЈЃ рЈЕрЈЊрјЙрЈЂрЈЇрЈЌрјб, рЈЕрЈЊрјЙрЈЂрЈЇрЈЌрјб
­ЪЈФ	рјарЈЊрЈЂрјИрјб, рЈЌрЈЋрјХрЈєрЈЇрЈЌ
­ЪЈг	рјарЈЊрЈЁрЈЁрјб, рјцрЈћрјЙ, рјцрЈћрјЙ рјарЈЊрЈЁрЈЁрјб
­ЪЈ»	рјцрЈѓрЈ»рЈФрЈЇрЈЌ, рЈБрЈЕрЈѓрЈЈ, рЈБрЈЕрЈѓрЈЈ рјарЈ»рЈФрЈЇрЈЌ
­ЪЈ░	рЈЇрЈєрЈѓрЈ┤рјб, рЈ┤рЈФ рјарЈљрЈ┤рјб
­Ъњњ	рЈЋрјерјЕрЈерЈЇрЈЌрј▓рјб, рЈџрјЙрЈЊрјИрЈЅрЈЏрјб, рЈДрЈѓрј│рЈФрЈЇрЈЌ
­ЪЌ╝	рјерЈЏрјб, рЈЎрјЕрЈ▓, рЈЎрјЕрЈ▓ рјерЈЏрјб
­ЪЌй	рјарј┤рЈћрЈЁ, рјарј┤рЈћрЈЁ рјБрЈЕрЈї рЈЌрјФрјфрЈћрЈѓрЈЊрЈЇрЈЌ рЈЊрЈЪрјХрЈЇрЈЏрјб, рјБрЈЕрЈї рЈЌрјФрјфрЈћрЈѓрЈЊрЈЇрЈЌ
­ЪЋї	рјбрЈЈрј│рј╗, рјцрЈЃрј»рЈ│рЈњрјб, рј╣рЈЈрј│рј╗, рЈЌрјдрј│рЈФрЈЇрЈЌ
­ЪЋЇ	рјарЈѓрЈДрЈЈ, рјарЈѓрЈДрЈЈ рЈДрЈѓрј│рЈФрЈЇрЈЌ, рЈДрјЙрЈЂрЈЪрЈЌ, рЈДрЈѓрј│рЈФрЈЇрЈЌ, рЈДрЈФ
­ЪЋІ	рјбрЈЈрј│рј╗, рјцрЈЃрј»рЈ│рЈњрјб, рјДрЈє, рј╣рЈЈрј│рј╗
­ЪїЂ	рјцрјгрјГрЈЊ, рЈЕрјХрЈЈ
­ЪїЃ	рјцрЈњрјб, рјцрЈњрЈЌрЈю рЈЃрЈѕрЈЈ, рЈЃрЈѕрЈЈ
­Ъїё	рјцрјЕрЈЦрЈЇрјг, рјцрјЕрЈЦрЈЇрјг рјдрЈџ рЈџрЈЎрЈЊрјИ, рЈЁрЈЊ рјбрјд рјАрј», рЈЉрјЙрЈЅрјб, рЈџрЈЁрЈЊрЈбрјб
­ЪїЁ	рјАрј» рЈЁрЈЊ, рјцрјЕрЈЦрЈЇрјг, рЈЉрјЙрј┤рјб
­Ъїє	рјцрЈњрј»рЈ░рЈ▒, рјдрјФрј▓рјбрјцрЈЎрЈбрЈњрјб рјцрЈњрј»рЈ░рЈ▒, рјдрЈЎрјб рјцрЈЇрЈЏрјб, рјдрЈџрј▓рјб, рЈЁрЈЊ рјбрјд рјАрј», рЈњрј»рЈ░рЈ▒
­ЪїЄ	рјцрЈњрј»рЈ░рЈ▒, рјцрЈЋрјхрјгрјб, рЈЁрЈЊ рјбрјд рЈЏрј»
­ЪїЅ	рјарЈњрЈбрјб, рјарЈњрЈбрјб рјцрЈњрјб, рјцрЈњрјб
­Ъїї	рјцрЈЪрЈЁрЈЏрјб, рЈЃрЈѕрЈЈ рЈѓрЈџрЈЇрЈЌрЈЊрЈЁ
­Ъја	рјарЈЋрЈ▓рј», рјарЈЋрЈ▓рј» рЈљрЈѕрјх, рЈљрЈѕрјх
­ЪјА	рјарЈ░рјхрјб рјцрЈЂрЈЊрЈЇрЈЌрјб, рјдрЈєрЈў, рЈЋрјдрЈљрјгрјб, рЈЦрЈ│рЈЊрЈћрјИ рјдрЈєрЈЎрЈЌ
­Ъјб	рјарЈЊрЈљрЈєрј┤рЈ▒, рјарЈЏрЈЪрЈњрјб, рјарЈ░рјхрјб рјцрЈЂрЈЊрЈЇрЈЌрјб, рЈџрјерЈЊрјхрЈЇрЈЏ рјарЈдрЈЎрЈЌ
­Ъњѕ	рјарЈЦрЈЇрЈЎрЈ░рјЦрјб, рјерЈЏрјб, рЈЌрЈЊрЈЇрЈЎрЈ░рЈЇрјЕ, рЈЌрЈЊрЈЇрЈЎрЈ░рЈЇрјЕ рјерЈЏрјб
­Ъјф	рјарјЙрЈЏрЈЂрјхрЈЇрјЕ, рјарјЙрЈЏрЈЂрјхрЈЇрјЕ рјцрјЙрјхрЈдрЈЏрјб, рјцрјЙрјхрЈдрЈЏрјб
­Ъџѓ	рјарЈћрјХрј┤рјгрјб, рјарЈЦрј│ рЈЁрЈЃрј», рјфрЈЌрјб, рЈЌрјдрЈБрЈёрј│
­ЪџЃ	рјарјЙрјдрјхрЈЇрјЕ, рјарЈЦрј│ рЈЁрЈЃрј», рјцрјЙрЈдрЈЌрјб, рЈЌрјдрЈБрЈёрј│, рЈЌрјдрЈБрЈёрј│ рЈЎрј┤рј│, рЈЎрЈєрј┤рј│
­Ъџё	рјарЈЦрј│ рЈЁрЈЃрј», рјдрЈБрЈёрјх, рјдрЈБрЈёрјх-рјарЈЦрј│рЈЌрј«рјЕ рЈЌрјдрЈБрЈёрјх, рЈЌрјдрЈБрЈёрјх
­ЪџЁ	рјарЈЦрј│ рЈЁрЈЃрј», рјдрЈѓ, рјдрЈѓ рЈЌрјдрЈБрЈёрјх, рјдрЈБрЈёрјх, рЈЌрјдрЈБрЈёрјх
­Ъџє	рјарЈЦрј│ рЈЁрЈЃрј», рЈЌрјдрЈБрЈёрјх
­Ъџѕ	рјарЈЦрј│ рЈЁрЈЃрј», рјдрЈјрјД рЈЌрЈљрЈ▓
­ЪџЅ	рјарЈЊрЈЂрјИ, рјарЈЦрј│ рЈЁрЈЃрј», рЈЌрјдрЈБрЈёрјх
­Ъџі	рЈЌрјдрЈБрЈёрјх рјдрЈџрј▓, рЈ┤рЈФ рЈЌрЈўрЈѓрЈЎ рЈЎрј┤рј│
­ЪџЮ	рЈЇрЈїрЈі рјдрЈЁрЈЁ рЈЦрЈ┤, рЈЎрЈєрј┤рјх
­Ъџъ	рјарЈЦрј│ рЈЁрЈЃрј», рјБрЈЊрјИ рјдрЈЦрЈёрјх рјцрјХрј»рЈЇрЈЌ, рЈЎрЈєрј┤рјх, рЈџрЈЁрЈЊрЈбрјб
­ЪџІ	рјцрјЙрЈдрЈЎрЈЌ, рЈЎрЈєрј┤рј│ рЈ┤рЈФ рЈЌрЈўрЈѓрЈЎрј», рЈЎрЈєрј┤рјх
­Ъџї	рЈЌрјЙрЈЋрјХрЈєрЈЇрјЕ рјцрјЙрЈдрЈЎрЈЌ, рЈЎрЈєрј┤рјх
­Ъџј	рјцрјЙрЈдрЈЎрЈЌ, рЈЌрјЙрЈЋрјХрЈєрЈЇрјЕ рјцрјЙрЈдрЈЎрЈЌ, рЈЎрЈєрј┤рјх, рЈ┤рЈФ рЈЌрЈўрЈѓрЈЎ рЈЎрј┤рј│
­Ъџљ	рјцрЈЇрЈЌ рЈЎрј┤рј│ рЈ┤рЈФ рЈЌрЈўрЈѓрЈЎрј», рЈЌрјЙрЈЋрјХрЈєрЈЇрјЕ рјцрјЙрЈдрЈЎрЈЌ
­Ъџњ	рјарЈЦрј│, рјарЈЦрј│ рјарЈЦрјИ рјарЈѓрјЕрЈЇрјЕ, рјарЈдрЈЎрЈЌ, рјфрЈЌрјб
­ЪџЊ	рјцрјдрЈЏрЈѓрЈЎрј▓рјб, рЈЌрЈЊрЈѓрјЕрЈЇрјЕ рЈЎрј┤рј│, рЈЌрЈЊрЈѓрЈ▒рЈЇрјЕ, рЈЎрЈєрј┤рјх
­ЪџЋ	рјарЈЊрЈБрЈЂрЈЌ, рЈЎрЈєрј┤рјх
­Ъџќ	рјарЈѕрЈЌ рјарЈдрЈЎрЈЌ, рЈѓрЈЊрЈ│рЈЇрЈЌрЈЏ, рЈѓрЈЊрЈ│рЈЇрЈЌрЈЏ рјарЈѕрЈЌ рјарЈдрЈЎрЈЌ
­ЪџЌ	рЈЌрјдрЈџрј┤рјЙ, рЈЎрЈєрј┤рјх
­ЪџЎ	рјарј│рЈЇрјдрјхрЈЌ рјгрЈЎрЈЌ рЈЎрј┤рј│, рјарјЙрЈЂрЈдрЈЇрјЕ рјцрјЙрЈћрЈѓрЈЊрЈЇрЈЌ, рјцрјЙрЈЏрЈЂрјхрЈЊрЈЇрЈЌрјб
­Ъџџ	рјдрЈЁрЈћрЈѓрЈЎрј», рјдрЈЁрЈћрЈѓрЈЎрј» рЈЎрЈєрј┤рји, рЈЎрЈєрј┤рји
­ЪџЏ	рјцрјЙрЈдрЈЎрЈЌ, рјцрЈћрјЙ рјцрјЙрЈдрЈЎрЈЌ, рјИрЈЂрјбрЈЇрЈћрЈЁ рЈЎрЈєрј┤рји
­Ъџю	рЈЌрјдрЈЊрјирјЕрЈЇрјЕ рЈЎрЈєрј┤рј│, рЈЎрЈєрј┤рјх
­ЪЏ┤	рјарјЕрјИрЈЎрЈЌ, рјдрЈ»рЈѓрЈќрЈЇрЈЌ, рјдрЈ»рЈѓрЈќрЈЇрЈЌ рјарјЕрјИрЈЎрЈЌ
­ЪЏ╣	рјарјхрЈ▓рЈЎрЈЌ рЈ»рЈќрјЙ, рЈ»рЈќрјЙ
­ЪЏх	рЈћрјх, рЈћрјх рЈЌрјдрЈЕрЈў, рЈЌрјдрЈЕрЈў
­ЪџЈ	рјГрј┤рЈФрЈЇрЈЊ, рЈЌрјЙрЈЋрјХрЈєрЈЇрјЕ рјцрјЙрЈдрЈЎрЈЌ, рЈЌрјЙрЈЋрјХрЈєрЈЇрјЕ рјцрјЙрЈдрЈЎрЈЌ рЈДрј┤рЈФрЈЇрЈЎрЈЌ, рЈЎрЈєрј┤рјх рЈДрј┤рЈФрЈЇрЈЎрЈЌ
­Ъџе	рјарјХрЈ▓рј», рјарЈЇрЈЊрЈЕрЈЏрЈЇрЈЌ, рјарЈерЈЇрЈЌ, рЈЌрЈЊрЈѓрјЕрЈЇрјЕ рЈЎрј┤рј│ рјарЈерЈЇрЈЌ, рЈЌрЈЊрЈѓрЈ▒рЈЇрјЕ, рЈЎрЈєрј┤рји
­ЪџЦ	рјарЈерЈЇрЈЌ, рЈїрЈЅ, рЈЎрЈєрј┤рји рЈЊрјбрЈњрјб, рЈЦрЈ▒ рЈёрЈЇрЈЌрЈЊрЈЁ рјарЈерЈЇрЈЌ
­Ъџд	рјарЈерЈЇрЈЌ, рЈїрЈЅ, рЈЎрЈєрј┤рји рЈЊрјбрЈњрјб, рЈЦрЈ│рјфрЈЌ рЈЎрј┤рј│ рЈЌрЈерЈЇрЈЊрЈЂрј»
­ЪЏЉ	рјарј┤рЈФрЈЇрЈЎрЈЌ, рјфрЈфрјИрјб, рјГрј┤рЈФрЈЇрЈЊ, рЈДрЈЂрј│ рЈДрЈЁрЈЈрЈ»
­ЪџД	рјарЈљрЈ┤рјб, рЈЌрЈЂрЈЇрјерЈЇрјЕ
­ЪЏХ	рјарј╣ рЈЦрЈ│, рЈЦрЈ│
­Ъџц	рјдрЈ│рЈёрј│ рЈЦрЈ│, рЈЦрЈ│
­Ъџб	рјАрЈє рЈЦрЈ│, рЈЦрЈ│, рЈ┤рЈФ рјарЈБрЈЇрјЕ
­ЪЏФ	рјарЈѓрјЕрЈЇрЈЌрјб, рјбрЈ┤рјб-рЈЕрЈ┤рЈЇрЈЌрјб, рЈЊрЈѓрјЕрЈЇрјгрјб, рЈЦрЈ│ рјдрЈЃрј»рјхрЈЎрј», рЈЦрЈ│ рјдрЈЃрј»рјхрЈЎрј» рјцрЈѓрјЕрЈЇрЈЌрјб
­ЪЏг	рјдрјирјгрјб, рЈЊрЈЌрЈЦрјбрј▓рјб, рЈЦрЈ│ рјдрЈЃрј»рјхрЈЎрј», рЈЦрЈ│ рјдрЈЃрј»рјхрЈЎрј» рјдрјирјгрјб, рЈФрЈЌрјдрјирјЕ
­Ъњ║	рјдрЈЇрјЕрјХ, рЈ┤рЈФ рјдрЈЇрјЕрјХ
­ЪџЂ	рјдрјИрјАрЈЌ рјгрЈў рјарјхрЈ▓рјирјЕрЈЇрјЕ, рЈЎрЈєрј┤рјх
­ЪџЪ	рјарЈЦрј│ рЈЁрЈЃрј», рјдрјИрј│рЈЌ рЈЋрјдрЈЁрЈЁрјб, рјдрјИрј│рЈЌ рЈЋрјдрЈЁрЈЁрјб рјарјдрј│ рЈЁрЈЃрј»
­Ъџа	рјБрЈЊрјИ рЈЎрј┤рј│ рјарЈЈрј│рЈЏрјб, рјцрјГрјерЈЌ рјцрЈ»рЈЁ, рјцрЈЁрЈЊрЈб, рјдрјЙрЈЎрј│
­ЪџА	рјцрЈ»рЈЁрјб рЈЋрјФрЈЊрјИ рјдрјИрј│рЈЌ рјцрјЙрЈдрЈЎрЈЌ, рјдрјИрј│рЈЌ, рјдрјИрј│рЈЌ рјцрјЙрЈдрЈЎрЈЌ, рјдрЈЁрЈЊрјИ, рЈЎрЈєрј┤рји, рЈДрјЙрЈЊрЈЋрЈњрЈЌ
­Ъџђ	рјцрЈЪрЈЁрЈЏрјб, рјдрјИрј│рЈЌ рјАрЈЎрј» рЈЦрЈ│
­ЪЏИ	рјдрЈЃрј»рјхрЈЎрј» рЈќрјхрЈЎ, рјфрЈЪрЈЇрЈЌ рЈѓрјерЈњрјЙ рјдрЈЃрј»рјхрЈЎрј»
­ЪД│	рјАрЈЎрјхрЈЊрЈЇрЈЌ, рјдрЈЄрЈЁрЈЇрјг, рЈЌрјЙрЈг рЈЌрјдрјИрЈЎрЈЌ
РЈ░	рјарЈЊрЈ▒рЈЌрЈЇрЈЎрЈЌ, рјарЈЊрЈ▒рЈЌрЈЇрЈЎрЈЌ рЈЕрЈЦ, рЈЕрЈЦ
­ЪЋД	12, 12:30, 30, рЈћрјхрЈџ, рЈћрјхрЈџ-рЈдрЈЇрјфрј», рЈдрЈЇрјф, рЈЕрЈЦ
­ЪЋю	1, 1:30, 30, рЈїрЈЅ, рЈїрЈЅ-рЈдрЈЇрјфрј», рЈдрЈЇрјфрј», рЈЕрЈЦ
­ЪЋЮ	2, 2:30, 30, рЈћрјх, рЈћрјх-рЈдрЈЇрјфрј», рЈдрЈЇрјф, рЈЕрЈЦ
­ЪЋъ	3, 30, 3:30, рЈдрјб, рЈдрјб-рЈдрЈЇрјфрј», рЈдрЈЇрјф, рЈЕрЈЦ
­ЪЋЪ	30, 4, 4:30, рЈЁрјЕ, рЈЁрјЕ-рЈдрЈЇрјфрј», рЈдрЈЇрјфрј», рЈЕрЈЦ
­ЪЋа	30, 5, 5:30, рј»рЈЇрјЕ, рј»рЈЇрјЕ-рЈдрЈЇрјфрј», рЈдрЈЇрјфрј», рЈЕрЈЦ
­ЪЋА	30, 6, 6:30, рЈЉрЈЊрјх, рЈЉрЈЊрјх-рЈдрЈЇрјфрј», рЈдрЈЇрјфрј», рЈЕрЈЦ
­ЪЋб	30, 7, 7:30, рјдрјхрЈЅрјЕ, рјдрјхрЈЅрјЕ-рЈдрЈЇрјфрј», рЈдрЈЇрјфрј», рЈЕрЈЦ
­ЪЋБ	30, 8, 8:30, рЈдрЈЇрјфрј», рЈДрЈЂрј│, рЈДрЈЂрј│-рЈдрЈЇрјфрј», рЈЕрЈЦ
­ЪЋц	30, 9, 9:30, рЈљрЈЂрј│, рЈљрЈЂрј│-рЈдрЈЇрјфрј», рЈдрЈЇрјфрј», рЈЕрЈЦ
­ЪЋЦ	10, 10:30, 30, рЈЇрјфрј», рЈЇрјфрј»-рЈдрЈЇрјфрј», рЈдрЈЇрјфрј», рЈЕрЈЦ
­ЪЋд	11, 11:30, 30, рЈїрЈџ, рЈїрЈџ-рЈдрЈЇрјфрј», рЈдрЈЇрјфрј», рЈЕрЈЦ
­ЪїЉ	рјбрЈц рЈЁрЈЊ рјцрЈњрјб рјАрј», рјцрјхрЈЈрјЕ, рЈЁрЈЊ рјцрЈњрјб рјАрј»
­Ъїњ	рјарЈ▓рјХрјд рјарјдрЈЇрјдрЈѓ, рјбрЈц рЈЁрЈЊ, рјБрЈѓ рЈБрјбрЈљ рјбрЈц рЈЁрЈЊ, рЈЁрЈЊ
­ЪїЊ	рјЕрЈёрјЕрЈЌ, рЈЁрЈЊ рјцрЈњ рЈЏрј», рЈњрЈЃрЈ▒ рјАрј» рЈЁрЈЊ рјбрјгрЈ▒рЈ▒ рјЕрЈёрЈЌ рјДрјИрјб
­Ъїћ	рјарјдрЈўрЈЈ рјарЈ▓рјХрјд, рјбрЈц рЈЁрЈЊ, рЈЁрЈЊ, рЈб рЈдрјб рјЕрЈёрјЕрЈЌ рЈЁрЈЊ
­Ъїќ	рјарјдрЈўрЈЈ рјарЈ▓рјХрјд, рјарЈ▓рјХрјд, рјЕрЈёрјЕрЈЌ рјарЈЪрјхрЈњ рЈЁрЈЊ рјарјдрјхрј▓рјб, рЈЁрЈЊ
­ЪїЌ	рјБрЈѓрјб рјЕрЈёрјЕрЈЌ рјцрЈњрјб рјАрј» рЈЁрЈЊ, рјЕрЈёрјЕрЈЌ, рЈЁрЈЊ рјцрЈњ рЈЏрј»
­Ъїў	рјарјдрЈЇрјдрЈѓрЈЌрЈю рЈЁрЈЊ рјарјдрјхрј▓рјб, рјарЈ▓рјХрјд рјарјдрЈўрЈЈ, рјбрЈц рЈЁрЈЊ, рЈЁрЈЊ
­ЪїЎ	рјбрЈц, рјбрЈц рЈЁрЈЊ, рЈЁрЈЊ
­Ъїџ	рјбрЈц рЈЁрЈЊ рјцрјДрЈЏ, рјцрјДрЈЏ, рЈЁрЈЊ рјцрЈњ рјАрј»
­ЪїЏ	рјцрјДрЈЏ, рјЕрЈёрјЕрЈЌ, рЈЁрЈЊ рјцрЈњ рјАрј», рЈњрЈЃрЈ▒ рјАрј» рЈЁрЈЊ рјбрјгрЈ▒рЈ▒ рјЕрЈёрЈЌ рјДрјИрјб рјцрЈарЈ»рЈЇрЈЌ рјцрјДрЈЏ
­ЪїЮ	рјбрјдрј», рјцрјДрЈЏ, рјцрЈЊ рјДрјхрјб рјцрЈарЈ»рЈЇрЈЌ рјцрјДрЈЏ, рјДрјх, рЈЁрЈЊ рјцрЈњ рјАрј»
­Ъїъ	рјбрјдрј», рјцрјДрЈЏ, рЈЁрЈЊ рјбрјд рјАрј», рЈЁрЈЊ рјцрјДрЈЊ
­ЪїЪ	рјарЈћрЈЁрјЕрја, рјарЈЦрЈЇрЈЊрјирјЕрја, рјарЈЦрЈЇрЈЊрјирјЕрЈЇрјЕ, рјцрЈЦрЈЇрј│, рјцрЈЦрЈЇрЈЊрјирјЕрЈЇрјЕ рЈЃрЈѕрЈЈ, рЈЃрЈѕрЈЈ
­Ъїа	рјцрЈгрј░рЈњ, рјцрЈгрј░рЈњ рЈЃрјДрЈЈ, рјфрј░рЈЇрјгрјб, рЈЃрЈѕрЈЈ
­Ъїђ	рјарјдрјирјд рјАрЈє, рјарјдрјирјд рјцрЈЇрЈЌ, рјарјдрјирјд рјцрЈћрјЙ, рјцрјИрЈЋрј»рЈЊ
­Ъїѕ	рјарјдрЈЇрјЕ, рјцрЈЃрЈЅрј│рЈЏ
­Ъїѓ	рјарјдрЈЇрјЕ, рјарЈЇрЈџрЈЁ рјарЈЊрЈЕрЈЌрЈЇрЈЎрЈЌ, рјарЈЊрЈЕрЈЌрЈЇрЈЎрЈЌ, рЈЌрј┐рЈгрЈЇрЈЌ
­ЪћЦ	рјарЈЊрЈфрј│рјЕрј▓рјб, рјарЈЦрј│, рјгрЈћрЈѓрЈЊрЈЇрЈЌ
­ЪњД	рјарјх, рјцрЈЕрЈгрЈе, рјцрЈгрЈЪрЈЌ, рјцрЈ┤рЈю, рјфрј░рЈЁрЈЎрЈЌ
­Ъїі	рјарј╣, рјарј╣ рјцрЈћрјЙ рјарЈќрјИрЈЊ, рјарј╣ рЈЊрјхрЈЇрЈЌрј│рЈЂрјг, рјарј║рЈЅрјб
­ЪјЃ	рјарјЙрјхрј«рјхрјгрјб, рјарЈерЈЇрЈЌ, рЈцрјЕ, рЈцрјЕ-рјарЈерЈЇрЈЌ, рЈДрјЙрјхрјгрЈџрјХрЈЌрјб рјцрЈњ
­Ъјё	рјарјЙрјхрј«рјхрјгрјб, рјбрЈАрјгрјб, рЈЊрЈѓрЈЇрЈЊрЈ▓рј»рј▓рјб, рЈЊрЈѓрЈЇрЈЊрЈ▓рј»рј▓рјб рјбрЈАрјгрјб
­Ъјє	рјарјЙрјхрј«рјхрјгрјб, рЈЌрЈћрЈЇрјЕрЈЇрјЕ
­ЪјЄ	рјарјЙрјхрј«рјхрјгрјб, рјарЈЦрЈЇрЈЊрјирјЕрЈЇрјЕ, рјцрЈЦрЈЇрЈЊрјирјЕрЈЇрјЕ, рЈЌрЈћрЈЇрјЕрЈЇрјЕ
­ЪДе	рјарЈћрЈЇрјЕрЈЇрЈЌ, рјарЈћрЈЇрјЕрЈЇрЈЎрЈЌ, рЈЌрЈћрЈЇрјЕрЈЇрјЕ, рЈЌрЈћрЈЇрјЕрЈЇрЈЎрЈЌ
Рюе	рјцрЈЦрЈЇрЈЊрјирјЕрЈЇрјЕ, рЈЃрЈѕрЈЈ, рЈЌрЈЦрЈЇрЈЊрјирјЕрЈЇрјЕ
­Ъјѕ	рјарјЙрјхрј«рјхрјгрјб, рјцрЈЃрјИрјарЈ▓рЈЎрЈЌ
­ЪјЅ	рјарјхрЈЇрЈєрјхрЈЇрјЕ рјарЈ▓рЈЇрЈЌрЈЇрјЕ, рјарјЙрјхрј«рјхрјгрјб, рјарјЙрјхрј«рјхрЈЇрЈЌрЈЇрјгрјб, рјарЈћрЈЇрјЕрЈЇрЈЎрЈЌ, рЈћрЈЊ
­Ъјі	рјарјхрјфрЈЏрЈЇрјЕ рјфрЈфрјх рЈЇрЈєрЈърЈЇрЈЌ, рјарјЙрјхрј«рјхрЈЇрЈЌрЈЇрјгрјб, рјцрјхрјфрЈЏрЈЁрјб рјфрЈфрјх, рЈЇрЈєрЈърЈЇрЈЌ
­ЪјІ	рјарјхрј«рјхрЈЇрЈЎрЈЌ рјбрјхрјгрјб, рјарјЙрјхрј«рјхрЈЇрЈЌрЈЇрјгрјб, рјбрЈАрјгрјб, рјдрЈЊрЈЌ, рЈБрЈЕрЈѓрЈЈ
­ЪјЇ	рјарјЙрјхрј«рјхрЈЇрЈЌрЈЇрјгрјб, рјбрј»рЈ▒ рјцрЈћрјЙ, рЈЃрЈБ рјарЈгрЈџрЈЇрЈЊрЈЁ, рЈЃрЈЦ, рЈБрЈЕрЈѓрЈЈ
­Ъјј	рјарјЙрјхрј«рјхрЈЇрЈЌрЈЇрјгрјб, рјарЈЂрЈЪрЈЌ, рјарЈЇрЈєрјхрЈЇрјг, рЈБрЈЕрЈѓрЈЈ, рЈБрЈЕрЈѓрЈЈ рЈЌрЈЂрЈЪрЈЎрЈЌ
­ЪјЈ	рјарЈБрЈЌ, рјарЈБрЈЌ рЈЌрЈЪрјХрЈЇрЈћрЈЁ рјдрЈЊрЈў рјарЈЄрЈАрЈЇрЈЌ, рјдрЈЊрЈў, рЈЌрЈЪрјХрЈЇрЈћрЈЁ
­Ъјљ	рјарјЙрјхрј«рјхрЈЇрЈЌрЈЇрјгрјб, рјцрјГрјИрЈЕрЈѓ, рјцрЈЃрј┤, рјцрЈЃрЈ┤рјЕ, рјдрЈЃрјИрЈЇрјг рЈДрЈЃрЈЪрЈЇрЈЌ
­ЪјЉ	рјарјЙрјхрј«рјхрЈЇрЈЌрЈЇрјгрјб, рЈЁрЈЊ, рЈЁрЈЊ рјарјфрЈЕрЈЏрЈЌ рЈЊрЈѓрј│рЈФрјгрјб, рЈЊрЈѓрј│рЈФрјгрјб
­ЪДД	рјарЈЊрЈЂрЈЌ, рјарЈЋрј│, рјБрЈЇрЈЊ рјцрЈЊрЈЮрЈЦрЈЌ, рјЕрјдрје рјдрјИрЈЎрЈЌ рјарЈЋрј│, рјЕрјдрје рјфрЈфрјх рјарЈЇрЈџрЈЎрЈЌ
­Ъјђ	рјарјЙрјхрј«рјхрЈЇрЈЌрЈЇрјгрјб, рјарЈЄрјирЈЇрЈЌ
­ЪјЂ	рјарјЙрјхрј«рјхрЈЇрЈЌрЈЇрјгрјб, рјарЈЊрЈЂрЈЌ, рјдрЈЄрЈѓрЈЊрЈЁ рјарЈЊрЈЂрЈЌ, рјдрЈЄрЈЁрЈЁрјб, рјДрЈЂрЈїрјб
­ЪјФ	рјарЈѕрЈ┤рЈЎрЈЌ, рјфрЈфрј│ рјарЈ┤рЈЇрЈЎрЈЌ
­ЪЈЁ	рјарј│рЈЇрјдрјИрЈЊ рјарЈЊрЈњрЈЁ, рЈћрјирјЕрЈЇрјЕ
­ЪЦЄ	рјарЈћрјирјЕрЈЇрјЕ, рјарЈЋрј│ рЈЊрјХрЈѓрје, рјбрјгрЈ▒рјб рјцрЈЊрЈњрЈЁрјб рЈћрјирјЕрЈЇрјЕ, рјбрјгрЈ▒рЈ▒
­ЪЦѕ	рјарЈћрјирјЕрЈЇрјЕ, рјарЈЋрј│ рјцрЈЂрјд, рЈћрјхрЈЂ, рЈћрјхрЈЂ рјцрЈЊрЈњрЈЁрјб рЈћрјирјЕрЈЇрјЕ
­ЪЦЅ	рјарЈћрјирјЕрЈЇрјЕ, рЈБрЈ▒, рЈдрјбрЈЂ рјцрЈЊрЈњрЈЁрјб рЈћрјирјЕрЈЇрјЕ, рЈдрЈЂрјб
­ЪЦј	рјарјхрЈ░рЈЉрјХ, рјарЈЇрЈєрЈърЈЇрЈЌ, рјцрЈ»рЈФрЈЇрјгрјб, рЈЕрјЙрјерЈЇрЈєрЈърЈЇрЈЌ
­ЪЈђ	рјдрЈљрЈєрјИ, рЈЇрЈєрЈърЈЇрЈЌ, рЈћрјирЈБ рЈЇрЈєрЈърЈЇрЈЌ
­ЪЈљ	рЈЇрЈєрЈърЈЇрЈЌ, рЈЇрЈєрЈърЈЇрЈЌ рјдрЈїрЈЏрЈѓрЈЇрЈЊ, рЈЌрЈЂрЈЪрЈЎрЈЌ
­ЪЈѕ	рјарј║рјхрјД, рјарј║рјхрјД рЈЇрЈєрЈърЈЇрЈЌ рјарјЙрЈ»рЈќрЈЇрјЕ, рЈЇрЈєрЈърЈЇрЈЌ, рЈЇрЈєрЈърЈЇрЈЌ рјарЈ»рЈѓрЈќрЈЇрЈЌ
­ЪЈЅ	рјарјЙрЈ»рЈѓрЈќрЈЇрјЕ рЈЇрЈєрЈърЈЇрЈЌ, рјарЈ▒рЈЊрЈЇрЈЌ рЈЇрЈєрЈърЈЇрЈЌ, рЈЇрЈєрЈърЈЇрЈЌ
­ЪјЙ	рјарЈЇрЈЏрЈѓрЈЇрЈЌ, рЈЇрЈєрЈърЈЇрЈЌ, рЈЕрјЙ рЈЇрЈєрЈърЈЇрЈЌ рјфрЈЇрЈЏрЈѓрЈЇрЈЎрЈЌ
­ЪЦЈ	рјарЈарЈЌ рјдрЈЃрј»рјхрЈЎрј», рјдрјХрЈњрЈЇрЈћрЈЁ
­Ъј│	рјарјхрЈљрЈєрј┤рЈ▒рЈЇрЈЌ, рЈЇрЈєрј┤рЈЇрЈЌ, рЈЌрЈЂрЈЪрЈЎрЈЌ
­ЪЈЈ	рјфрЈЇрЈЏрЈѓрЈЇрЈЌ, рЈЇрЈєрј┤рЈЇрЈЌ, рЈћрј│рЈџ рЈЌрЈЂрЈЪрЈЎрЈЌ, рЈЌрЈЂрЈЪрЈЎрЈЌ
­ЪЈЉ	рјдрЈЁрЈЇрЈЊ, рјГрјЕ, рЈЇрЈєрЈърЈЇрЈЌ, рЈЌрЈЂрЈЪрЈЎрЈЌ, рЈарјерЈЈ, рЈарјерЈЈ рјарј│рЈЇрјДрјхрЈЊ
­ЪЈњ	рјцрЈЂрЈЇрЈЊрј│, рјцрЈЂрЈЇрЈЊрјИрјб рјарЈЂрЈдрЈЌ, рјдрЈЁрЈЇрЈЊ, рјГрјЕ, рЈІрјЕ, рЈЌрЈЂрЈЪрЈЎрЈЌ
­ЪЦЇ	рјарј│рЈЇрјдрјхрЈЎрЈЌ, рјарј│рЈЇрјдрјХрЈЌ, рјарЈЂрЈдрЈЊ, рЈЕрјхрЈљрЈЇрЈЎрЈЌ
­ЪЈЊ	рјдрјдрЈфрЈЇрЈЎрЈЌ, рјдрЈЇрјЕрјХрјЕ рЈЇрЈєрЈърЈЇрЈЌ, рјфрЈЇрЈЏрЈѓрЈЇрЈЌ, рјгрЈѓрјхрЈЊрЈЇрЈЌ рјцрЈЊрЈїрјД рЈЇрЈєрЈърЈЇрЈЌ, рЈЇрЈєрЈърЈЇрЈЌ, рЈЌрЈЂрЈЪрЈЎрЈЌ
­ЪЈИ	рјарЈЂрЈдрЈЌ, рјарЈдрЈЎрЈЌ, рјцрјЙрЈЊрЈЃрЈЪрЈЇрЈЏрјб, рЈЌрЈЂрЈЪрЈЎрЈЌ, рЈЦрЈЇрЈєрЈ»
­ЪЦі	рјцрјЙрјхрЈ░рЈЉрјХ, рЈЌрјЙрЈЊрЈЏрЈѓ, рЈЌрјЙрЈЊрЈЏрЈѓ рјцрјЙрјхрЈ░рЈЉрјХ
­ЪЦІ	рјДрЈЕрЈќ, рЈћрЈ▒рЈєрЈѓрЈЎ, рЈЌрјЙрЈг, рЈЌрЈЪрЈЎрЈЌ, рЈЌрЈЪрЈЎрЈЌ рЈЌрјЙрЈг, рЈДрЈЎ
­ЪЦЁ	рјарјдрЈ», рјарјдрЈ» рјирЈЌ, рјирЈЌ
­ЪјБ	рјарЈБрЈЌ, рЈЉрЈЌ
­Ъјй	рјарј┐рЈг, рјарЈЊрЈарЈЇрЈЌ, рјарЈЏрЈЪ, рјарЈЪ рјарјЙрЈг, рЈЌрЈЂрЈдрЈЌ
­Ъј┐	рјЦрЈЃрЈЦ, рЈЌрЈЪрјЙрЈњрЈЎрЈЌ, рЈЌрЈЪрјЙрЈњрЈЎрЈЌрЈЇрјЕ
­ЪЏи	рјарЈ▓рЈЪрЈЇрјЕ, рјдрЈЁрЈЕрјХрЈЇрЈЌ рјцрЈћрјЙ
­ЪЦї	рјцрЈЇрЈЌ рЈЁрЈ», рЈЁрЈ», рЈЌрЈЂрЈЪрЈЎрЈЌ
­Ъј»	рјарјдрЈў, рјгрЈѓрјЕ, рЈЌрЈ▓рЈЇрЈЌ, рЈЦрЈ│рјфрЈЌ рјгрЈѓрјИрјб, рЈДрјДрЈЁрЈЇрЈЋрјЙ, рЈЕрЈ▓рЈЇрЈЌ, рЈФрјгрЈѓрЈЇрЈЊ
­Ъј▒	8, 8 рјфрЈфрј│ рјдрЈЊрЈ▓рЈЇрЈЌ, 8 рЈЇрЈєрЈърЈЇрЈЌ, рјдрЈЊрЈ▓рЈЇрЈЌ, рЈЌрЈЂрЈЪрЈЎрЈЌ, рЈДрЈЂрј│
­Ъћ«	рјцрјИрЈїрЈЌ, рјцрјИрЈїрЈЌ рЈЇрЈєрЈърЈЇрЈЌ, рјЦрЈЊрЈЁрЈќрЈЇрјг рј░рЈЕрЈѓрјерЈњрјЙ, рјгрЈћрЈѓрЈЊрЈЇрЈЌ, рј░рЈЕрЈѓрјерЈњрјЙ, рЈЁрЈЕрЈЎрј»рЈ»рЈЊ, рЈЇрЈєрЈърЈЇрЈЌ
­ЪД┐	рјарјдрЈЎрјх рјбрЈ│рЈЇрЈЌ рјцрјдрЈјрЈЇрЈЌ, рјарјдрЈЎрјх рјбрЈ│рЈЇрЈЌ рјцрјдрЈјрЈЇрЈЌ рјарЈЋрј│рЈЌрЈБрЈЁрЈЎрЈЌ рјарјхрЈЇрјдрЈЇрЈЎрЈЌ, рјарЈЋрј│, рјБрЈЇрЈЏ рјарЈЊрЈЁрЈЊрЈЊ, рјцрЈљрЈЁрјб-рјарјдрЈЎрјх, рЈЁрЈ» рјарЈЊрЈфрј»
­Ъј░	рјарЈЋрј│ рјдрЈарЈЌ рјфрЈбрЈЇрјЕ, рјцрЈЪрЈЁрЈЏрјб, рЈЌрЈЂрЈЪрЈЎрЈЌ
­Ъј▓	рјарЈЂрЈЪрЈЎрЈЌ рјдрјхрЈгрјЕ, рјдрјхрЈгрјЕ, рЈЌрЈЂрЈЪрЈЎрЈЌ, рЈДрјфрј│
­ЪДЕ	рјарјгрјГрјИрЈЊ, рјарЈЊрЈјрј«, рјцрЈЇрЈєрЈѓрјфрЈцрјб, рЈЏрјхрјфрј▓рЈЇрЈЌрЈЇрјг, рЈЦрјЕрЈї
­ЪДИ	рјцрЈфрјЙрјб, рјдрјИрЈЏрјб, рЈќрЈЌ рЈ▓рјЙ, рЈЌрЈѓрЈ▓рјх рЈДрјЙрЈЂрјИрЈЎрЈЌ, рЈДрЈЊрј┤рЈЁрЈЊ рЈЌрЈЂрјИрЈЎрЈЌ
­ЪЃЈ	рјарЈєрЈѓрЈ▓рЈЇрЈЌ, рјдрЈфрЈЪрЈЇрјЕ, рјерЈ»рЈћрј» рЈєрЈѓрЈ▓рЈЇрЈЌ, рЈЌрЈЂрЈЪрЈЎрЈЌ
­Ъј┤	рјцрЈЦрјИрЈЇрјЕ, рјцрЈЦрјИрЈЇрјЕ рЈЊрЈєрјЙрЈ▓рј»рјГ, рЈєрЈѓрЈ▓рЈЇрЈЌ, рЈЊрЈЂрјХрј▓рЈЇрјЕ, рЈЌрЈЂрЈЪрЈЎрЈЌ, рЈБрЈ▒рЈѓрЈЈ
­Ъје	рјцрЈфрЈў рјарЈЇрЈєрЈѓрјфрЈЏрјб, рЈЊрЈЉрЈФрЈЇрјгрјб, рЈЌрЈЉрЈФрЈЌрјЕ рЈ»рЈќрјЙ, рЈЌрЈЪрјХрЈЇрЈћрЈЁрјб
­ЪДх	рјарЈЇрЈў, рјарЈЇрЈў рјарЈЇрЈєрЈѓрјфрЈЌрЈЇрјЕ, рјдрЈ░рЈФрЈЇрјЕ, рЈ┤рјЕ
­ЪДХ	рјарЈЇрЈєрЈърЈЇрЈЌ, рјцрЈЕрЈѓ рјарЈЇрЈў, рјфрЈбрЈЁрЈЎрЈЌ рјцрЈЕрЈѓ рјарЈЇрЈў рјгрЈћрЈЁрјб, рјгрЈЌрЈ▒
­ЪћЄ	рјАрјХрЈфрјб, рјАрЈЮрЈф рЈѓрјгрЈЂрјИ, рЈЇрЈЊрЈ▒ рјцрЈЃрЈ┤рјЕ
­ЪћЅ	рјарЈ▓рЈЪрје, рјдрЈгрЈѓрЈЇрјЕ рјарЈ░рЈЪ рјарЈЇрЈЊрЈ▒рЈЌрЈЇрЈЌ
­Ъћі	рјдрЈгрЈѓрЈЇрјЕ рјдрјИрј│рЈЌ рјарЈЇрЈЊрЈ▒рЈЌрЈЇрЈЌ, рЈДрјхрЈЇрЈЎрЈЇрЈЌ
­ЪЊб	рјарЈ░рјх рјцрЈцрјх рјфрЈфрјх рЈДрЈЂрЈЇрЈЌ рЈЌрЈјрЈЇрЈЌ, рЈЌрјГрј│рЈЊ рјдрЈгрЈѓрЈЇрјЕ, рЈДрјхрЈЇрЈЎрЈЇрЈЌ
­ЪЊБ	рјцрЈЂрјирјгрјб, рЈЌрјГрј│рЈЎрЈЌ рЈФрјдрЈгрЈѓрЈЇрЈЎрЈЌ
­ЪЊ»	рјцрЈЎрЈбрЈњ, рјцрЈ▓рЈѓ, рјфрЈфрјх рЈДрЈѓрЈЇрЈџрјбрЈЇрЈЌ, рјфрЈфрјх рЈДрЈѓрЈЇрЈџрјбрЈЇрЈЌ рјцрЈ▓рјЙ
­Ъћћ	рјцрЈ»рјИрЈѓ
­ЪћЋ	рјАрјХрЈфрјб, рјбрЈ»рЈЏрЈЂрЈЌ рЈѓрјерЈњрјЙ, рјцрЈ»рјИрЈѓ, рјцрЈ»рјИрЈѓ рјЙрЈЇрјЕ рјгрЈЌ рјцрЈЂрЈЇрЈарјЦ, рјЦрЈЮ, рјгрЈЁрЈЇрЈЊ, рЈѓрјерЈњрјЙ
­Ъј╝	рјфрЈфрј│рЈЁ, рЈЌрјДрЈЃрјЕрЈЇрЈЌ, рЈЌрјДрЈЃрјЕрЈЊ рјфрЈфрј│рЈЁ
­Ъјх	рјцрЈЇрЈЌ рјфрЈфрјх, рЈЌрјДрЈЃрјЕрЈЇрЈЌ, рЈЌрјДрЈЃрјЕрЈЇрЈЎрЈЌ рјарЈЇрЈЊрЈФрЈЏрЈѓрЈЌ
­ЪјХ	рјцрЈЇрЈЌ рјфрЈфрјх, рЈЌрјДрЈЃрјЕрЈЇрЈЌ, рЈЌрјДрЈЃрјЕрЈЇрЈЎрЈЌ рЈЌрЈЇрЈЊрЈФрЈЏрЈѓрЈЌ, рЈДрЈЇрЈЌ рЈЌрјфрЈфрјх
­Ъјц	рјдрЈѓрЈ▒рЈЇрјЕ, рЈЊрЈѓрЈЃрјЕрЈЇрјг, рЈФрјдрЈгрЈѓрЈЇрЈЎрЈЌ
­Ъји	рјдрЈцрјирјЕрЈЇрЈЌ, рЈїрјдрјфрЈЂ, рЈЌрјДрЈЃрјЕрЈЇрЈЌ, рЈЌрјДрЈЃрјЕрЈЇрЈЎрЈЌ
­ЪјИ	рЈЌрјДрЈЃрјЕрЈЇрЈЌ, рЈЌрјДрЈЃрјЕрЈЇрЈЎрЈЌ, рЈЌрЈЄрЈёрјЕрЈЇрЈЌ
­Ъј╣	рЈЌрјДрЈЃрјЕрЈЇрјЕрЈЇрЈЌ, рЈЌрјДрЈЃрјЕрЈЇрЈЌ, рЈЌрјДрЈЃрјЕрЈЇрЈЎрЈЌ рЈЌрЈљрЈЁрЈЇрЈЎрЈЌ, рЈЌрЈљрЈЁрЈЇрЈЎрЈЌ, рЈЌрЈљрЈЁрЈЇрЈЎрЈЌ рјДрЈЃрјЕрЈЇрЈЌ
­Ъј║	рЈЌрјДрЈЃрјЕрЈЇрЈЌ, рЈЌрјДрЈЃрјЕрЈЇрЈЎрЈЌ, рЈбрЈЄрЈў
­Ъј╗	рјарЈ░рЈЪрЈ░рЈЌ, рЈЌрјДрЈЃрјЕрЈЇрЈЌ, рЈЌрјДрЈЃрјЕрЈЇрЈЎрЈЌ
­ЪЦЂ	рј▒рјх, рј▒рјх рјдрјИрЈѓрЈЇрЈЎрЈЌ, рЈЌрјДрЈЃрјЕрЈЇрЈЌ
­ЪЊ▒	рјарЈЊрЈЁрЈЈрЈЎрј», рЈЌрЈЪрЈЃрј«рЈЌ, рЈЌрЈЪрЈЃрјхрЈЌ рЈѓрЈЊрЈЈрј│рЈЏрјЙ, рЈЎрј┤рј│рЈі рЈЌрјхрЈЃрј«рЈЊ
­ЪЊ▓	рјарјЕрЈЇрјЕ, рјарЈЊрЈЁрЈЈрЈЎрј», рјдрЈЮрЈЌ, рЈЌрЈЪрЈЃрј«рЈЌ, рЈЌрЈЪрЈЃрј«рЈЌ рЈѓрЈЊрЈЈрј│рЈЏрјЙ, рЈЌрЈЪрЈЃрј«рЈЌрјб, рЈЎрј┤рј│рЈі рЈЌрјхрЈЃрј«рЈЊ рјцрјхрјфрЈЌ рјдрЈЪрЈЊ, рЈЕрЈЪрЈЃрј«рЈЌ
­ЪЊъ	рјарјЕрЈЈрЈЇрјЕ, рЈЌрјхрЈЃрј«рЈЌ рјдрЈгрЈѓрЈЇрЈЎрЈЌ, рЈЌрЈЪрЈЃрј«рЈЌрјб
­ЪЊа	рЈЌрЈЪрјХрЈЇрЈћрЈЁ рјфрЈфрјх, рЈЌрЈЪрјХрЈЇрЈћрЈЁ рјфрЈфрјх рЈФрјдрЈЁрјЦрЈЇрјЕ
­ЪћІ	рјарјЙрјдрјхрЈЇрјЕ
­Ъћї	рјарјЙрјдрјхрЈЇрјЕ, рјарјЙрјдрјхрЈЇрјЕ рЈЌрјдрјирјЕ, рјарјЙрјдрјхрЈЇрјЕ рЈЌрјФрЈЊрјИрЈЌ, рЈЌрјФрЈЊрјИрЈЌ
­Ъњй	рјарјдрЈЎрјЦрј»рЈЇрЈЌрЈЇрјЕ рјарЈЇрЈєрЈѓрјфрЈЌрЈЇрјЕ, рјарјдрЈЎрјЦрј»рЈЇрЈЌрЈЇрјЕ рјарЈЇрЈєрЈѓрјфрЈЌрЈЇрјЕ рјарЈарЈЌ, рјарјфрЈЕрЈЏрЈЌ, рјарЈарЈЌ, рјцрЈЇрЈЌ рјарЈарЈЌ
­ЪњЙ	рјарјдрЈЎрјЦрј»рЈЇрЈЌрЈЇрјЕ рјарЈЇрЈєрЈѓрјфрЈЌрЈЇрјЕ, рјарЈарЈЌ, рЈЕрЈѓрје, рЈЕрЈѓрје рјарЈарЈЌ
­ЪЊђ	blu-ray, dvd, рјарјдрЈЎрјЦрј»рЈЇрЈЌ рјарЈЇрЈєрЈѓрјфрЈЌрЈЇрјЕ, рјарјфрЈЕрЈЏрЈЌ, рјарЈарЈЌ
­ЪД«	рЈЌрЈјрј»рЈЇрЈЎрЈЌ, рЈЌрЈјрЈЇрЈЌ рЈЌрЈјрЈЇрЈЎрЈЌ
­ЪјЦ	рјарЈЌрЈ┤рј│рЈЏрЈЇрјЕ, рјарЈЌрЈ┤рј│рЈЏрЈЇрјЕ рЈЌрЈЊрЈЪрјХрЈЇрЈЌрЈЇрјЕ, рЈЌрЈЪрјХрЈЇрЈЌрЈЇрјЕ, рЈДрјЙрЈЌрЈ┤рј│рЈЎрЈЌ
­ЪЊИ	рјарЈЌрЈ┤рј│рЈЏрЈЇрјЕ, рјцрЈЦрЈЇрЈЊрјирјЕ, рЈЌрЈЊрЈЪрјХрЈЇрЈЎрЈЌ, рЈЌрЈЊрЈЪрјХрЈЇрЈЎрЈЌ рјцрЈЦрЈЇрЈЊрјирјЕ рјарЈЕрЈарЈ»рЈЇрЈЊ
­ЪЊ╝	vhs, рјдрЈарЈЌ, рјдрЈарЈЌ рЈЌрјДрЈЃрјЕрЈЇрјЕ, рЈЌрЈЊрЈ┤рј│рЈЏрЈЇрјЕ
­ЪћЇ	рјарјдрЈЇрјдрЈѓ рјарјдрЈЎрЈЌ рјарЈћрЈЃрј»рЈЇрЈЌрЈЇрјЕ рјцрјИрЈїрЈЌ, рјарЈћрЈЃрј»рЈЇрЈЌрЈЇрјЕ, рјарЈ▒рЈЇрЈЌрјб, рјцрјИрЈїрЈЌ, рјгрЈћрЈѓрЈЊрЈЇрЈЌ
­Ъћј	рјарјдрЈўрЈЈ рЈЕрЈјрј»рј▓ рјАрЈє рЈѓрјгрЈЂ рјФрјд, рјарЈћрЈЃрј»рЈЇрЈЌрЈЇрјЕ, рјарЈ▒рЈЇрЈЌрјб, рјцрјИрЈїрЈЌ, рјгрЈћрЈѓрЈЊрЈЇрЈЌ
­ЪњА	рјарЈЊрЈЁрЈќрЈб, рјарЈерЈЇрЈЌ, рјарЈерЈЇрЈЌ рјдрЈЌ, рјцрЈгрЈЪрЈЌ, рЈЌрјЙрјдрјхрЈЇрјЕ
­Ъћд	рјарјЙрјдрјхрЈЇрјЕ, рјарЈерЈЇрЈЌ, рјцрЈЇрЈЌ рјарЈерЈЇрЈЌ, рјгрЈћрЈѓрЈЊрЈЇрЈЌ
­ЪЈ«	рјарЈерЈЇрЈЌ, рјарЈерЈЇрЈЌ рјдрјфрЈЌ, рјдрјЙрјИ, рјЕрјдрје, рјЕрјдрје рјфрЈфрј│ рјарЈерЈЇрЈЌ
­ЪЊћ	рјфрЈфрјх, рјфрЈфрјх рјцрјхрјфрЈњ рЈЌрЈЪрјХрЈЇрЈЊрЈЁ рјФрЈбрЈЌ, рјфрЈфрјХрЈЌрјб рјфрЈфрјх, рјФрЈЮрјЦ, рЈЊрЈЪрјХрЈЇрЈЌрЈЊрЈЁрјб
­ЪЊЋ	рјарЈЇрЈџрјГ, рјарЈЇрЈџрј▓ рјфрЈфрјх, рјфрЈфрјх
­ЪЊќ	рјарЈЇрЈџрјбрЈЊ, рјфрЈфрјх, рј»рЈЇрЈџрјб рјфрЈфрјх рЈЌрјфрјхрЈ░рЈЌ
­ЪЊЌ	рјбрЈц рјбрЈ│рЈЇрЈЌ, рјбрЈцрЈ│рЈЇрЈЌ рЈЌрјфрЈфрјх, рјфрЈфрјх
­ЪЊў	рјфрЈфрјх, рЈїрјфрЈѓрје, рЈїрјфрЈѓрје рјфрЈфрјх
­ЪЊЎ	рјарЈЊрјХрЈѓрје, рјарЈЊрјХрЈѓрје рјфрЈфрјх рЈЌрјфрјхрЈ░рЈЎрЈЌ, рјфрЈфрјх
­ЪЊЊ	рјфрЈфрјх рЈЌрјфрЈфрјХрЈЎрЈЌ
­ЪЊњ	рјфрЈфрјх рјцрјГрјерЈЊ, рјфрЈфрјх рЈЌрјфрЈфрјХрЈЎрЈЌ
­ЪЊЃ	рјцрјдрЈЁрЈЊрЈЏ рјцрјхрјфрЈЌ рјцрјхрЈЦрЈЇрЈєрЈЂрЈЌ, рјцрјдрЈЁрЈЊрЈЏрјб, рјдрЈёрЈќрЈ▓рјИ, рјфрЈфрј│рЈЁрјб
­ЪЊю	рјдрЈЁрЈЇрјЕ, рјфрЈфрјх
­ЪЊё	рјцрјдрЈЁрЈЊрЈЏ рјцрјДрЈЏ рјдрјИрј│рЈЌ, рјцрјдрЈЁрЈЊрЈЏрјб, рјфрЈфрј│рЈЁрјб
­ЪЊ░	рјфрЈфрјх, рЈЌрјдрЈЃрЈБрј│рЈЁрјб
­ЪЌъ	рјдрЈљрЈєрј┤рЈбрјб, рјдрЈљрЈєрј┤рЈбрјб-рЈЌрјдрЈЃрЈБрј│рЈЁрјб рјфрЈфрјх, рјфрЈфрјх, рЈЌрјдрЈЃрЈБрј│рЈЁрјб, рЈЌрјдрЈЃрЈБрј│рЈЁрјбрјфрЈфрјх
­ЪЊЉ	рјцрЈЎрЈфрјИ, рјфрЈфрјхрјфрЈБрјИрЈЌ, рјфрЈфрјхрјфрЈБрјИрЈЌ рЈЌрјдрЈЌ, рЈЌрјдрЈЌ
­Ъћќ	рјфрЈфрј│рЈЁрј», рјфрЈфрјхрјфрЈБрјИрЈЌ
­Ъњ┤	рјарЈЋрј│, рјарЈЋрј│ рЈДрЈѓрЈЌрјб, рјцрјЙрЈЊрЈџрјг, рјцрЈЃрЈЇрЈЊ, рјфрЈфрјх, рЈцрЈѕрЈѓрЈЈ рЈЊрјхрјЕ рјарЈЌрЈћрЈЇрЈЌ
­Ъњх	рјарЈЋрј│, рјарЈЋрј│ рЈДрЈѓрЈЌрјб, рјцрјЙрЈЊрЈџрјг рјфрЈфрјх, рјцрЈЃрЈЇрЈЊ, рјцрЈЃрЈЇрЈЊ рјарЈЋрј│ рЈДрЈѓрЈЌрјб рјфрЈфрјх, рјцрЈЇрЈЌ рјфрЈфрјх, рјфрЈфрјх
­ЪњХ	рјарЈЋрј│, рјарЈЋрј│ рЈДрЈѓрЈЌрјб, рјцрјЙрЈЊрЈџрјг рјфрЈфрјх, рјцрЈЇрЈЌ рјфрЈфрјх, рјфрЈфрјх, рЈ│рј│рЈѕ рјфрЈфрјх рјарЈЋрјхрјб рјарЈЋрј│ рЈДрЈѓрЈЌ рЈЌрЈџрЈЊрјИрЈЎрЈЌ
­Ъњи	рјарЈЋрј│, рјарЈЋрј│ рјцрјЙрЈЊрЈџрјг рјфрЈфрјх, рјарЈЋрј│ рЈДрЈѓрЈЌрјб, рјцрјЙрЈЊрЈџрјг рјфрЈфрјх, рјцрЈЇрЈЌ рјфрЈфрјх, рјцрЈЊрјерЈЊ, рјфрЈфрјх
­ЪњИ	рјарЈЋрј│ рЈЌрјфрЈ»рЈЊ, рјарЈЋрј│ рЈДрЈѓрЈЌрјб, рјарЈЮрЈФрЈЊ, рјцрјЙрЈЊрЈџрјг рјфрЈфрјх, рјцрЈЃрЈЇрЈЊ, рјцрЈЇрЈЌ рјфрЈфрјх, рјфрЈфрјх, рЈЌрјфрЈ»рЈЌ
­ЪДЙ	рјарЈЋрј│ рЈЌрЈјрј»рј», рјбрјдрјб рјарјФрЈ┤рј▓рјб рјфрЈфрј│, рјфрј»рЈ│рЈћрЈЁрј», рјфрЈфрјх рЈЌрјдрЈўрЈЇрЈЌ, рЈЌрј│рЈЈрЈЎрЈЌ
­Ъњ╣	рјарјДрјхрЈЈрЈљрЈЌ рјфрЈфрјх, рјарјхрЈїрј│рЈЌрја, рјарЈЊрјЙрЈЁрјб, рјарЈЊрЈЁрЈЇрјгрјб, рјарЈЋрј│, рјарЈЋрј│ рЈДрЈѓрЈЌрјб, рјАрЈІрј»рЈЇрЈЌ, рјДрЈЃрј«рЈЊ рЈЊрЈЪрјХрЈЇрЈЏ рјДрЈЂрЈЅрјгрјб рЈ▒рЈѓ рјгрЈЌ, рЈЇрјИрј│рЈЌрјарјдрЈў, рЈДрЈЁрЈЈрЈ» рЈЌрјфрЈфрјх, рЈ▒рЈѓ
­Ъњ▒	рјарЈЋрј│, рјарЈЋрј│ рјдрЈЂрЈЪрЈ┤рЈЇрЈЌ, рјарЈЋрј│ рЈДрЈѓрЈЌ, рјдрЈЂрЈЪрЈ┤рЈЇрЈЌ
­Ъњ▓	рјарЈЋрј│, рјцрЈЃрЈЇрЈЌ, рјцрЈЊрјерЈЊ рјцрЈЃрЈЇрЈЌ рјфрЈфрјх
­ЪЊД	рјарјЙрјдрјхрЈЇрјЕ рјфрЈфрјх, рјарјЙрјдрјхрЈЇрјЕ рјфрЈфрјИ, рјфрЈфрјх, рЈЌрјфрЈфрјх
­ЪЊе	рјарјЙрјдрјхрЈЇрјЕ рјфрЈфрјх, рјдрјирјЕ рјфрЈфрјх рјдрјИрЈЎрЈЌ, рјдрЈЁрјЕрЈЇрЈЌ, рјфрЈфрјх рјдрјИрЈЎрЈЌ, рЈЌрјдрјирјЕ, рЈЌрјфрЈфрјх
­ЪЊЕ	рјарјЙрјдрјхрЈЇрјЕ рјфрЈфрјх, рјАрј│рЈЌ, рјдрЈЮрЈЌ, рјфрЈфрјх, рјфрЈфрјх рјарЈЇрЈџрЈЌ рјарЈарЈ»рЈЇрЈЌ рјдрЈЮрЈЌ, рјфрЈфрјх рјдрјИрЈЎрЈЌ, рЈЏрјдрЈїрЈЎрЈЇрјгрјб, рЈФрјдрЈЁрЈЁрјб
­ЪЊ«	рјфрЈфрјх, рјфрЈфрјх рјДрЈЂрЈї, рјфрЈфрјх рЈЌрјдрјИрЈЎрЈЌ рјДрЈЂрЈї
­ЪЊЮ	рЈЇрЈєрј│ рјфрЈфрј│рЈЁ, рЈЌрјфрЈфрјХрЈЎрЈЌ
­Ъњ╝	рјдрЈЁрЈћрЈЁрЈЎрЈЌ
­ЪЊЂ	рјарЈЇрЈєрЈѓрјфрЈЎрЈЌ, рјарЈЇрЈєрЈѓрјфрЈЎрЈЌ рЈЌрЈ┤рЈѕрЈЏрјЦрЈЇрјЕ, рЈЌрЈ┤рЈѕрЈЏрјЦрЈЇрјЕ
­ЪЊѓ	рјарЈЇрЈєрЈѓрјфрЈЏрјб, рјарЈЇрЈџрјбрЈЊ, рј»рЈЇрЈџрјб рјарЈЇрЈєрЈѓрјфрЈЎрЈЌ рјарЈ░рЈѕрЈЏрЈЇрјЕ, рЈЌрЈ┤рЈѕрЈЏрјЦрЈЇрјЕ
­ЪЊЁ	рјбрјфрј» рјарЈјрј»рј▓рјб, рЈЁрЈЊ рЈЌрЈјрЈЇрЈЌ
­ЪЊє	рјдрЈ»рј┤рЈЇрЈЌ-рЈЁрЈЊ рЈЌрЈјрЈЇрЈЌ, рЈЁрЈЊ рЈЌрЈјрЈЇрЈЌ
­ЪЊЄ	рјарЈЇрЈЊрЈЕрЈЏрЈЇрЈЌ, рЈєрЈѓрЈ▓рЈЇрЈЌ, рЈЌрјхрЈљрЈєрј┤рј»рјГ рЈЌрјфрЈфрјх, рЈЌрЈєрЈѓрЈ▓рЈЇрЈЌ рјарЈЇрЈЊрЈЕрЈЏрЈЇрЈЌ
­ЪЊѕ	рјцрЈфрЈІрЈњрјб, рјдрјхрјдрј│, рјдрјИрј│рЈЊрјдрЈў, рјДрЈЃрј«рЈЊ рЈЊрЈЪрјХрЈЇрЈЏ, рјДрЈЃрј«рЈЊ рЈЊрЈЪрјХрЈЇрЈЏ рјДрЈЂрЈЅрјгрјб, рЈЊрЈЪрјХрЈЇрЈЏ
­ЪЊЅ	рјАрј│рЈЌ, рјдрјхрјдрј│, рјДрЈЃрј«рЈЊ рЈЊрЈЪрјХрЈЇрЈЏ, рјДрЈЃрј«рЈЊ рЈЊрЈЪрјХрЈЇрЈЏ рјарјдрЈ▓рјХрјгрјб, рЈЊрЈЪрјХрЈЇрЈЏ
­ЪЊі	рјдрјЙрјИрјб, рјдрјЙрјИрјб рјДрЈЃрј«рЈЇрјЕ рЈЌрЈЪрјХрЈЇрЈћрЈЁ, рјДрЈЃрј«рЈЊ рЈЊрЈЪрјХрЈЇрЈЏ, рЈЊрЈЪрјХрЈЇрЈЏ
­ЪЊї	рјцрЈЇрЈєрЈў, рЈ┤рјЕ рјдрјГрЈЎрЈЌ
­ЪЊЇ	рјдрЈљрЈєрјИ рЈ┤рјЕ рјдрјГрЈЎрЈЌ, рЈЌрјфрЈфрјХрЈЌ, рЈ┤рјЕ рјдрјГрЈЎрЈЌ
­ЪЊј	рЈћрјирјЕрЈЇрЈЌ рјгрЈЎрЈЌ
­ЪЊЈ	рјарЈЇрЈЏрјб рЈЦрЈ│рјфрЈЌ, рјарЈЪрјХрЈЇрЈЌ, рЈЦрЈ│рјЕрЈЌ рјарЈЪрјХрЈЇрјЕ
­ЪЊљ	рјарЈЪрјХрЈЇрЈЌ, рјдрјфрЈЌ, рЈдрјб рЈДрЈЁрЈЈрЈЊ рјарЈЪрјХрЈЇрЈЌ, рЈдрјб рЈДрЈЁрЈЈрЈ»
­ЪћЈ	рјцрЈЋрјхрЈЊ, рјдрЈљрјЙрј│рЈЏрјб, рјфрЈфрјХрЈЌ рјдрЈЂрј», рЈЇрЈЊрЈ▒ рјарЈЇрЈџрј▓рјб рјФрЈЇрЈѕрЈЏрЈЌ рјгрЈЌ, рЈЌрјфрЈфрјХрЈЌ, рЈФрјфрЈЇрЈЊрЈ┤
­Ъћљ	рјарЈЇрЈџрјбрЈЇрЈЌ, рјарЈЇрЈџрјГ, рЈЇрЈЊрЈ▒ рјарЈЇрЈџрј▓, рЈЇрЈЊрЈ▒ рјарЈЇрЈџрј▓рјб рЈЇрЈџрјбрЈЇрЈЌ рјгрЈЌ, рЈЊрјдрЈЈ
­ЪћЉ	рјЦрјДрЈЂрјгрјб рјарЈЇрЈџрјбрЈЇрЈЌ, рЈЇрЈЊрЈ▒ рјарЈЇрЈџрј▓рјб, рЈЇрЈџрјбрЈЇрЈЌ
­Ъће	рјдрЈЁрЈЕрјХрЈЇрЈЌ, рјгрЈћрЈѓрЈЊрЈЇрЈЌ
­ЪћФ	рјарјхрЈЇрЈЋрјИрЈЎрЈЌ, рјдрјХрЈф, рјдрјХрЈф рЈЇрЈєрј│, рјгрЈћрЈѓрЈЊрЈЇрЈЌ, рЈЌрЈЊрЈЂрЈЪрЈ┤рЈЇрјЕ
­ЪЈ╣	рјарЈЅрЈѓрЈЇрјЕ, рјарЈЅрЈЁрЈЎрЈЌ, рјарЈЇрјдрЈ» рЈљрЈѕрјх рјцрјгрјГрјх, рјдрјхрЈБрЈЌ, рјдрјхрЈБрЈЌ рјарј┤ рјарЈЮрЈЌ, рјдрЈЮрЈЌ
­ЪћД	рјдрЈїрЈЂрЈЇрЈЌ, рјгрЈћрЈѓрЈЊрЈЇрЈЌ, рЈЌрјдрЈџрЈЕрјИрЈЋрЈЇрЈЎрЈЌ, рЈЌрЈЇрЈџрЈЕрјИрјХрЈЇрЈЎрЈЌ
­ЪћЕ	рјарЈЇрЈЊрЈ▒рЈЌрЈЇрЈЎрЈЌ, рјарЈЇрЈЊрЈ▒рЈЌрЈЇрЈЎрЈЌ рјарј┤ рјдрјГрЈЌ, рјдрјГрЈЌ, рјгрЈћрЈѓрЈЊрЈЇрЈЌ
­ЪћЌ	рјФрЈЊрјИрЈЎрЈЌ
­ЪД░	рјБрЈЇрЈЊ рЈ▒рјгрЈЂрјИрЈЇрјЕ, рјДрЈЂрЈїрјб рјдрјхрЈћрЈЁрЈЎрЈЌ, рјгрЈћрЈѓрЈЊрЈЇрЈЌ, рјгрЈћрЈѓрЈЊрЈЇрЈЌ рјдрјхрЈћрЈЁрЈЎрЈЌ рјДрЈЂрЈїрјб
­ЪД▓	рјцрјхрјХрј» рјарјдрЈјрЈЇрЈЏ, рЈљрЈѕрјх рјцрј│рЈЉрјХрјЕ, рЈћрјирјЕрЈЇрјЕ рјдрЈїрЈЂрЈЇрјЕ
­ЪДф	рјарјдрЈЎрј▓рЈЇрЈЌ рЈЁрЈЇрЈЌрЈЊрЈЁрјб, рјарјдрЈЏрЈѓрЈЊрЈЇрЈЌ, рјарјдрЈЏрЈЌ рјцрЈњрЈЎрЈѓ, рјарјдрЈЏрЈЎрЈЌ рјДрЈЁрЈЉрјИ, рЈЁрЈгрЈў рЈДрјИрЈФрЈЇрЈЊрЈЂрј», рЈДрЈЊрј┤рЈЁрЈЊ рЈЁрЈФрЈў рјарЈЉрЈ░рЈЇрјЕ
­ЪДФ	рјарјдрЈЏрЈЎрЈЌ рјДрЈЁрЈЉрјИ, рјцрЈЕрјЙрЈгрЈЇрЈњ рЈњрЈЎрЈѓ рјцрјИрЈїрЈЌ, рјгрЈЃрЈЌ рјарјдрЈјрЈЇрЈЎрЈЌ, рјгрЈЃрЈЌ рЈёрЈЇрЈЏ рјцрЈјрЈЇрЈЌрЈЋрјЕ, рЈёрЈЇрЈЏрјбрЈЋрј▓, рЈгрЈЇрЈЌрјг рјгрЈЃрЈЌ рјЦрЈ│рјЕ
­ЪДг	рјгрЈѓрЈЏ, рјгрЈЃрЈЌ рјцрЈЊрЈЂрЈЪрЈ┤рЈњ рЈДрјХрЈњрјб, рјгрЈЃрЈЌ рЈёрЈЇрЈЏ рјцрЈјрЈЇрЈЌрЈЋрјЕ, рЈДрЈџрјфрЈћрЈЁ рјгрЈЃрЈЌ рЈДрЈЊрј┤рЈЁрј▓, рЈДрЈџрјфрЈћрЈЁ рјгрЈЃрЈЌ рЈДрЈЊрј┤рЈЁрј▓ рјцрЈЊрЈ░рјХрЈњрјб, рЈДрЈџрјфрЈћрЈЁ рјгрЈЃрЈЌ рЈДрЈЊрј┤рЈЁрј▓ рјцрЈЊрЈ░рјХрЈњрјб рјцрјЙрјдрЈјрЈЇрЈЌрЈЋрјЕ
­Ъћг	рјарјгрЈЏрЈѓрЈЊрЈЇрЈЌ, рјцрЈЇрЈЌ рјфрј▒рЈЇрЈЌ рјарјфрјхрЈ▒рЈЇрЈЎрЈЌ, рјгрЈћрЈѓрЈЊрЈЇрЈЌ
­ЪћГ	рјарјгрЈЏрЈѓрЈЊрЈЇрЈЌ, рјдрјИрј│рЈЌ рЈЕрјфрЈЕрЈЏрЈЌ, рјгрЈћрЈѓрЈЊрЈЇрЈЌ
­ЪЊА	рјцрЈЁрЈфрЈЊ, рјдрјИрј│рЈЌ рјАрЈЎрј» рјЙрЈЈрј│рЈЏрјЙ рјдрЈѓрЈ▒рЈЇрјЕ, рјдрјИрјХрј» рјарјдрЈќрЈЃрјхрЈЎ, рјдрјИрјХрј» рјарјдрЈќрЈЃрјхрЈЎ рјАрЈЎрј» рјЙрЈЈрј│рЈЏрјЙ
­ЪњЅ	рјарјдрјЙрјдрЈў, рјарЈЊрЈБрЈ▓рЈЇрЈЌ, рјцрЈЊрЈѓрјх, рјгрЈћрЈѓрЈЊрЈЇрЈЌ, рЈЁрЈгрЈў, рЈ┤рјЕ рјарЈЊрЈБрЈ▓рЈЇрЈЎрЈЌ
­Ъњі	рјарјдрјЙрјдрЈў, рјцрЈбрјЕ, рЈЁрЈгрЈЊ рјарјЕрЈЇрЈЊ, рЈЁрЈгрЈў
­Ъџф	рЈЇрЈџрЈЌ
­Ъџй	рЈЎрЈ▒ рјАрЈЊрЈЇрЈЌ
­Ъџ┐	рјарј╣, рјарЈЇрЈџрЈЪрЈЦрЈЎ
­ЪЏЂ	рјарЈЊрЈгрЈЇрЈЌ, рјцрјЙрЈЊрЈгрЈЇрЈЌ
­ЪД┤	рјарЈЊрЈЁрјхрЈ░рЈЌ, рјарЈЊрЈЁрјхрЈ░рЈЌ рјФрјд, рјарЈ░рјИ рјдрЈЁрјхрЈ░рЈЌ, рјБрЈю рјарјхрЈЇрЈџрјхрЈЎрЈЌ, рЈЁрЈЊ рјарЈЊрј┤рЈЌрЈЇрјЕ рЈѓрјдрЈњрјЙ
­ЪДи	рјцрјЙрЈјрјХрЈЎрЈЌ, рјцрЈЇрЈєрЈў, рЈћрЈЕрјх рЈЁрЈ»
­ЪД╣	рјгрЈЃрЈїрЈ»рЈЇрЈЌ, рЈЋрјдрЈЁрјдрјхрЈЇрјг, рЈЋрјгрЈЃрЈїрЈЇрјЕ, рЈЦрјЕрјх
­ЪД║	рјцрјЙрЈЊрЈЪрЈїрј▓, рЈћрјирЈБ, рЈЋрјдрјХрјЕрЈЇрјг, рЈЌрјЕрјХрЈЇрЈЌ
­ЪД╗	рјфрЈфрјх рјдрЈЄрЈЁрЈћрЈЁ, рјфрЈфрјх рЈЌрјхрјЕрЈ▓рЈЌ, рЈЎрЈ▒ рјАрЈЊрЈЇрЈўрЈ▒ рјфрЈфрјх
­ЪД╝	рјарЈЊрЈгрЈЇрјг, рјБрЈю рјарЈарЈЌ рЈќрјхрЈЎ, рјБрЈЮ, рјцрЈгрјЕрЈЪ, рјдрјЙрјИ, рЈЋрјдрЈЁрјдрјхрЈЇрјг
­ЪДй	рјарјДрЈ▓рЈЌрЈЇрјг, рјцрЈ» рјцрЈЇрЈЌ рЈЌрЈћрјИрјбрЈЊ, рЈЊрЈгрјх рјбрЈ│рЈЇрЈЌ, рЈЋрјдрЈЁрјдрјхрЈЇрјг
­ЪД»	рјарЈЁрЈюрЈЌ, рјарЈЊрЈфрј│рјЕрЈЇрјг, рјарЈЊрЈфрј│рјЕрЈЇрјг рЈЌрјдрЈЪрЈЌрЈЇрЈЎрЈЌ, рЈџрЈЎрјхрЈцрјИ рЈёрЈћрЈЋрјЕрЈЇрјгрјЙ
­ЪЏњ	рјарЈЊрјЙрјЙрјЕрја, рјарЈдрЈЎрЈЌ, рјдрЈїрЈЎрЈ▒рЈЊрЈЇрЈЌ, рЈЎрј┤рј│
­Ъџг	рјфрјЕрЈЇрЈЌ, рЈџрјдрЈњрЈЇрЈЏ
­ЪЌ┐	рјцрјДрЈЏ, рјцрјЙрј┤рЈћрЈЁрјб, рј╝рјб, рј╝рЈ»рјб
­ЪЈД	ATM рјфрЈфрјх, atm, рјарЈЋрј│ рЈДрЈѓрЈЌрјб, рјарЈЋрј│ рЈДрЈѓрЈЌрјб рЈДрјИрЈФрЈЇрЈЊрЈЂрј», рјцрЈЕрЈї
­Ъџ«	рјцрЈ▓ рЈЕрЈЌрЈЁрЈЌ, рјцрЈ▓ рЈЕрЈЌрЈЁрЈЌ рјарјфрјхрЈ░рЈЌ, рјцрЈ▓ рЈЕрЈЌрЈЁрЈЌ рјцрЈњрЈЎрјЙ
­Ъџ░	рјарј╣, рјарЈЊрЈЁрЈЈрЈЎ, рјарЈЌрЈћрЈЇрјЕ, рјарЈЌрЈћрЈЇрЈЌ рјарј╣
­Ъџ╗	WC, рјАрЈЊрЈЇрЈЌ, рјцрјЙрЈЊрЈЁрјдрЈЪрЈЌ рјДрЈЁрЈЉрјИ, рЈЎрЈ▒ рјцрјЙрЈерЈЇрЈЌ
­ЪџЙ	wc, рјарј╣, рјарј╣ рјАрЈЊрЈЇрЈЌ, рјцрјЙрЈЊрЈЁрјдрЈЪрЈЌ рјдрЈЁрЈЉрјИ, рјДрЈЁрЈЉрјИрјб, рЈЎрЈ▒ рјцрјЙрЈерЈЇрЈЌ
­ЪЏѓ	рјдрјХрј»рЈЇрЈЎрЈЌ, рјдрјХрј»рЈЇрЈЎрЈЌ рЈЌрјФрјЕрЈЌрЈЇрјЕ, рЈЌрјФрјЕрЈЌрЈЇрјЕ
­ЪЏЃ	рЈёрЈЇрЈЏрјб рјбрЈ│рјЙрЈЏрЈЂрЈЌ
­ЪЏё	рјдрЈЁрЈћрЈЁрЈЎрЈЌ, рјдрЈЁрЈћрЈЁрЈЎрЈЌ рјфрј»рЈ│рЈЌрЈЇрјЕ, рјфрј»рЈ│рЈЌрЈЇрјЕ
­ЪЏЁ	рјарјдрЈЇрјдрЈѓ рЈЋрјдрјИрЈЏрјб, рјдрЈЁрЈћрЈЁрЈЎрЈЌ, рЈЇрЈЊрЈ▒ рјарЈЇрЈџрЈЌ, рЈЋрјдрјИрЈЏрјб
­ЪџИ	рјарЈ▓рЈЪ, рјАрј│рЈЌ рјАрЈЎрј», рЈЋрјдрјЙрЈЌрЈФрЈЇрјг, рЈЌрЈѓрЈ▓рЈЪ рЈДрЈѓрЈЌрЈФрЈЇрЈЌ, рЈЎрЈєрј┤рји рЈЊрЈЌрЈЪрЈЎрј▓рјб
­ЪџФ	рјарјерЈ│рЈЊрЈЁрјб, рјарЈ┤рЈЇрЈЌ, рјбрЈ»рЈЏрЈЂрЈЌ рЈѓрјерЈњрјЙ, рјЦрЈЮ, рЈѓрјерЈњрјЙ
­Ъџ│	рјбрЈ»рЈЏрЈЂрЈЌ рЈѓрјерЈњрјЙ, рјЦрЈЮ, рјдрЈЁрЈЇрЈЎрЈЇрјд, рЈѓрјерЈњрјЙ, рЈћрјх рЈЌрјдрЈєрЈў, рЈЮрјерЈњ рЈћрјх рЈЌрјдрЈЕрЈў
­Ъџ»	рјбрЈ»рЈЏрЈЂрЈЌ рЈѓрјерЈњрјЙ, рјЦрЈЮ, рјдрјхрјерЈ»рЈЏрЈЁрјб, рјдрЈЁрЈЇрЈЎрЈЇрјд, рЈѓрјерЈњрјЙ, рЈърЈЇрЈЌ рјдрјхрјерЈ┤рЈЏрЈЁ
­Ъџ▒	рјарј╣, рЈЮ-рјарЈЌрЈћрЈЇрјд, рЈЮ-рјдрЈЁрЈЦрЈЊрЈЇрЈЌ, рЈЮ-рјдрЈЁрЈЦрЈЊрЈЇрЈЌ рјарј╣
­Ъџи	рјарЈерЈЈрЈ░рЈЇрјЕ, рјбрЈ»рЈЏрЈЂрЈЌ рЈѓрјерЈњрјЙ, рјЦрЈЮ, рјЦрЈЮ рјарјЙрЈерЈЈрЈ░рЈЇрјЕ, рјдрЈЁрЈЇрЈЎрЈЇрјд, рЈѓрјерЈњрјЙ
­ЪЊх	рјарЈЊрЈЁрЈЈрЈЎрј» рјЦрЈЮ, рјдрЈЁрЈЇрЈЎрЈЇрјг, рјдрЈЁрЈЇрЈЎрЈњрјб, рЈѓрјерЈњрјЙ, рЈЌрЈЪрЈЃрј«рЈЌ, рЈЌрЈЪрЈЃрј«рЈЌрјб, рЈЮ рЈЎрј┤рј│рЈі рЈЌрјхрЈЃрј«рЈЊ
­Ъћъ	18, рјАрЈЇрјд рјбрЈ│рЈЋрЈўрЈ┤рЈЊ, рјбрЈ│рјЙрЈЋрЈўрЈ┤рЈЊ рјдрЈЁрЈЇрЈЌ, рјЦрЈЮ, рјЦрЈЮ рјарјхрЈЇрјфрЈЪрЈћрЈЁрјб, рјЙрЈЇрјЕ рјбрЈћрЈЏрЈЂрЈЌрјб рЈѓрјерЈњрјЙ, рЈЂрј│рЈџрјб, рЈърЈЇрЈЌ рЈѓрјерЈњрјЙ рЈЂрј│рЈџ рјбрЈ│рЈЋрЈўрЈ┤рЈЊ
­ЪћЃ	рјдрЈЮрЈЌ, рјфрЈфрјх рЈЌрјдрЈѓрЈ▒рЈЎрЈЌ, рЈЎрјфрЈбрј»рЈљрЈЌ, рЈЕрЈЦ рјцрЈфрЈЁрЈЇрЈЌ
­Ъћё	рјарЈЌрЈєрјИрЈЋрЈ▓рј░рјб рјарјдрЈЇрјдрЈѓ рЈЌрЈю, рјдрЈЮрЈЌ, рЈЕрЈЦ рјдрЈЈрЈЁрЈЇрЈћрЈЁ, рЈЕрЈЦ рјдрЈЈрЈЁрЈЇрЈћрЈЁ рјфрЈфрјх рЈЌрјдрЈѓрЈ▒рЈЎрЈЌ, рЈЕрЈЦ рјдрЈЈрЈЁрЈЇрЈћрЈЁрјб, рЈЕрЈЦ рјдрЈЈрЈЁрЈЇрЈћрЈЁрјб рјдрЈЮрЈЌ рјдрЈЌ
­ЪћЎ	рјБрЈѓрЈЌрЈЮ, рјБрЈѓрЈЌрЈб рјдрЈЮрЈЌ, рјдрЈЮрЈЌ
­Ъћџ	рјдрЈЮрЈЌ, рЈГрјхрЈЇрЈєрЈЏ рјдрЈЮрЈЌ, рЈГрјхрЈЇрЈЏ
­ЪћЏ	рјдрЈЮрЈЌ, рјДрЈѓрјЕрЈЊ! рјдрЈЮрЈЌ, рјфрЈфрјИ, рЈёрЈЇрЈЏрјб
­Ъћю	рјдрЈЮрЈЌ, рЈърјЕрЈГ, рЈърјЕрЈГ рјдрЈЮрЈЌ
­ЪћЮ	рјдрјИрј│рЈЌрЈю, рјдрЈџ, рјдрЈџ рјдрЈЮрЈЌ, рјдрЈЮрЈЌ
­ЪЏљ	рјцрЈЃрј»рЈ│рЈњрјб, рјцрЈЎрЈбрЈњ рЈДрЈѓрј│рЈФрЈЇрЈЌрјб, рЈДрЈѓрј│рЈФрЈЇрЈЌрјб
­ЪЋј	рјарЈерЈЇрЈЌ рјдрјфрЈЌ, рјцрјДрјЙрЈФ рјарЈерЈЇрЈЌ, рјцрЈЃрј»рЈ│рЈњрјб, рјдрјхрЈЅрјЕ рЈЌрЈерЈЇрЈЌ
­Ъћ»	рјцрЈЁрЈЦ рЈЉрЈЊрјх-рЈЋрјфрЈЇрЈЊрЈ» рЈЃрЈѕрЈЈ, рјцрЈфрј┐, рЈЃрЈѕрЈЈ
РЏј	рјарЈ▒рЈЎрј», рјбрјЙрЈЊ, рјбрјЙрЈЊ рјдрЈѓрЈ┤рЈЊ, рЈЃрЈѕрЈЈ рЈЊрЈЪрјХрЈЇрЈЌрј▓рјб
­Ъћђ	рјдрЈЮрЈЌ, рЈЌрЈЉрЈ░рЈЌ рЈџрЈЎрЈфрјИ рјдрЈЌ, рЈДрЈЊрј┐рЈФрЈЊ
­ЪћЂ	рјцрЈЕрЈЦ рјцрЈфрЈЁрЈЇрЈЌ, рјдрЈЮрЈЌ, рЈѓрј▓рјд рјдрЈЏрЈЌ, рЈћрјхрЈЂ рјбрЈ»рЈЏрЈЂрЈЌ
­Ъћѓ	рјцрЈЕрЈЦ рјцрЈфрЈЁрЈЇрЈЌ, рјдрЈЮрЈЌ, рЈѓрј▓рјд рјцрЈЕрЈї рјдрЈЏрЈЌ, рЈїрЈЅ рјбрЈ│рЈЕрјгрЈў
РќХ	рјарјдрЈўрЈЈ, рјдрЈЮрЈЌ, рЈЌрЈЂрЈЪрЈЎрЈЌ, рЈЌрЈЂрЈЪрЈЎрЈЌ рјдрЈЌ, рЈдрјб рЈДрЈЁрЈЈрЈ»
РЈЕ	рјбрјгрЈ▒рЈ▒ рЈЌрЈю, рјцрЈЪрЈЇрЈЌ, рјдрЈЮрЈЌ, рјдрЈБрЈёрјх-рјбрјгрЈ▒рЈЌрЈб рјарЈљрјЦрЈЇрЈЎрЈЌ, рЈћрјхрјГ
РЈГ	рјарЈЮрЈЌ, рЈћрјхрЈЂ рјарјбрЈњ, рЈћрјхрЈЂ рјарјбрЈњрјб рјдрЈЌ, рЈћрјхрЈЂ рјарЈЌрЈ┤рј│рЈЏрЈЇрјгрјб, рЈдрјб рЈДрјЙрЈЈрЈ»
РЈ»	рјарјдрЈўрЈЏ, рјдрјЙрј»рЈЇрЈЌ, рјдрЈЮрЈЌ, рЈћрЈЂрЈЪрЈЊ, рЈћрЈЂрЈЪрЈЊ рјарј┤рЈ▒рјЕ рЈЌрјЙрј»рЈЇрЈЌ рјдрЈЌ, рЈдрјб рЈДрјЙрЈЈрЈ»
РЌђ	рјарјдрЈўрЈЈ, рјдрЈЮрЈЌ, рЈЌрјдрЈЂрЈЇрЈѕрЈћрЈЁрјб, рЈЌрјдрЈЂрЈЇрЈѕрЈћрЈЁрјб рјдрЈЌ, рЈдрјб рЈДрЈЁрЈЈрЈ»
РЈф	рјдрЈЈрЈЁрЈЇрЈћрЈЁрјб, рјдрЈЮрЈЌ, рјдрЈБрЈёрјх рјарЈерЈЇрЈЎрЈЌ рјарЈљрјЦрЈЇрЈЎрЈЌ, рЈћрјх
РЈ«	рјБрЈѓрјб рјарЈЇрЈЊрЈЕрЈЏрЈЇрЈЌ рјдрЈЌ, рјдрЈЮрЈЌ, рЈдрјб рЈДрЈЁрЈЈрЈ», рЈДрЈЕрјФрЈћрЈЁ рјарјбрЈњрјб, рЈДрЈЕрјФрЈћрЈЁ рјарЈЌрЈ┤рј│рЈЏрЈЇрјгрјб
­Ъћ╝	рјдрјИрј│рЈЌ рјдрЈЌ, рјдрЈЌ, рјдрЈЮрЈЌ, рјЕрјдрје
РЈФ	рјдрЈЮрЈЌ, рјдрЈБрЈёрјх рјдрјИрј│рЈЌрЈб рјарЈљрјЦрЈЇрЈЎрЈЌ, рЈћрјхрјГ
­Ъћй	рјАрј│рЈЌ, рјАрј│рЈЌ рјдрЈЌ, рјдрЈЌ, рјдрЈЮрЈЌ, рјЕрјдрје
РЈг	рјАрј│рЈЌ, рјдрЈЮрЈЌ, рјдрЈБрЈёрјх рјАрј│рЈЌ рјарЈљрјЦрЈЇрЈЎрЈЌ, рЈћрјхрјГ
­Ъјд	рјарЈЌрЈ┤рј│рЈЎрЈЌ, рјарЈЌрЈ┤рј│рЈЏрЈЇрјЕ, рЈЌрЈЊрЈЪрјХрЈЇрЈЌрЈЇрјЕ, рЈЌрЈЊрЈ┤рј│рЈЏрЈЇрјЕ
­ЪћЁ	рјарЈЇрјфрј»рЈЇрЈћрЈЁрјб, рјарЈЇрјфрјИрЈЊ рјдрЈЌ, рјАрј│рЈЌ, рјцрЈЇрјфрјИ
­Ъћє	рјарЈЇрјфрј»рЈЇрЈћрЈЁрјб, рјцрЈЇрјфрЈЇрЈЌ, рјцрЈЇрјфрЈЇрЈЌ рјдрЈЌ
­ЪЊХ	рјарЈЊрЈЁрЈЈрЈЎрј», рјдрјЙрјИрјб рЈЌрЈЪрЈЃрј«рЈЌ, рЈїрЈЅ, рЈЌрЈЪрЈЃрј«рЈЌ, рЈџрјирјгрјб рЈЋрјдрјЙрјИрјб, рЈџрЈ»рЈЊрЈЏ
­ЪЊ│	рјарј»рЈЊрЈЇрЈЌ рЈЌрЈЪрЈЃрјхрЈЌ, рјарјхрЈќрјИрј▓рЈЇрјг, рјарјхрЈќрјИрј▓рЈЇрјг рЈёрЈЏрЈЁ, рјгрЈЎрЈЌ, рЈЌрЈЪрЈЃрј«рЈЌрјб, рЈЌрЈЪрЈЃрјхрЈЌрјб
­ЪЊ┤	рјарј»рЈЊрЈЇрЈЌ рЈЌрЈЪрЈЃрј«рЈЌ, рјарЈЊрјЙрЈЈрЈЎ, рЈЌрЈЪрЈЃрј«рЈЌрјб, рЈЎрј┤рј│рЈі рЈЌрјхрЈЃрј«рЈЊ рјарЈюрЈЏ
Рџю	рјарЈЦрј│ рјарЈЂрјХрј» рјарЈЦрјИрЈЇрјЕ
­Ъћ▒	рјцрЈЎрЈфрјИрјб, рјгрЈћрЈѓрЈЊрЈЇрЈЌ, рЈЌрјдрЈЃрЈБрјхрЈЇрјЕ, рЈЦрЈ│, рЈ┤рјЕ, рЈ┤рјЕ рЈЊрЈЪрјХрЈЇрЈЏ
­ЪЊЏ	рјарјДрЈЂрЈЇрЈЌ, рЈЎрЈЎрјЦрјб, рЈЎрЈЎрјЦрјб рјдрЈЌ
­Ъћ░	рјарјДрЈЂрЈЇрЈЌ, рјарј┤рЈѓрЈЇрјЕ, рјбрЈц рјбрЈ│рЈЇрЈЌ, рјцрјдрјХрјд, рјгрЈћрЈѓрЈЊрЈЇрЈЌ, рЈЊрјХрЈѓрје, рЈБрЈЕрЈѓрЈЈ, рЈБрЈЕрЈѓрЈЈ рЈЊрЈЪрјХрЈЇрЈЌрЈЇрјгрјб рјЙрЈЇрјЕ рјгрЈЕрЈЎрЈЌ рјарј┤рЈѓрЈЇрјЕ
РюЁ	рјарјдрЈЏрЈЌ, рјцрЈЂрјд рјдрјерЈЊ рјарЈЇрЈЊрЈЁрЈЁрјб, рјцрЈЎрЈфрјИ
РЮї	x, рјарЈјрЈњрЈЌ, рјДрЈЂрЈЅрјбрЈЇрЈЌ, рјфрЈфрјИ, рЈЊрЈЊрј┐рЈФрЈЇрЈЏ рјфрЈфрјх, рЈЊрЈЊрј┐рЈФрЈЇрЈЏ рјфрЈфрјИ, рЈЌрЈјрЈбрјб
РЮј	рјфрЈфрјх, рЈЁрјЕ рЈДрЈЁрЈЈрЈ», рЈЊрЈЊрј┐рЈФрЈЇрЈЏ рјфрЈфрјх рјдрЈЌ
РъЋ	рјцрЈЊрјерЈЊ рјДрЈЂрЈЅрјЕ рјфрЈфрјх, рјДрЈЂрЈЅрјЦрјб, рЈЌрЈјрЈЇрЈЌ
Ръќ	рјарјдрЈ▓рјХрЈЌрЈЇрјЕ, рјцрЈЊрјерЈЊ рјарјдрЈ▓рјХрЈЌрЈЇрјЕ рјфрЈфрјх, рЈЌрЈјрЈЇрЈЌ
РъЌ	рјцрЈЊрјерЈЊ рЈ▒рјдрЈЏрјб рјфрЈфрјх, рЈЌрЈјрЈЇрЈЌ, рЈ▒рЈЌрјдрЈЏрјб
Ръ░	рјцрјхрЈЦрЈЇрЈєрЈЂрЈЊ, рјцрјхрЈЦрЈЇрЈєрЈЂрЈЊ рјдрЈЋрЈ▒рЈЇрЈЏрјб, рјдрЈЋрЈ▒рЈЇрЈЏрјб
Ръ┐	рјцрјхрЈЦрЈЇрЈєрЈЂрЈЊ, рјдрЈЋрЈ▒рЈЇрЈЏрјб, рЈћрјх рЈДрјхрЈЦрЈЇрЈєрЈЂрЈЊ рјдрЈЋрЈ▒рЈЇрЈЏ, рЈћрјхрјГ
РЮћ	рјарЈЏрЈЏрј▓рЈЇрјЕ, рјцрЈЂрјд рјарЈЊрЈћрЈЏрј▓рЈЇрјЕ рјарЈЇрЈЊрЈЁрЈЁрјб, рјцрЈЎрЈфрјИ, рјдрЈЋрЈ▒рЈЇрЈћрЈЁрјб, рЈџрЈЎрЈфрјИ
РЮЋ	рјцрЈЂрјд рЈЇрЈЊрЈ▒ рјцрЈЃрЈ┤ рЈџрЈЎрЈфрјИ, рјцрЈЎрЈфрјИ, рјдрЈЋрЈ▒рЈЇрЈЏрјб, рЈЇрЈЊрЈ▒ рјцрЈЃрЈ┤рјЕ, рЈџрЈЎрЈфрјИ
­Ъњ»	100, рјарјфрј»рЈДрЈѕ рјгрЈЁрЈЁрјб, рјцрЈЁрЈЁрјб, рјДрјхрјб, рЈЇрјфрј»рЈДрЈѕ
­Ъћа	ABCD, рјдрјИрј│рЈЌрЈЌрјфрЈфрјх, рј│рЈћрЈѓ, рЈЌрјдрЈўрЈЁрЈЌрЈЇрЈЌ, рЈЌрјдрЈўрЈЁрЈЌрЈЇрЈЌ рј│рЈћрЈѓ рјдрјИрј│рЈЌрЈЌрјфрЈфрјх, рЈЌрјфрЈфрј│рЈЁрјб
­ЪћА	abcd, рјАрј│рЈЌрЈЌрјфрЈфрјх, рј│рЈћрЈѓ, рЈЌрјдрЈўрЈЁрЈЌрЈЇрЈЌ, рЈЌрјдрЈўрЈЁрЈЌрЈЇрЈЌ рј┤рЈћрЈѓ рјАрј│рЈЌрЈЌрјфрЈфрјх, рЈЌрјфрЈфрј│рЈЁрјб
­Ъћб	1234, рЈЌрјдрЈўрЈЁрЈЌрЈЇрЈЌ рЈЌрЈјрЈЇрЈЌ, рЈЌрјдрЈўрЈЁрЈЌрЈЇрЈЌрјб, рЈЌрЈјрЈЇрЈЌ
­ЪћБ	рЈЌрјдрЈўрЈЁрЈЌрЈЇрЈЌ, рЈЌрјдрЈўрЈЁрЈЌрЈЇрЈЌ рЈџрЈЎрЈфрјИрјб, сђњРЎф&%
­Ъћц	abc, рј│рЈћрЈѓ, рЈЌрјдрЈўрЈЁрЈЌрЈЇрЈЌ, рЈЌрјдрЈўрЈЁрЈЌрЈЇрЈЌ рј┤рЈћрЈѓ рЈЌрјфрјхрЈ░рЈЌ, рЈЌрјфрЈфрј│рЈЁрјб, рЈЌрјфрЈфрјХрЈЌ рЈџрЈЃрЈ┤рјгрјб
­Ъєј	AB рјдрЈЌ (рјбрЈ│рЈЇрЈЌ рјЕрјд рјБрЈЂрј▓рјб), ab, рјбрЈ│рЈЇрЈЌ рјЕрјд рјБрЈЂрј▓рјб
­ЪєЉ	cl, рЈЪрЈъ рјдрЈЌ
­Ъєњ	рјцрЈЂрЈЈрЈ┤рЈЮ, рјцрЈЂрЈЈрЈ┤рЈЮ рјдрЈЌ
­ЪєЊ	рјарЈјрЈГрјб, рјарЈјрЈГрјб рјдрЈЌ
­Ъєћ	ID рјдрЈЌ, id, рјфрЈЪрЈЇрЈЌ
­ЪєЋ	рјбрЈцрјб, рјбрЈцрјб рјдрЈЌ
­Ъєќ	NG рјдрЈЌ, ng
­ЪєЌ	рјБрЈЈрЈі, рјБрЈЈрЈі рјдрЈЌ
­Ъєў	SOS рјдрЈЌ, sos, рјарјхрЈЇрЈЋрјИрЈЎрЈЌ
­ЪєЎ	рјцрЈЎрЈфрјИ, рјдрјИрј│рЈЌ, рјдрјИрј│рЈЌрјб! рјдрЈЌ
­Ъєџ	VS рјдрЈЌ, vs, рјцрЈЊрЈАрЈЌ
­ЪѕЂ	рјДрЈћрјДрјЙ, рЈБрЈЕрЈѓрЈЈ, рЈБрЈЕрЈѓрЈЈ РђюрјарјГрЈѓРђЮ рјдрЈЌ, РђюрјарјГрЈѓРђЮ, сѓ│сѓ│
­Ъѕи	рјдрЈЁрЈЇрЈЎрЈЇрјг, рЈБрЈЕрЈѓрЈЈ, рЈБрЈЕрЈѓрЈЈ РђюрЈЈрЈЁрЈЊ рЈ│рЈЊрјх рјарЈ»рЈЎрЈбрјбРђЮ рјдрЈЌ, РђюрЈЈрЈЁрЈЊ рЈ│рЈЊрјх рјарЈ»рЈЎрЈбрјбРђЮ, Тюѕ
­ЪѕХ	рјдрЈЁрЈЇрЈЎрЈЇрјг, рЈБрЈЕрЈѓрЈЈ, рЈБрЈЕрЈѓрЈЈ РђюрјарЈјрЈГ рЈѓрјерЈњрјЙРђЮ рјдрЈЌ, РђюрјЦрЈЮ рјарЈјрЈГрјб рЈ▒рјЕРђЮ, ТюЅ
­Ъѕ»	рјдрЈЁрЈЇрЈЎрЈЇрјг, рЈБрЈЕрЈѓрЈЈ, рЈБрЈЕрЈѓрЈЈ РђюрјдрЈЃрј»рЈ┤рјбРђЮ рјдрЈЌ, Рђюрјарј»рЈ░рјИрјбРђЮ, ТїЄ
­ЪЅљ	рјдрЈЁрЈЇрЈЎрЈЇрјг, рЈБрЈЕрЈѓрЈЈ, рЈБрЈЕрЈѓрЈЈ РђюрЈЌрјфрЈЈрЈїрЈЁРђЮ рјдрЈЌ, РђюрјдрЈ▓рЈЪ рјарЈѕрЈ┤рЈЎрЈЌРђЮ, тЙЌ
­Ъѕ╣	рјдрЈЁрЈЇрЈЎрЈЇрјг, рЈБрЈЕрЈѓрЈЈ, рЈБрЈЕрЈѓрЈЈ РђюрјдрЈ▓рЈЪ рЈДрјгрЈЕрјХрЈЌРђЮ рјдрЈЌ, РђюрјарЈ▓рЈЪрје рЈДрјгрЈЕрјХрЈЌРђЮ, тЅ▓
­Ъѕџ	рјдрЈЁрЈЇрЈЎрЈЇрјг, рЈБрЈЕрЈѓрЈЈ, рЈБрЈЕрЈѓрЈЈ РђюрјарЈјрЈГрјбРђЮ рјдрЈЌ, РђюрјарЈЊрЈѓрЈЪрЈЌ рЈѓрјерЈњрјЙРђЮ, уёА
­Ъѕ▓	рјдрЈЁрЈЇрЈЎрЈЇрјг, рЈБрЈЕрЈѓрЈЈ, рЈБрЈЕрЈѓрЈЈ РђюрјбрЈ»рЈЏрЈЂрЈЌ рЈѓрјерЈњрјЙРђЮ рјдрЈЌ, РђюрјдрЈЁрЈЇрЈЎрЈЇрјдРђю, удЂ
­ЪЅЉ	рЈБрЈЕрЈѓрЈЈ РђюрјдрЈЁрЈЇрЈЊРђЮ, рЈБрЈЕрЈѓрЈЈ РђюрЈЌрЈЊрЈѓрјИрЈЇрЈЌРђЮ рјдрЈЌ, РђюрЈЌрЈЊрЈЊрЈѓрјИрЈЇрЈЎрЈЌРђЮ, тЈ»
­ЪѕИ	рјдрЈЁрЈЇрЈЎрЈЇрјг, рЈБрЈЕрЈѓрЈЈ, рЈБрЈЕрЈѓрЈЈ РђюрјарјДрјхрЈЈрЈљрЈЌРђЮ рјдрЈЌ, РђюрјарјДрјхрЈЈрЈљрЈЌРђЮ, ућ│
­Ъѕ┤	рјдрЈЁрЈЇрЈЎрЈЇрјг, рЈБрЈЕрЈѓрЈЈ, рЈБрЈЕрЈѓрЈЈ РђюрЈЋрјдрјХрЈЇрјгрјбРђЮ рјдрЈЌ, РђюрЈЋрјдрјХрЈЇрјдРђЮ, тљѕ
­Ъѕ│	рјдрЈЁрЈЇрЈЎрЈЇрјг, рЈБрЈЕрЈѓрЈЈ, рЈБрЈЕрЈѓрЈЈ РђюрјцрЈЪрЈЁрЈЊРђЮ рјдрЈЌ, РђюрјцрЈюрЈЁрЈЊРђЮ, уЕ║
­Ъѕ║	рјарЈЇрЈџрјбрЈЊ рЈЌрјдрјИрЈФрЈЇрЈЊрЈЂрЈЌ, рјдрЈЁрЈЇрЈЎрЈЇрјг, рЈБрЈЕрЈѓрЈЈ, рЈБрЈЕрЈѓрЈЈ РђюрјарЈЇрЈџрјбрЈЊ рЈЌрјдрјИрЈФрЈЇрЈЊрЈЂрЈЌРђЮ рјдрЈЌ, тќХ
­Ъѕх	рјдрЈЁрЈЇрЈЎрЈЇрјг, рЈБрЈЕрЈѓрЈЈ, рЈБрЈЕрЈѓрЈЈ РђюрјЦрЈЮ рЈ▒рЈЪрЈЁрЈЊРђЮ рјдрЈЌ, РђюрјЦрЈЮ рЈ│рЈЪрЈЁрЈЊРђю, Т║ђ
­Ъћ┤	рјцрЈЎрЈбрЈњ, рјдрЈљрЈєрјИ, рјЕрјдрје, рјЕрјдрје рјдрЈљрЈєрјИ
­Ъћх	рјцрЈЎрЈбрЈњ, рјдрЈљрЈєрјИ, рЈїрјфрЈѓрје, рЈїрјфрЈѓрје рјдрЈљрЈєрјИ
­ЪћХ	рјБрЈѓрЈЦ, рјцрЈћрјЙ рјБрЈѓрЈЦ рјдрјИрЈЅрЈЌ рЈЁрЈ», рјцрЈЎрЈбрЈњрјб, рјдрјИрЈЅрЈЌ рЈЁрЈ»
­Ъћи	рјцрЈћрјЙ рЈїрјфрЈѓ рјдрјИрЈЅрЈЌ рЈЁрЈ», рјцрЈЎрЈбрЈњ, рјдрјИрЈЅрЈЌ рЈЁрЈ», рЈїрјфрЈѓрје
­ЪћИ	рјБрЈѓрЈЦ, рјцрЈЇрЈЌ рјарЈЊрјХрЈѓрје рјцрЈБрЈЇрЈЊрјирјЕрЈЇрјЕ рЈЁрЈ», рјцрЈЎрЈбрЈњрјб, рјдрјИрЈЅрЈЌ рЈЁрЈ»
­Ъћ╣	рјцрЈЇрЈЌ рЈїрјфрЈѓрје рјцрЈБрЈЇрЈЊрјирјЕрЈЇрјЕ рЈЁрЈ», рјцрЈЎрЈбрЈњ, рјдрјИрЈЅрЈЌ рЈЁрЈ», рЈїрјфрЈѓрје
­Ъћ║	рјцрЈЎрЈбрЈњ, рјЕрјдрје, рјЕрјдрје рЈдрјб рЈДрЈЈрЈЁрЈЊ рјарЈјрј» рјдрјИрј│рЈЌ
­Ъћ╗	рјАрј│рЈЌ, рјцрЈЎрЈбрЈњ, рјЕрјдрје, рјЕрјдрје рЈдрјб рЈДрЈЈрЈЁрЈЊ рјарЈјрј» рјАрј│рЈЌрЈю
­Ъња	рјцрЈЎрЈбрЈњ, рјцрЈЦрЈЇрЈЊрјирјЕрЈЇрјЕ рјцрЈЊрЈЊрЈЪ, рјцрЈгрЈЪрЈЌ, рјдрјИрЈЅрЈЌ рЈЁрЈ», рЈљрјГрЈФрЈѓ
­Ъћў	рјцрЈЎрЈбрЈњ, рјдрЈЌ, рЈЌрјДрЈЃрјЕрЈЇрЈЌ, рЈЌрјДрЈЃрјЕрЈЇрЈЌ рјдрЈЌ
­Ъћ▓	рјцрЈЎрЈбрЈњ, рјдрЈЌ, рјгрј┐рје рЈЁрјЕ рЈДрЈЁрЈЈрЈ» рјдрЈЌ, рЈЁрјЕ рЈДрЈЁрЈЈрЈ»
­Ъћ│	рјцрЈЂрјд рЈЁрјЕ рЈДрЈЁрЈЈрЈ» рјдрЈЏ, рјцрЈЎрЈбрЈњ, рјдрЈЌ, рјдрЈ▒рЈЋрЈ▒рЈЇрЈЌ, рЈЁрјЕ рЈДрЈЁрЈЈрЈ▒
­ЪЈЂ	рјцрЈЁрЈБрЈў, рЈЊрЈЎрјЕрЈ»рЈЇрјгрјб, рЈДрЈЁрЈБрЈў, рЈДрЈЁрЈБрЈў рјдрЈЊрЈў
­ЪџЕ	рЈЋрјдрЈЃрЈБрјхрЈЇрјг, рЈдрјб рЈДрЈЁрЈЈрЈЊ рјдрЈЌ
­Ъјї	рјарјЙрјхрј«рјхрЈЇрЈЌрЈЇрјгрјб, рЈЊрЈЊрј┐рЈФрЈЇрЈЏ, рЈБрЈЕрЈѓрЈЈ, рЈДрЈЊрј┐рЈФрЈЊ, рЈДрЈЊрј┐рЈФрЈЊ рЈЌрјдрЈЊрЈЌ
­ЪЈ┤	рјарјхрЈљрЈ░рЈЇрјг, рјгрј┐рје рјдрЈЊрЈў
­ЪЈ│РђЇ­Ъїѕ	рјцрЈЁрјфрј│рЈЏ, рјцрЈЁрјфрј│рЈЏ рјдрЈЊрЈў
­ЪЈ┤РђЇРўа	рјарЈЊрјЕрјАрЈЌ, рјцрјхрјдрјхрЈЇрЈЌ рј│рЈЦ, рЈЦрЈ│рјАрЈЎрј» рјарЈЊрЈїрј▓рЈЇрјЕ, рЈЦрЈ│рјАрЈЎрј» рјарЈЊрЈїрј▓рЈЇрјЕ рјдрЈЊрЈЌ, рЈДрјгрЈЕрјХрЈЌ рјарЈЇрЈєрЈѓрјфрЈЏ
┬Е№ИЈ	рјцрЈцрјхрјб рјцрј»рЈ┤рјб
┬«№ИЈ	рјарјфрЈфрј│рЈЁрјб
Рђ╝№ИЈ	рјцрЈЃрЈ┤рјЕ, рјцрЈЎрЈфрјИ, рЈЇрЈЊрЈ▒ рјцрЈЃрЈ┤рјЕ, рЈћрјхрјГ рЈЇрЈЊрЈ▒ рјцрЈЃрЈ┤рјЕ рјцрЈЎрЈфрјИ, рЈџрЈЎрЈфрјИ
РЂЅ№ИЈ	рјарЈЏрЈЏрј▓рЈЇрјЕ, рјцрЈЎрЈфрјИ, рЈЇрЈЊрЈ▒ рјцрЈЃрЈ┤рјЕ, рЈЇрЈЊрЈ▒ рјцрЈЃрЈ┤рјЕ рјарЈЏрЈЏрј▓рЈЇрјЕ рјфрЈфрјИрјб, рЈЇрЈЊрЈ▒ рјдрјИрЈЏрЈѓрјИрјб, рЈџрЈЎрЈфрјИ
Рёб№ИЈ	tm, рјарјхрЈ▒рЈЏрјб рјфрЈфрјИ, рјарјхрЈ▒рЈЏрјбрјфрЈфрјИ, рјфрЈфрјИ
Рё╣№ИЈ	рјЦ, рјДрЈЃрј«рЈбрЈЁрјб
Рєћ№ИЈ	рјарјдрЈЇрјдрЈѓ - рјдрЈўрЈЈ рјдрЈЮрЈЌ, рјдрЈЮрЈЌ
РєЋ№ИЈ	рјдрјИрј│рЈЌ - рјАрј│рЈЌ рјдрЈЮрЈЌ, рјдрЈЮрЈЌ
Рєќ№ИЈ	рјцрЈ┤рЈбрјбрЈГрЈЋрјхрјгрјб, рјдрјИрј│рЈЌ-рјарјдрЈЇрјдрЈѓ рјдрЈЮрЈЌ, рјдрЈЮрЈЌ, рЈѓрЈџрЈ│рјфрЈЏрјб, рЈЁрјЕрЈѓрЈџрЈ│рјфрЈЏрјб рЈѓрЈџрЈЊрјИрЈЌрЈјрј»рј»
РєЌ№ИЈ	рјцрЈ┤рЈЮрјДрјИрјгрјб, рјдрјИрј│рЈЌ-рјарјдрЈўрЈЈ рјдрЈЮрЈЌ, рјдрЈЮрЈЌ, рЈѓрЈџрЈ│рјфрЈЏрјб, рЈЁрјЕрЈѓрЈџрЈ│рјфрЈЏрјб рЈѓрЈџрЈЊрјИрЈЌрЈјрј»рј»
Рєў№ИЈ	рјАрј│рЈЌ-рјарјдрЈўрЈЈ рјдрЈЮрЈЌ, рјцрјдрЈЁрЈ«рјДрјИрјгрјб, рјдрЈЮрЈЌ, рЈѓрЈџрЈ│рјфрЈЏрјб, рЈЁрјЕрЈѓрЈџрЈ│рјфрЈЏрјб рЈѓрЈџрЈЊрјИрЈЌрЈјрј»рј»
РєЎ№ИЈ	рјАрј│рЈЌ-рјарјдрЈЇрјдрЈѓ рјдрЈЮрЈЌ, рјцрјдрЈЁрЈ«рјцрЈЋрјхрјг, рјдрЈЮрЈЌ, рЈѓрЈџрЈ│рјфрЈЏрјб, рЈЁрјЕрЈѓрЈџрЈ│рјфрЈЏрјб рЈѓрЈџрЈЊрјИрЈЌрЈјрј»рј»
РєЕ№ИЈ	рјарјдрЈўрЈЈ рјдрЈЮрЈЌ рјарЈЋрЈ▓ рјарјдрЈЇрјдрЈѓ, рјдрЈЮрЈЌ
Рєф№ИЈ	рјарјдрЈЇрјдрЈѓ рјдрЈЮрЈЌ рјарЈЋрЈ▓ рјарјдрЈўрЈЈ, рјдрЈЮрЈЌ
Рїџ№ИЈ	рјцрЈЇрЈЌ рЈЕрЈЦ, рЈЕрЈЦ
РїЏ№ИЈ	рјарЈЪрјХрЈЇрјЕ, рЈЃрЈ▒, рЈЃрЈ▒ рјарЈЪрјарјхрЈњрјб рјарЈјрј»рј» рјарЈЇрЈєрЈЏ
Рїе№ИЈ	рјарјдрЈЎрјЦрј»рЈЇрЈЌрЈЇрјЕ рјарЈЇрЈєрЈѓрјфрЈЌрЈЇрјЕ, рЈЌрЈљрЈЁрЈЇрЈЎрЈЌ
РЈЈ№ИЈ	рјдрј┤рЈЇрЈЌ, рјдрј┤рЈЇрЈЌ рјдрЈЌ
РЈ▒№ИЈ	рјарј┤рЈФрЈЇрЈЌрЈЇрјЕ рЈЕрЈЦ, рЈЕрЈЦ
РЈ▓№ИЈ	рјарЈЪрјарјхрЈњрјб рјарЈјрј»рј», рјарЈЪрјарјхрЈњрјб рЈЕрЈЦ, рЈЕрЈЦ
РЈ│№ИЈ	рјарЈЪрјХрЈЇрјЕ, рЈЃрЈ▒, рЈЃрЈ▒ рјарЈЪрјарјхрЈњрјб рјарЈјрј»рј», рЈЃрЈ▒ рјарЈЪрјарјхрЈњрјб рјарЈјрј»рј» рЈЮ рјарЈЇрЈєрЈЏ
РЈИ№ИЈ	рјдрјЙрј»рЈЇрЈћрЈЁрјб, рјдрјЙрј»рЈЇрЈЎрЈЌ рјдрЈЌ, рјдрјЙрјИрјб, рЈћрјхрјГрјб, рЈЦрЈ│рјфрЈЌ
РЈ╣№ИЈ	рјарј┤рЈФрЈЇрЈЎрЈЌ, рјарј┤рЈФрЈЇрЈЎрЈЌ рјдрЈЌ, рјЙрјЕ рЈДрЈЁрЈЈрЈ»
РЈ║№ИЈ	рјдрЈѓрЈ▒рЈЎрЈЌ, рјдрЈѓрЈ▒рЈЎрЈЌ рјдрЈЌ, рјдрЈЋрЈ▒рЈЇрЈЏ
РЊѓ№ИЈ	m, рјдрЈљрЈєрј│, рјдрЈЋрЈ▒рЈЇрЈЏ M, рјдрЈЋрЈ▒рЈЇрЈЏ рји
Рќф№ИЈ	рјгрј┐рје рјцрЈЇрЈЌ рЈЁрјЕ рЈДрЈЁрЈЈрЈ», рЈЁрјЕ рЈДрЈЁрЈЈрЈ», рЈЌрЈјрЈЇрЈЌ
РќФ№ИЈ	рјцрЈЂрјд рјцрЈЇрЈЌ рЈЁрјЕ рЈДрЈЁрЈЈрЈ», рЈЁрјЕ рЈДрЈЁрЈЈрЈ», рЈЌрЈјрЈЇрЈЌ
РЌ╗№ИЈ	рјцрЈЂрјд рјарЈ▓рЈЪрје рЈЁрјЕ рЈДрЈЁрЈЈрЈ», рЈЁрјЕ рЈДрЈЁрЈЈрЈ», рЈЌрЈјрЈЇрЈЌ
РЌ╝№ИЈ	рјгрј┐рје рјарЈ▓рЈЪрје рЈЁрјЕ рЈДрЈЁрЈЈрЈ», рЈЁрјЕ рЈДрЈЁрЈЈрЈ», рЈЌрЈјрЈЇрЈЌ
РЌй№ИЈ	рјцрЈЂрјд рјарЈ▓рЈЪрје-рјцрЈЇрЈЌ рЈЁрјЕ рЈДрЈЁрЈЈрЈ», рЈЁрјЕ рЈДрЈЁрЈЈрЈ», рЈЌрЈјрЈЇрЈЌ
РЌЙ№ИЈ	рјгрј┐рје рјарЈ▓рЈЪрје-рјцрЈЇрЈЌ рјЙрјЕ рЈДрЈЁрЈЈрЈ», рЈЁрјЕ рЈДрЈЁрЈЈрЈ», рЈЌрЈјрЈЇрЈЌ
Рўђ№ИЈ	рјарјдрјх, рјбрјдрј», рЈЁрЈЊ рјбрјд рјАрј», рЈџрјИрЈїрЈЏ
РўЂ№ИЈ	рјцрјХрјЕрј│, рЈЎрЈ▒рЈЌрЈю рЈѓрјдрјхрЈЇрЈћрЈЁрЈЇрјгрјб
Рўѓ№ИЈ	рјарјдрЈЇрјЕ, рјарЈЊрЈЕрЈЌрЈЇрЈЎрЈЌ, рЈЌрј┐рЈгрЈЇрЈЌ
РўЃ№ИЈ	рјцрЈ┤рЈю, рјЦрЈѓрЈЦ, рјЦрЈѓрЈЦ рјарЈЇрјдрЈ»
Рўё№ИЈ	рјцрЈЪрЈЁрЈЏрјб, рЈбрЈЊрЈЦ рјЕрјдрје
Рўј№ИЈ	рЈЌрЈЪрЈЃрј«рЈЌ, рЈ┤рЈФ рЈЌрЈЪрЈЃрј«рЈЌ
РўЉ№ИЈ	рјарЈЇрЈЊрЈЁрЈЁрјб, рјДрЈЂрЈї, рјДрЈЂрЈе рјфрЈфрјИ, рјДрЈЂрЈе рјфрЈфрјИ рјарЈЇрЈЊрЈЁрЈЁрЈЁрјб
Рўћ№ИЈ	рјарјдрЈЇрјЕ, рјарЈЊрЈЊрЈФрЈЇрЈЎрЈЌ рјцрјхрЈЌрЈЌ рјарјдрЈЇрјд, рјарЈЊрЈЕрЈЌрЈЇрЈЎрЈЌ, рјцрЈЕрЈгрЈе, рЈЌрј┐рЈгрЈЇрЈЌ
РўЋ№ИЈ	рјарЈћрјХрј┤рјг, рјарЈЌрЈћрЈЇрЈЌ, рјцрјдрјХрјд, рјцрЈЌрЈърјЕ, рјцрЈЌрЈърјЕ рјарЈЌрЈћрЈЇрЈЌ, рјДрЈФ
Рўў№ИЈ	рјдрјфрЈЌ, рЈДрјдрјХрјд
РўЮ№ИЈ	рјарЈјрј», рјарЈјрј» рЈЕрЈјрј»рј▓рјб рјдрјИрј│рЈЌ, рјцрЈгрЈ▒, рјдрјИрј│рЈЌ, рјдрЈ░рЈїрЈЏ, рЈЕрЈјрЈб
Рўа№ИЈ	рјарЈ▓рј▒рј»рЈЇрЈЌ, рјцрјДрЈЏ, рјдрЈѓрЈ░рјЕ, рјфрј│рјГ рјцрЈЇрјд, рјфрј│рјГ рјцрЈЇрјд рјарј┤ рЈДрЈЊрј┐рЈФрЈЊ рЈДрјфрј│, рЈДрЈЊрј┐рЈФрЈЊ рЈДрјфрј│
Рўб№ИЈ	рјАрЈЇрјд рЈ»рЈЊрЈЏрЈЂрј», рјфрЈфрјИрјб
РўБ№ИЈ	рјарЈЊрј»рј», рјдрјЙрЈ░рј»рЈЇрЈЌ, рјфрЈфрјИрјб
Рўд№ИЈ	рјарЈѓрЈДрЈЈ рјцрјЙрЈцрјх рЈЊрЈЊрј┐рЈФрЈЇрЈЏ, рјцрЈЃрј»рЈ│рЈњрјб, рЈЊрЈЊрј┐рЈФрЈЇрЈЏ, рЈДрЈЂрЈЪрЈЌ
Рўф№ИЈ	рјбрЈЈрј│рј╗, рјцрЈЃрј»рЈ│рЈњрјб, рј╣рЈЈрј│рј╗, рЈЃрЈѕрЈЈ рјарј┤ рјцрЈЊрЈЇрЈѕрЈў
Рў«№ИЈ	рЈЁрЈЕрЈЎрј»рЈ»рЈЏ, рЈЁрЈЕрЈЎрј»рЈ»рЈЏ рјфрЈфрјх
Рў»№ИЈ	рЈћрјБрЈў, рЈЎрја, рЈџрјЙрЈЂрЈЪрЈЏ, рЈ░рјЕ, рЈ▒рЈѓ, рЈ▒рЈѓ рЈ░рјЙрјЕ
РўИ№ИЈ	рјдрЈЕрЈў, рјдрЈЕрЈў рЈЊрјГрј╣, рЈЊрјГрј╣, рЈџрјЙрЈЂрЈЪрЈЏрјб, рЈБрЈЕрЈѓрЈЈ рЈДрЈЂрЈЪрЈЎрЈЌ
Рў╣№ИЈ	рјцрјДрЈЏ, рјцрЈЊрЈЂрјфрЈ│, рјцрЈЊрЈЂрјфрЈ│ рјцрјДрЈЏ
Рў║№ИЈ	рјцрјДрЈЏ, рјцрЈцрЈБрЈЇрЈЌ, рјцрЈ»рЈфрЈљрЈбрјб, рјцрЈ░рЈЦрЈЇрјгрјб рјцрјДрЈЏ, рЈЎрЈ▒рЈЌрЈю рјарЈЪрјХрјЦ
РЎђ№ИЈ	рјарјерЈ», рјарјерЈ» рјфрЈЪрЈЇрЈЎрЈЌ
РЎѓ№ИЈ	рјарЈЇрјдрЈ», рјарЈЇрјдрЈ» рјфрЈЪрЈЇрЈЎрЈЌ
РЎѕ№ИЈ	рјцрЈЃрЈЋрјЙ рЈДрјДрЈЁрЈЇрЈЋрјЙ, рЈЃрЈѕрЈЈ рЈЊрЈЪрјХрЈЇрЈЏрј▓рјб, рЈЊрј┐рЈЕ
РЎЅ№ИЈ	рјарјДрЈЈ, рЈЃрЈѕрЈЈ рЈЊрЈЪрјХрЈЇрЈЌрј▓рјб, рЈДрјДрЈЁрЈЇрЈЋрјЙ
РЎі№ИЈ	рЈЃрЈѕрЈЈ рЈЊрЈЪрјХрЈЇрЈЌрј▓рјб, рЈЌрЈѓрЈЮрЈФ, рЈЦрј╣рјЙрЈ▒
РЎІ№ИЈ	рјарЈЊрЈ░рЈЇрјЕ, рјцрЈ»рЈЇрјд, рЈЃрЈѕрЈЈ рЈЊрЈЪрјХрЈЇрЈЌрј▓рјб
РЎї№ИЈ	рјхрЈ▓, рЈЃрЈѕрЈЈ рЈЊрЈЪрјХрЈЇрЈЌрј▓рјб, рЈбрЈЊрЈЦ
РЎЇ№ИЈ	рЈЃрЈѕрЈЈ рЈЊрЈЪрјХрЈЇрЈЌрј▓рјб, рЈЄрјхрјф
РЎј№ИЈ	рјбрјдрЈўрјГ, рјхрЈє, рЈЃрЈѕрЈЈ рЈЊрЈЪрјХрЈЇрЈЌрј▓рјб, рЈЌрјдрЈЏрЈЌ, рЈЌрјДрј┐рЈЕрЈЏрЈЇрЈЌ
РЎЈ№ИЈ	рЈЃрЈѕрЈЈ рЈЊрЈЪрјХрЈЇрЈЌрј▓рјб, рЈЇрјфрЈѕрЈ┤рЈЇ, рЈЦрЈЇрЈЏрјЙ рјарЈЊрЈерЈЇрјЕ, рЈДрЈЂрјхрЈЂ
РЎљ№ИЈ	рјарЈЅрЈѓрЈЇрјЕ, рјдрјхрЈБрЈЌрЈЇрјЕ, рЈЃрЈѕрЈЈ рЈЊрЈЪрјХрЈЇрЈЌрЈЇрј▓рјб
РЎЉ№ИЈ	рјцрјдрЈљрЈБрЈЂрЈЊ, рјДрЈѕрјфрЈѓ, рЈЃрЈѕрЈЈ рЈЊрЈЪрјХрЈЇрЈЌрј▓рјб
РЎњ№ИЈ	рјарј╣, рјарј╣ рјдрЈЁрЈЦрЈЎ, рјарЈ▒рЈЎрј», рЈЃрЈѕрЈЈ рЈЊрЈЪрјХрЈЇрЈЌрј▓рјб
РЎЊ№ИЈ	рјарЈѓрЈБрЈЌ, рјарЈБрЈЌ, рЈЃрЈѕрЈЈ рЈЊрЈЪрјХрЈЇрЈЌрЈЇрј▓рјб
РЎЪ№ИЈ	рјдрјХрјЙрЈЇрЈЌ, рЈцрјАрЈЇ, рЈцрјАрЈЇ рјарјдрЈўрЈЌрЈЇрЈЎрЈЌ, рЈФрЈЊрЈ▓рј»рЈЇрЈЌрЈГ
РЎа№ИЈ	рјарЈєрЈѓрЈ▓рЈЇрЈЌ, рјфрЈЋрЈЇрЈЌ рЈДрЈарЈ▒рјГ, рЈЌрЈЂрЈЪрЈЎрЈЌ
РЎБ№ИЈ	рјарЈєрЈѓрЈ▓рЈЇрЈЌ, рЈЌрЈЂрЈЪрЈЎрЈЌ, рЈЌрЈЊрЈЇрЈєрјИрЈѓрЈЇрЈЌ рЈДрЈарЈ▒рјГ
РЎЦ№ИЈ	рјарЈєрЈѓрЈ▓рЈЇрЈЌ, рјцрј┐рЈФ рЈДрЈарЈ▒рјГ, рЈЌрЈЂрЈЪрЈЎрЈЌ
РЎд№ИЈ	рјарЈєрЈѓрЈ▓рЈЇрЈЌ, рјдрјИрЈЅрЈЌ рЈЁрЈ» рЈДрЈарЈ▒рјГ, рЈЌрЈЂрЈЪрЈЎрЈЌ
РЎе№ИЈ	рјарЈћрјХрј┤рјгрјб, рјцрЈЌрЈърјд, рјцрЈЌрЈърјд рјдрЈЁрјфрјгрјб, рјцрЈЌрЈърјд рЈЋрјдрЈЁрјфрјгрјб, рЈЋрјдрЈЁрјфрјгрјб
РЎ╗№ИЈ	рјбрјгрјдрЈћрЈѓрЈЊрЈЇрЈЌ, рјбрјгрјдрЈћрЈѓрЈЊрЈЇрЈЌ рјфрЈфрјх
РЎЙ№ИЈ	рјбрјфрј»рЈЊ, рјбрјфрј»рЈЏрЈЅ рјерЈњрјб, рјбрјгрЈЕрЈЊрј┤рјЕ, рјцрјХрЈњрЈЇрЈћрЈЁрјб
РЎ┐№ИЈ	рјарЈ┤рј»рЈЇрЈЌ, рјдрЈЇрјЕрјХ рјарЈдрЈЎрЈЌ рјдрЈ»рјИрјб
Рџњ№ИЈ	рјгрЈЁрЈЕрјХрЈЇрЈЌ, рјгрЈЁрЈЕрјХрЈЇрЈЌ рјарј┤ рЈЌрјДрјЙрЈЇрЈЋрЈЪрЈЌ, рјгрЈћрЈѓрЈЊрЈЇрЈЌ, рЈЌрјДрјЙрЈЇрЈЋрЈЪрЈЌ
РџЊ№ИЈ	рјАрЈє рЈЦрЈ│, рјдрЈЁрј»рЈЇрЈЎрЈЌ, рјгрЈћрЈѓрЈЊрЈЇрЈЌ
Рџћ№ИЈ	рјарјхрЈЇрЈЋрјИрЈЎрЈЌ, рЈЌрЈ░рј│рЈЇрЈЌ, рЈДрЈЊрј┐рЈФрЈЊ, рЈДрЈЊрј┐рЈФрЈЊ рЈЌрЈ░рј│рЈЇрЈЌ рЈЌрјдрЈЁрј»рЈЊ
РџЋ№ИЈ	рјцрЈЊрј│рЈёрЈЇрЈў, рЈЁрЈгрЈў, рЈЁрЈгрЈў рјбрјЙрЈЊ, рЈЁрЈгрЈў рјцрЈЎрЈбрјГ
Рџќ№ИЈ	рјбрјдрЈўрјГрјбрЈџрЈ│рјфрЈЏрјб, рјбрЈЌрјдрЈўрјГ, рјбрЈЌрјдрЈўрјГ рЈЌрјдрЈЏрЈЌ, рјцрЈЊрјерЈЇрЈЎрЈЌ, рјгрЈћрЈѓрЈЊрЈЇрЈЌ, рЈѓрЈџрЈ│рјфрЈЏрјб, рЈЃрЈѕрЈЈ рЈЊрЈЪрјХрЈЇрЈЌрј▓рјб, рЈЌрјдрЈЏрЈЌ
РџЌ№ИЈ	рјарјфрЈЎрЈЌ, рјгрЈћрЈѓрЈЊрЈЇрЈЌ, рЈЊрЈЁрЈЇрЈЌрЈЇрјгрјб
РџЎ№ИЈ	рјгрЈћрЈѓрЈЊрЈЇрЈЌ, рјгрЈћрЈЁрЈЎрЈЌ
РџЏ№ИЈ	рјбрјдрЈЊ, рјбрјдрЈЊ рјфрЈфрјИ, рЈёрЈгрј»рЈ│рЈњрјЙ
Рџа№ИЈ	рјдрјЙрЈ░рј»рЈЇрЈЌ
РџА№ИЈ	рјарјдрјЙрјхрЈЇрјЕ рјцрЈ«рЈѓрјИрјб, рјарјЙрјдрјхрЈЇрјЕ, рјарјЙрјдрјхрЈЇрјЕ рјгрЈЎрЈЌ, рјарјЙрјдрјхрЈЇрјЕ рЈёрЈЊрЈѓрјгрјг, рјарјЙрјдрјхрЈЇрјг, рјцрЈЪрЈѓрјЕрЈЊ рјарјЙрјдрјхрЈЇрјЕ, рјдрЈѓрЈ░рјЕ
Рџф№ИЈ	рјцрЈЂрјд рјдрЈЋрЈ»рЈЇрЈЏ, рјцрЈЎрЈбрЈњ, рјдрЈљрЈєрјИ
РџФ№ИЈ	рјцрЈЎрЈбрЈњ, рјдрЈљрЈєрјИ, рјгрј┐рјерјб рјдрЈљрЈєрјИ
Рџ░№ИЈ	рјарЈ▓рј▒рј»рЈЇрЈЌ, рјДрЈЂрЈїрјб
Рџ▒№ИЈ	рјарЈ▓рј▒рј»рЈЇрЈЌ, рјдрЈѓрЈљрЈЌ рјфрЈЇрЈЊ рјдрЈЪрЈЌ, рјфрЈЇрЈЊ, рјфрЈЇрЈЊ рјдрЈЪрЈЌ, рЈЊрјЙрЈЊрЈѓрЈЈрЈЇрјгрјб
Рџй№ИЈ	рјарјЙрЈ»рЈѓрЈќрЈЇрјЕ рЈЇрЈєрЈърЈЇрЈЌ, рјдрЈ»рЈѓрЈќрЈЇрЈЌ рЈЇрЈєрЈърЈЇрЈЌ, рЈЇрЈєрј┤рЈЇрЈЌ
РџЙ№ИЈ	рјарј│рЈЇрјдрЈЪрЈЌ, рЈЇрЈєрЈърЈЇрЈЌ
РЏё№ИЈ	рјцрЈ┤рЈю, рјЦрЈѓрЈЦ, рјЦрЈѓрЈЦ рјарЈЇрјдрЈ», рјЦрЈѓрЈЦ рјарЈЇрјдрЈ» рЈѓрјФрЈўрј▓рјЙ
РЏЁ№ИЈ	рјцрјХрјЕрј│, рЈЁрЈЊ, рЈЁрЈЊ рјБрЈѓрЈЌрЈю рЈёрЈЏрјЙ рјцрјХрјЕрјИрјб
РЏѕ№ИЈ	рјарјдрЈЇрјЕ, рјарЈ┤рЈЊрЈєрјХрЈЇрјЕ, рјцрјХрјЕрј│, рјцрјХрјЕрј│ рјарјЙрјдрјхрЈЇрјЕ рјарј┤ рјарјдрЈЇрјЕ
РЏЈ№ИЈ	рјарЈѓрЈЇрјфрЈЇрјгрјб, рјгрЈћрЈѓрЈЊрЈЇрЈЌ, рЈЌрјДрјЙрЈЇрЈЋрЈЪрЈЌ
РЏЉ№ИЈ	рјарјхрЈЇрЈЄрЈџрЈг, рјарјхрЈЇрЈЋрјИрЈЎрЈЌ, рјарјхрЈЇрЈџрјХрЈЌ, рјарЈЊрЈЇрЈЋрјхрЈЇрјЕ рЈДрјИрЈФрЈЇрЈЊрЈЂрј» рјцрјхрЈЇрЈџрјХрЈЌ, рјцрјДрЈЏ, рЈЊрЈЊрј┐рЈФрЈЇрЈЏрјб
РЏЊ№ИЈ	рјцрјЙрЈЊрЈЋрЈњрЈЌ, рЈДрјЙрЈЊрЈЋрЈњрЈЌ
РЏћ№ИЈ	рјбрЈ»рЈЏрЈЂрЈЌрјб рЈѓрјерЈњрјЙ, рјЦрЈЮ, рјЦрЈЮ рјарЈ┤рЈЇрЈЌ, рјдрЈЁрЈЇрЈЎрЈЇрјд, рјфрЈфрјХрЈЌ, рЈѓрјерЈњрјЙ, рЈЎрЈєрј┤рји рЈЋрЈЎрј▓рјб
РЏЕ№ИЈ	рјарјЙрЈЁрЈЊрЈЌрЈЇрЈЌрЈЇрјгрјб, рјцрЈЃрј»рЈ│рЈњ, рЈЈрЈѓрЈЎ, рЈЈрЈѓрЈЎрј» рјарЈцрјхрЈЇрЈЏрјб
РЏф№ИЈ	рјцрЈЃрј»рЈ│рЈњрјб, рЈЊрЈЊрј┐рЈФрЈЇрЈЏ, рЈДрЈЂрЈЪрЈЌ, рЈДрЈѓрј│рЈФрЈЇрЈЌ
РЏ░№ИЈ	рјцрЈЁрЈЊрЈбрјб
РЏ▒№ИЈ	рјарјдрЈЇрјЕ, рјарЈЊрЈЕрЈЌрЈЇрЈЎрЈЌ, рјарЈЊрЈЕрЈЌрЈЇрЈЎрЈЌ рјдрЈЎрјб рЈЦрЈ», рЈЁрЈЊ рјбрјд рјАрј»
РЏ▓№ИЈ	рјарј╣ рјцрјЙрЈёрјфрјбрЈЇрЈЌ
РЏ│№ИЈ	рјарЈћрј┤рЈњ, рјдрЈЊрЈў рјЙрј┐ рјарЈћрј┤рЈњ, рјфрЈЇрЈЏрЈѓрЈЇрЈЌ рЈЇрЈєрЈърЈЇрЈЌ
РЏ┤№ИЈ	рЈЌрјдрЈљрј»рЈЇрЈЌрЈЇрјЕ, рЈЦрЈ│, рЈ┤рЈФ рјарЈБрЈЇрјЕ
РЏх№ИЈ	рјарј║рЈЅрј», рјцрЈЎрЈбрЈњрјб рјАрЈЊрЈЇрЈЌ, рЈЌрЈЊрЈЦрј»рЈЇрЈЌрЈЇрјЕ, рЈЦрЈ│, рЈЦрЈ│ рјарЈѓрјЕрЈЇрјЕ
РЏи№ИЈ	рјЦрЈЃрЈЦ, рЈЌрЈЪрјЙрЈњрЈЎрЈЌ, рЈ┤рЈФ рЈЌрЈЪрјЙрЈњрЈЎрЈЌрЈЇрјЕ
РЏИ№ИЈ	рјцрЈЂрЈЇрЈЊрј│, рјцрЈЂрЈЇрЈЊрј│ рЈЊрјЙрЈЪрјЙрЈњрЈЌрј▓рјб, рЈЊрјЙрЈЪрјЙрЈњрЈЌрј▓рјб
РЏ╣№ИЈ	рЈЇрЈєрЈърЈЇрЈЌ, рЈ┤рЈФ рЈЇрЈєрЈърЈЇрЈЌ рјарЈЊрЈЊрјерјг
РЏ║№ИЈ	рјдрјхрЈдрЈЏ, рЈЊрЈѓрјхрЈдрЈЏрЈЇрјгрјб
РЏй№ИЈ	рјарјфрј▓рЈЇрЈЎ, рјарјфрј▓рЈЇрЈЎрЈЌ рјцрЈѓрјФрјЕрЈЇрЈЌ, рјарјФрјЕрЈЇрЈЌ, рјцрЈЎрЈбрЈњрјб, рјерЈїрјхрЈѓ рјдрЈїрЈЎрЈ»рЈЇрјЕ, рЈ░рЈЈ
Рюѓ№ИЈ	рјарјдрјхрЈЇрјд, рјгрЈћрЈѓрЈЊрЈЇрЈЌ, рЈЌрјхрЈЇрЈЎрЈЌ
Рюѕ№ИЈ	рЈЦрЈ│ рјдрЈЃрј»рјхрЈЎрј»
РюЅ№ИЈ	рјарјЙрјдрјхрЈЇрјЕ рјфрЈфрјх, рјфрЈфрјх, рјфрЈфрјх рјарјИрЈЎрЈЌ
Рюї№ИЈ	v, рјцрЈЊрЈарЈњ, рјцрЈЊрЈарЈњ рјцрЈгрЈ▒, рјцрЈгрЈ░рЈѓ
РюЇ№ИЈ	рјцрЈгрЈ▒, рјцрЈгрЈ▒ рјфрЈфрј│рЈЁрјб, рјфрЈфрјХрЈЌ
РюЈ№ИЈ	рЈЌрјфрЈфрјХрЈЎрЈЌ
Рюњ№ИЈ	рјгрј┐рје рЈФрјфрЈЇрЈЊрЈ┤, рЈЌрјфрЈфрјХрЈЌ, рЈФрјфрЈЇрЈЊрЈ┤
Рюћ№ИЈ	рјарјдрЈЏрЈЌ, рјцрЈЊрјерЈЊ рјарјдрЈЏрЈЌ рјцрЈЎрЈфрјИ, рјцрЈЎрЈфрјИ
Рюќ№ИЈ	x, рјарЈјрЈњрЈЌ, рјцрЈЊрјерЈЊ рЈЌрЈјрЈбрјб x, рјДрЈЂрЈЅрјбрЈЇрЈЌ, рЈЌрЈјрЈбрјб
РюЮ№ИЈ	рјцрЈЃрј»рЈ│рЈњрјб, рј┤рЈћрЈѓ рјцрјЙрЈцрјх рЈЊрЈЊрј┐рЈФрЈЇрЈЏ, рЈЊрЈЊрј┐рЈФрЈЇрЈЏ, рЈДрЈЂрЈЪрЈЌ
РюА№ИЈ	рјарЈѓрЈДрЈЈ, рјарЈДрЈЈ, рјцрЈЃрј»рЈ│рЈњрјб, рЈЃрЈѕрЈЈ, рЈЃрЈѕрЈЈ рЈЋрЈФ, рЈЋрЈФ
Рю│№ИЈ	рјцрЈЎрЈфрјИ, рЈДрЈЂрј│-рЈДрЈ»рЈЊрЈў рјцрЈЎрЈфрјИ
Рю┤№ИЈ	рЈЃрЈѕрЈЈ, рЈДрЈЂрј│-рЈЌрјфрЈЇрЈЊрЈ▒ рЈЃрЈѕрЈЈ
РЮё№ИЈ	рјцрЈГрЈћрЈЁрјб, рјцрЈ┤рЈю, рјЦрЈѓрЈЦ
РЮЄ№ИЈ	рјцрЈЦрЈЇрЈЊрјирјЕрЈЇрјЕ
РЮЊ№ИЈ	рјарЈЊрЈЏрЈЏрј▓рЈЇрјЕ рјарЈЇрЈЊрЈЁрЈЁ, рјарЈЏрЈЏрј▓рЈЇрјЕ, рјцрЈЎрЈфрјИ, рЈџрЈЎрЈфрјИ
РЮЌ№ИЈ	рјфрЈфрјИ, рјГрЈЃрЈ┤рјг рјцрЈЎрЈфрјИ, рЈЇрЈЊрЈ▒ рјЦрјДрЈЂрјгрјб, рЈџрЈЎрЈфрјИрјб
РЮБ№ИЈ	рјцрЈЊрјерЈЊ рјцрј┐рЈФ рЈЇрЈЊрЈ▒ рјЦрјДрЈЂрјгрјб, рјфрЈфрјИ, рЈЇрЈЊрЈ▒ рјЦрјДрЈЂрјгрјб, рЈџрЈЎрЈфрјИрјб
РЮц№ИЈ	рјцрј┐рЈФ, рјЕрјдрје рјцрј┐рЈФ
РъА№ИЈ	рјарјдрЈўрЈЈ рјдрЈЮрЈЌ, рјдрЈЮрЈЌ, рјДрјИрјгрјб, рЈѓрЈџрЈ│рјфрЈЏрјб, рЈДрјхрЈЇрјерЈЊ
Рц┤№ИЈ	рјарјдрЈўрЈЈ рјдрЈЮрЈЌ рјарЈЋрЈ▓ рјдрјИрј│рЈЌрјарјдрЈў, рјдрЈЮрЈЌ
Рцх№ИЈ	рјарјдрЈўрЈЈ рјдрЈЮрЈЌ рјарЈЉрЈ▓ рјАрј│рЈЌрјарјдрЈў, рјАрј│рЈЌрјарјдрЈў, рјдрЈЮрЈЌ
РгЁ№ИЈ	рјарјдрЈЇрјдрЈѓ рјдрЈЮрЈЌ, рјцрЈЋрјхрјгрјб, рјдрЈЮрЈЌ, рЈѓрЈџрЈ│рјфрЈЏрјб, рЈДрЈѓрЈЇрјерЈЊ
Ргє№ИЈ	рјцрЈ┤рЈбрјб, рјдрјИрј│рЈЊрјдрЈў рјдрЈЮрЈЌ, рјдрЈЮрЈЌ, рЈѓрЈџрЈ│рјфрЈЏрјб, рЈДрјхрЈЇрјерЈЊ
РгЄ№ИЈ	рјАрј│рЈЌ, рјАрј│рЈЌ рјдрЈЮрЈЌ, рјцрјдрЈЁрЈ«, рјдрЈЮрЈЌ, рЈѓрЈџрЈ│рјфрЈЏрјб, рЈДрјхрЈЇрјерЈЊ
РгЏ№ИЈ	рјгрј┐рје рјцрЈћрјЙ рјЙрјЕ рЈДрЈЁрЈЈрЈ▒, рЈЁрјЕ рЈДрЈЁрЈЈрЈ», рЈЌрЈјрЈЇрЈЌ
Ргю№ИЈ	рјцрЈЂрјд рјцрЈћрјЙ рЈЁрјЕ рЈЌрЈДрЈЁрЈЈрЈ», рЈЁрјЕ рЈДрЈЁрЈЈрЈ», рЈЌрЈјрЈЇрЈЌ
РГљ№ИЈ	рјцрЈЂрјд рјарЈ░рЈЪ рЈЃрЈѕрЈЈ, рЈЃрЈѕрЈЈ
РГЋ№ИЈ	o, рјцрЈЊрјерЈЊ рјцрЈћрјЙ рјдрЈљрЈєрј│, рјцрЈЊрјерЈЊ рјцрЈћрјЙ рјгрЈЕрЈЋрЈ▒рЈЊ, рјдрЈљрЈєрј│
сђ░№ИЈ	рјарјхрЈљрЈ░рјГ, рјарјхрЈљрЈ░рјГ рјцрЈЊрЈѓрЈ┤рјб, рјцрЈЊрЈѓрЈ┤рјб, рЈџрЈЎрЈфрјИ
сђй№ИЈ	рјбрјдрЈЏ рјдрЈЂрЈЪрЈ┤рЈЇрЈЌ рјцрЈЎрЈфрјИ, рјфрЈфрјх, рЈ▒рјдрјЦрјб
сіЌ№ИЈ	рјдрЈЁрЈЇрЈЎрЈЇрјг, рЈБрЈЕрЈѓрЈЈ, рЈБрЈЕрЈѓрЈЈ Рђюрјарјхрј«рјхрЈЇрЈЌРђЮ рјдрЈЌ, Рђюрјарјхрј«рјхрЈЇрЈЌ Рђю, уЦЮ
сіЎ№ИЈ	рјцрЈЋрјхрЈЊ, рЈБрЈЕрЈѓрЈЈ рјдрЈЁрЈЇрЈЎрЈЇрјг, рЈБрЈЕрЈѓрЈЈ РђюрјцрЈЋрјхрЈЊРђЮ рЈЌрјд, уДў
­Ъђё№ИЈ	рјЕрјдрје, рј╣рЈдрјд, рј╣рЈдрЈѓрјЕ рјЕрјдрје рјАрЈє рЈћрЈ▓рјГрјх, рЈЌрЈЂрЈЪрЈЎрЈЌ
­ЪЁ░№ИЈ	A рјдрЈЌ (рјбрЈ│рЈЇрЈЌ рјЕрјд рјБрЈЂрј▓рјб), a, рјбрЈ│рЈЇрЈЌ рјЕрјд рјБрЈЂрј▓рјб
­ЪЁ▒№ИЈ	B рјдрЈЌ ( рјбрЈ│рЈЇрЈЌ рјЕрјд рјБрЈЂрј▓рјб), b, рјбрЈ│рЈЇрЈЌ рјЕрјд рјБрЈЂрј▓рјб, рЈ┤ рјдрЈЌ (рјбрЈ│рЈЇрЈЌ рјЕрјд рјБрЈЂрј▓рјб)
­ЪЁЙ№ИЈ	O рјдрЈЌ (рјбрЈ│рЈЇрЈЌ рјЕрјд рјБрЈЂрј▓рјб), O рјдрЈЌ (рјбрЈ│рЈЇрЈЌ рјЕрјд рјцрЈЂрј▓рјб), o, рјбрЈ│рЈЇрЈЌ рјЕрјд рјБрЈЂрј▓рјб
­ЪЁ┐№ИЈ	рЈЎрЈєрј┤рјх рјдрЈЌ, рЈб рјдрЈЌ
­Ъѕѓ№ИЈ	рјДрЈћрјДрјЙ, рЈБрЈЕрЈѓрЈЈ, рЈБрЈЕрЈѓрЈЈ РђюрјарЈЊрЈѓрЈЪрЈЌрјбРђЮ рјдрЈЌ, РђюрјарЈЊрЈѓрЈЪрЈЌрјбРђЮ, сѓх
­Ъїј№ИЈ	рјарј║рјхрјДрЈЈ, рјАрјХрј», рјАрјХрј» рЈЌрЈЪрјХрЈЇрЈћрЈЁ, рјАрјХрј» рЈЌрЈЪрјХрЈЇрЈћрЈЁрјб рјгрЈѓрјерЈњрјб рЈѓрјгрЈЂрј» рјарј╣рЈ░рјх
­ЪїЋ№ИЈ	рјДрјх рјДрј│, рЈЁрЈЊ рјцрЈњрјб рјАрј», рЈЁрЈЊ рјцрЈњрјб рјАрј» рјДрјх рјДрј│
­Ъїю№ИЈ	рјБрЈѓрјб рјЕрЈёрјЕрЈЌ рјцрЈњрјб рјАрј» рЈЁрЈЊ рјЙрЈЇрјЕ рјцрјДрЈЏ, рјцрјДрЈЏ, рјЕрЈёрјЕрЈЌ, рЈЁрЈЊ рјцрЈњ рјАрј»
­ЪїА№ИЈ	рјцрЈЌрЈърјгрјб рјцрјдрјЙрЈ« рјарЈјрј»рј», рЈЎрЈ▒рЈЌрЈю рЈѓрјдрјхрЈЇрЈћрЈЁрЈЇрјгрјб
­Ъїц№ИЈ	рјцрјХрјЕрј│, рЈЁрЈЊ, рЈЁрЈЊ рјбрјд рјАрј» рЈДрЈўрЈЇрЈЊ рјцрЈЇрЈЌрјб рЈДрјХрјЕрјхрјб рјБрЈѓрЈЌрЈбрјб
­ЪїЦ№ИЈ	рјцрјХрјЕрј│, рЈЁрЈЊ, рЈЁрЈЊ рјбрјд рјАрј» рЈДрЈўрЈЇрЈЊ рјцрЈћрјЙ рЈДрјХрјЕрјИрјб рјБрЈѓрЈЌрЈбрјб
­Ъїд№ИЈ	рјарјдрЈЇрјЕ, рјцрјХрјЕрј│, рЈЁрЈЊ рјбрјд рјАрј», рЈЁрЈЊ рјбрјд рјАрј» рЈДрЈўрЈЇрЈЊ рјарјдрЈЇрјЕрјб рЈДрјХрјЕрјИрјб рјБрЈѓрЈЌрЈбрјб
­ЪїД№ИЈ	рјарјдрЈЇрјЕ, рјцрјХрјЕрј│, рјцрјХрјЕрј│ рјарјдрЈЇрјЕ
­Ъїе№ИЈ	рјцрјХрјЕрј│, рјцрјХрјЕрј│ рјЦрЈѓрЈЦ, рјцрЈ┤рЈЮ, рјЦрЈѓрЈЦ
­ЪїЕ№ИЈ	рјарјЙрјдрјхрјГ, рјцрјХрјЕрј│, рјцрјХрјЕрј│ рјарјЙрјдрјхрјГ
­Ъїф№ИЈ	рјарјдрјирјд, рјарјдрјирјд рјцрЈћрјЙ, рјцрјХрјЕрј│
­ЪїФ№ИЈ	рјцрјХрјЕрј│, рЈЕрјХрЈЈ
­Ъїг№ИЈ	рјцрјДрЈЏ, рјцрјХрјЕрј│, рјдрЈЃрјИрЈЇрјг, рјдрЈЃрјИрЈЇрјг рјцрјИрЈЏ
­ЪїХ№ИЈ	рјцрЈЌрЈърјЕ, рјцрЈЌрЈърјЕ рЈЌрЈєрЈ▓рЈЌ, рЈЌрЈєрЈ▓рЈЌ
­ЪЇИ№ИЈ	рјарЈЋрЈ»рЈЁрјб рјарЈЌрЈћрЈЇрЈЌ рјцрјИрЈїрЈЌ, рјарЈЌрЈћрЈЇрЈЌ, рјарЈ»рЈћрјЙрјИ, рјцрјИрЈїрЈЌ
­ЪЇй№ИЈ	рјарЈЊрЈЇрЈЊрЈ┤рј▓рЈЇрјЕ, рјарЈќрјхрЈЎ, рјарЈ░рј│рЈЇрЈЌ, рЈ┤рјЕ, рЈ┤рјЕ рјарј┤ рјарЈ░рј│рЈЇрЈЌ рЈќрјхрЈЎрЈЃ
­ЪјЊ№ИЈ	рјарјхрЈЇрЈЄрЈћрЈг, рјарјхрЈЇрЈџрјХ, рјарјЙрјхрј«рјхрјгрјб, рЈЊрЈѓрЈЇрЈєрЈЌрЈЇрјгрјб, рЈЌрј┐рЈгрЈЇрЈЌ, рЈЌрЈЇрЈєрЈЌрЈЇрјЕ рјцрјхрЈЇрЈџрјХ
­Ъјќ№ИЈ	рјарјЙрјхрј«рјхрЈЇрЈЌрЈЇрјгрјб, рјарЈѓрЈ▓рЈЇрјЕ, рјарЈѓрЈ▓рЈЇрјЕ рЈћрјирјЕрЈЇрјЕ, рЈћрЈЁрјЕрЈЇрјЕ
­ЪјЌ№ИЈ	рјарјЙрјхрј«рјхрЈЇрЈЌрЈЇрјгрјб, рјарЈЁрЈЊрЈЌрЈЇрЈЎрЈЌ, рјарЈЁрЈЊрЈЌрЈЇрЈЎрЈЌ рјарЈЄрЈАрЈЇрЈЌ, рјарЈЄрЈАрЈЇрЈЌ
­ЪјЎ№ИЈ	рјдрЈѓрЈ▒рЈЇрјЕ, рЈЇрЈЊрЈ▒ рјдрЈЃрЈ┤рјхрЈЇрЈЌрЈЇрјЕ, рЈЌрјДрЈЃрјЕрЈЇрЈЌ, рЈДрЈѓрЈЃрјЕрЈЇрЈЎрЈЌ рјДрЈЁрЈЉрјИ, рЈДрЈѓрЈЃрјЕрЈЇрЈЎрЈЌ рјДрЈЁрЈЉрјИ рЈЇрЈЊрЈ▒ рјдрЈЃрЈ┤рјхрЈЇрЈЌрЈЇрјЕ
­Ъјџ№ИЈ	рјарЈ▓рЈЪрЈЇрјЕ, рјцрЈЕрЈѓрЈЋрЈЇрјЕ, рјцрЈЕрЈѓрЈЋрЈЇрјЕ рјарЈ▓рЈЪрЈЇрјЕ, рЈЌрјДрЈЃрјЕрЈЇрЈЌ
­ЪјЏ№ИЈ	рјарј»рјИрЈЇрЈЌ, рјарј»рјИрЈЇрЈЌ рЈЌрјдрЈѓрЈ▒рЈЎрЈЌ, рЈЌрјдрЈѓрЈ▒рЈЎрЈЌ, рЈЌрјДрЈЃрјЕрЈЇрЈЌ
­Ъјъ№ИЈ	рјарЈЌрЈ┤рј│рЈЌрЈЇрјЕ, рјарЈЌрЈ┤рј│рЈЌрЈЇрјЕ рјдрЈЪрЈЎрЈЌ, рјдрЈЪрЈЎрЈЌ, рЈЌрјЙрЈЌрЈ┤рј│рЈЏрЈЇрјг, рЈЌрЈЊрЈ┤рј│рЈЏрЈЇрјЕ
­ЪјЪ№ИЈ	рјарЈѕрЈ┤рЈЎрЈЌ, рјарЈѕрЈ┤рЈЎрЈЌ рјфрЈфрјх, рјфрЈфрјх
­ЪјД№ИЈ	рјарЈЪрјцрЈЇрЈЎрЈЌ, рЈЌрЈЪрјцрЈЇрЈЎрЈЌ
­Ъјг№ИЈ	рјарЈЌрЈ┤рј│рЈЏрЈЇрјЕ, рЈЌрЈЈрЈЏрЈѓрјГ, рЈЌрЈЈрЈЏрЈѓрјГ рЈ»рЈќрјЙ
­ЪјГ№ИЈ	рјарјхрјгрЈџрјХрјб, рјарЈЏрЈЂрјИрЈЇрјгрјб, рјцрјЙрЈЏрЈЂрЈЪрЈЌрјб, рјЙрјЙрЈЏрЈЂрјхрЈЇрјгрјб, рЈЌрЈЪрјХрЈЇрЈћрЈЁрјб
­Ъј«№ИЈ	рјарЈЊрЈ┤рјхрЈЏрЈЇрјЕ рЈЌрЈЂрјхрЈЎрЈЌ, рјерЈўрЈ┤рЈЇрЈЌ, рЈЌрЈЂрЈЪрЈЎрЈЌ
­ЪЈѓ№ИЈ	рјЦрЈѓрЈЦ, рјЦрЈѓрЈЦ рјарЈЪрјЙрЈњрЈЎрЈЌ, рјЦрЈѓрЈЦ рЈЌрЈЪрјЙрЈњрЈЎрЈЌ, рЈЌрЈЪрјЙрЈњрЈЎрЈЌ
­ЪЈё№ИЈ	рјарј╣ рЈЊрЈЇрЈЌрј│рЈЂрјг рјАрЈЎрј», рЈ┤рЈФ рјарј╣ рЈЊрЈЇрЈЌрј│рЈЂрјг рјАрЈЎрј»
­ЪЈє№ИЈ	рјарЈЊрЈїрЈЁ, рјарЈЊрЈњрЈЁ
­ЪЈі№ИЈ	рјарЈЊрЈг, рЈ┤рЈФ рјарЈЊрЈг
­ЪЈІ№ИЈ	рјарјхрЈїрј│рЈЌрЈЇрјг, рјцрЈЊрјерЈЊ, рЈ┤рЈФ рЈЊрјхрЈїрј│рЈЌрЈЇрјгрјб рЈДрЈЊрјерЈЊ
­ЪЈї№ИЈ	рјарЈЈрЈ┤рЈФ рјфрЈЇрЈЏрЈѓрј▓рјб рЈЇрЈєрЈърЈЇрЈЌ, рјфрЈЇрЈЏрЈѓрЈЇрЈЌ рЈЇрЈєрЈърЈЇрЈЌ, рЈЇрЈєрЈърЈЇрЈЌ
­ЪЈЇ№ИЈ	рјарЈЎрјЕрЈ»рЈЇрЈЌ, рЈћрјх рЈЌрјдрЈЕрЈў рјарјЕрјИрЈЎрЈЌ
­ЪЈј№ИЈ	рјарЈЎрјЕрЈ»рЈЇрЈЌ, рјарЈЎрјЕрЈ»рЈЇрЈЌ рЈЎрЈєрј┤рји, рЈЎрЈєрј┤рји
­ЪЈћ№ИЈ	рјцрЈЁрЈЊрЈбрјб, рјцрЈ┤рЈЮ, рјЦрЈЃрЈЦ, рјЦрЈЃрЈЦ-рЈџрЈГрЈЮрјЦрјб рЈџрЈЁрЈЊрЈбрјб
­ЪЈЋ№ИЈ	рЈЊрЈѓрјхрЈдрЈЏрЈЇрјгрјб
­ЪЈќ№ИЈ	рјарЈЊрЈЕрЈЌрЈЇрЈЎрЈЌ, рЈЃрЈ│рј», рЈЃрЈ│рј» рјарЈЊрЈЕрЈЌрЈЇрЈЎрЈЌ
­ЪЈЌ№ИЈ	рЈЊрјБрЈЂрЈЇрјерЈЇрјгрјб рЈЌрјЙрЈЂрЈЇрјерЈЇрјЕ, рЈЌрјЙрЈЂрЈЇрјерЈЇрјЕ
­ЪЈў№ИЈ	рЈЌрјдрјхрЈдрЈЋ
­ЪЈЎ№ИЈ	рјдрЈџрј▓рјб, рјдрЈџрј▓рјб рјарЈЇрЈЏрјб
­ЪЈџ№ИЈ	рјарЈЂрЈЇрјдрЈгрЈЇрјд, рјарЈЂрЈЇрјдрЈгрЈЇрјд рјдрјхрЈдрЈЋ, рјдрјхрЈдрЈЋ
­ЪЈЏ№ИЈ	рјцрЈфрЈў, рјцрЈфрЈў рјарЈЊрЈЂрјИрјб
­ЪЈю№ИЈ	рјбрјфрЈЏ
­ЪЈЮ№ИЈ	рјбрјфрЈЏ, рјбрјфрЈЏ рјцрјдрЈџрЈЏрјб, рјцрјдрЈџрЈЏрјб
­ЪЈъ№ИЈ	рјарЈ░рјх рјАрЈЊрЈЇрЈЌрјб, рјбрјгрјЙрЈЋрјЙ рјарЈ░рјх рјАрЈЊрЈЇрЈЌрјб
­ЪЈЪ№ИЈ	рјцрјЙрј┤рЈЁрЈЌ
­ЪЈа№ИЈ	рјБрЈфрЈЁрЈњрјб, рјдрјхрЈдрЈЋ
­ЪЈГ№ИЈ	рјарЈЊрЈЂрјИрјб, рјфрј▒рЈЇрЈЌ рјцрЈЃрЈбрЈЌ
­ЪЈ│№ИЈ	рјарјхрЈљрЈ░рЈЇрјг, рјцрЈЂрјд рјдрЈЊрЈў
­ЪЈх№ИЈ	рјарјДрЈЂрЈЇрЈЌ, рјдрјфрЈЌ
­ЪЈи№ИЈ	рјфрЈфрјИрјб
­Ъљѕ№ИЈ	рјдрјЙрЈбрЈЌ, рЈфрЈї
­ЪљЋ№ИЈ	рјдрјЙрЈбрЈЌ, рјЕрјх
­ЪљЪ№ИЈ	рјарЈѓрЈћрјх рјарЈБрЈЌ, рјарЈБрЈЌ, рЈЃрЈѕрЈЈ рЈЊрЈЪрјХрЈЇрЈЌрј▓рјб
­Ъљд№ИЈ	рЈЦрЈЇрЈє
­Ъљ┐№ИЈ	рјЕрЈ│рјд
­ЪЉЂ№ИЈ	рјарјдрЈў, рјЦрЈ░рјИрјб
­ЪЉѓ№ИЈ	рјЦрЈ░рјИрјб, рјдрј┤рЈѓ
­ЪЉє№ИЈ	рјарЈјрј», рјарЈЈрЈЂрјд, рјБрЈѓрЈЌрЈюрјфрЈ»рЈЌ рјарЈЇрЈЊрЈЕрЈЏрЈЇрЈЌ рЈЕрЈјрј»рј▓рјб рјдрјИрј│рЈЊрјгрЈў, рјцрЈгрЈ▒, рјдрјИрј│рЈЌ, рјдрЈ░рЈїрЈЏ, рЈЕрЈјрЈб
­ЪЉЄ№ИЈ	рјарЈјрј», рјАрј│рЈЌ, рјБрЈѓрЈЌрЈюрјфрЈ»рЈЌ, рјБрЈѓрЈЌрЈюрјфрЈ»рЈЌ рјарЈЇрЈЊрЈЕрЈЏрЈЇрЈЌ рЈЕрЈјрј»рј▓рјб рјАрј│рЈЌ, рјцрЈгрЈ▒, рјдрЈ░рЈїрЈЏ, рЈЕрЈјрЈб
­ЪЉѕ№ИЈ	рјарЈјрј», рјБрЈѓрЈЌрЈюрјфрЈ»рЈЌ, рјБрЈѓрЈЌрЈюрјфрЈ»рЈЌ рјарЈЇрЈЊрЈЕрЈЏрЈЇрЈЌ рјарЈјрј» рјарјдрЈЇрјдрЈѓ, рјцрЈгрЈ▒, рјдрЈ░рЈїрЈЏ, рЈЕрЈјрЈб
­ЪЉЅ№ИЈ	рјарЈјрј», рјБрЈѓрЈЌрЈюрјфрЈ»рЈЌ, рјБрЈѓрЈЌрЈюрјфрЈ»рЈЌ рјарЈЇрЈЊрЈЕрЈЏрЈЇрЈЌ рјарЈјрј» рјарјдрЈўрЈЈ, рјцрЈгрЈ▒, рјдрЈ░рЈїрЈЏ, рЈЕрЈјрЈб
­ЪЉЇ№ИЈ	+1, рјцрЈћрјЙ рјЦрјдрЈ░рЈїрЈЏ, рјцрЈћрјЙ рјдрЈ░рЈїрЈЏ рјцрјхрЈїрј│рЈЊ, рјцрЈгрЈ▒, рјдрјИрј│рЈЊрјгрЈў
­ЪЉј№ИЈ	-1, рјАрј│рЈЌ, рјцрЈћрјЙ рјдрЈ░рЈїрЈЏ, рјцрЈћрјЙ рјдрЈ░рЈїрЈЏ рјАрј│рЈЌрЈю, рјцрЈгрЈ▒
­ЪЉЊ№ИЈ	рјарјдрЈў, рЈЌрјдрЈўрЈЁрЈЌ, рЈЌрј┐рЈг
­ЪЉф№ИЈ	рЈЈрЈЊрЈЂрјИрјб
­ЪЉй№ИЈ	рјарЈЈрЈ┤рЈФ, рјбрјЙ рЈѓрЈЊрЈ│рјХрЈњ, рјбрјЙ рЈѓрЈЊрЈ│рјХрЈњрјб, рјцрјДрЈЏ, рјфрЈЪрЈЇрЈЌ рЈѓрјерЈњрјЙ рјдрЈЃрј»рјхрЈЎрј», рј░рЈЕрЈѓрјерЈњрјЙ
­ЪњБ№ИЈ	рјарЈћрЈЇрјЕрЈЇрјЕ, рјцрЈгрЈЪрЈЌ
­Ъњ░№ИЈ	рјарЈЋрј│, рјарЈЋрј│ рЈЋрјдрјХрЈЌ, рјарЈЋрј│рЈЋрјдрјХрЈЌ, рјцрЈЃрЈЇрЈЊ, рЈЋрјдрјХрЈЌ
­Ъњ│№ИЈ	рјарЈєрЈѓрЈ▓рЈЇрЈЌ, рјарЈЊрЈџрЈЇрјЕ рЈєрЈѓрЈ▓рЈЇрЈЌ, рјарЈЊрЈџрЈЌрјб, рјарЈЋрј│, рјарЈЋрј│ рЈЌрЈЌрјб
­Ъњ╗№ИЈ	pc, рјарјдрЈЎрјЦрј»рЈЇрЈЌ рјарЈЇрЈєрЈѓрјфрЈЌрЈЇрјЕ, рјарЈёрјхрЈЇрЈЌ рјарјдрЈЎрјЦрј»рЈЇрЈЌ рјарЈЇрЈєрЈѓрјфрЈЌрЈЇрјЕ, рјарЈёрјхрЈЇрЈЌ рјарјдрЈЎрјЦрЈњрјб рјарЈЇрЈєрЈѓрјфрЈЌрЈЇрјЕ, рјарЈЈрЈ┤рЈФ рјцрЈцрјх
­Ъњ┐№ИЈ	cd, рјарјдрЈЎрјЦрј»рЈЇрЈЌ рјарЈЇрЈєрЈѓрјфрЈЌрЈЇрјЕ, рјарјфрЈЕрЈЏрЈЌ, рјарјфрЈЕрЈЏрЈЌ рјарЈарЈЌ, рјарЈарЈЌ
­ЪЊІ№ИЈ	рЈЌрјгрјГрјИрЈЊ рЈЌрЈЇрЈєрЈѓрјфрЈЎрЈЌ
­ЪЊџ№ИЈ	рјфрЈфрјХрЈЌ рјфрЈфрјх, рЈЌрјфрЈфрјх
­ЪЊЪ№ИЈ	рјарЈЊрЈ»рЈѓ
­ЪЊц№ИЈ	рјДрЈЂрЈїрјб, рјфрЈфрјх, рЈЌрјдрјИрЈЎрЈЌ, рЈЌрјфрЈфрјх, рЈЎрЈ▒ рјДрЈЂрЈї рЈќрјхрЈЎ, рЈФрјдрЈїрЈЎрЈ┤рјб, рЈФрЈЌрјдрЈїрЈЎрјбрЈЇрЈЌ рјДрЈЂрЈїрјб
­ЪЊЦ№ИЈ	рјДрЈЂрЈї, рјфрЈфрјх, рјфрЈфрјх рЈДрјирј»рЈЇрЈЌ, рјфрЈфрјх рЈДрјирј»рЈЇрЈЌ рЈЌрјдрјИрЈЎрЈЌ, рЈЌрјдрјИрЈЎрЈЌ, рЈЌрјдрЈЂрЈЇрЈЌ
­ЪЊд№ИЈ	рјцрЈЎрЈбрЈњрјб, рјдрЈЄрЈѓрЈЊрЈЁрјб, рјДрЈЂрЈї
­ЪЊф№ИЈ	рјарЈЇрЈџрЈЁ, рјарЈЇрЈџрЈЁ рјфрЈфрјх рЈЌрјдрјИрЈЎрЈЌ рјдрЈЊрЈўрЈЃ рјАрј│рЈЌ рЈ▒рјгрЈЂрјИрјб, рјАрј│рЈЌ рЈ▒рјгрЈЂрјИрјб, рЈЌрјфрЈфрјх, рЈЌрјфрЈфрјх рЈДрјирј»рЈЇрЈЌ, рЈЌрјфрЈфрјх рЈДрјирј»рЈЇрЈЌ рјДрЈЂрЈїрјб
­ЪЊФ№ИЈ	рјарЈЇрЈџрЈЁ, рјарЈЇрЈџрЈЁ рјфрЈфрјх рЈЌрјдрјИрЈЎрЈЌ рјдрЈЊрЈўрЈЃ рјарЈїрј│рЈЊрЈЁрјб, рЈЌрјфрЈфрјх, рЈЌрјфрЈфрјх рЈДрјирј»рЈЇрЈЌрјб, рЈЌрјфрЈфрјх рЈДрјирј»рЈЇрЈЌрјб рјДрЈЂрЈїрјб
­ЪЊг№ИЈ	рјарЈЇрЈџрјбрЈЊ, рј»рЈЇрЈџрјб рјБрЈфрјх рЈЌрјдрЈЂрЈЇрЈЌ рјцрјхрјфрЈЌ рјарЈїрјИрЈЏрЈЁ рјдрЈЌ, рЈЌрјфрЈфрјх, рЈЌрјфрЈфрјх рЈДрјирј»рЈЇрЈЌ, рЈЌрјфрЈфрјх рЈДрјирј»рЈЇрЈЌ рјДрЈЂрЈїрјб
­ЪЊГ№ИЈ	рјАрј│рЈЌ рЈ▒рјгрЈЂрјИрјб, рј»рЈЇрЈџрјб рјфрЈфрјх рЈЌрјдрЈЂрЈЇрЈЌ рјцрјхрјфрЈЌ рјАрј│рЈЌрЈю рјдрЈЌ, рЈЌрјфрЈфрјх, рЈЌрјфрЈфрјх рЈДрјирј»рЈЇрЈЌ рјДрЈЂрЈїрјб
­ЪЊи№ИЈ	рјарЈЌрЈ┤рј│рЈЏрЈЇрјЕ, рЈЌрЈЊрЈЪрјХрЈЇрЈЎрЈЌ
­ЪЊ╣№ИЈ	рјарЈЊрЈ┤рјхрЈЏрЈЇрјЕ рЈЌрЈЊрЈЪрјХрЈЇрЈЌрЈЇрјЕ, рјарЈЌрЈ┤рј│рЈЏрЈЇрјЕ, рЈЌрЈЊрЈЪрјХрЈЇрЈЎрЈЌ
­ЪЊ║№ИЈ	tv, рјарЈЊрЈ┤рј│рЈЏрЈЇрјЕ, рЈЌрЈЊрЈ┤рј│рЈЏрЈЇрјЕ, рЈЌрЈЊрЈ┤рјхрЈЏрЈЇрјЕ
­ЪЊ╗№ИЈ	рјарЈЌрЈ┤рј│рЈЏрЈЇрјЕ, рЈЌрјДрЈЃрјЕрЈЇрјЕ
­ЪЊй№ИЈ	рјарЈЌрЈ┤рј│рЈЎрЈЌ, рјарЈЌрЈ┤рј│рЈЎрЈЌ рЈЌрјдрјИрЈїрЈЌрЈЇрјЕ, рјарЈЌрЈ┤рј│рЈЏрЈЇрјЕ, рЈЌрјдрјИрЈїрЈЌрЈЇрјЕ, рЈДрјЙрЈЌрЈ┤рј│рЈЎрЈЌ
­Ъћѕ№ИЈ	рјдрЈгрЈѓрЈЇрјЕ рјАрј│рЈЌрЈю рјарЈЇрЈЊрЈ▒рЈЌрЈЇрЈЌ, рЈЕрЈѓрје
­Ъћњ№ИЈ	рјарЈЇрЈџрјГ, рЈЇрЈЊрЈ▒ рјарЈЇрЈЇрјГ
­ЪћЊ№ИЈ	рјарЈЇрЈџрјбрЈЊ, рЈЊрјдрЈЈ, рЈЎрјарЈЇрЈџ
­ЪЋЅ№ИЈ	рјБрј╣, рј»рЈџрј», рЈџрјЙрЈЂрЈЪрЈЏ
­ЪЋі№ИЈ	рјдрЈЃрј»рјх, рјФрј┤ рЈЌрЈЇрјфрЈѓ, рЈЁрЈЕрЈЎрј»рЈ»рЈЏ, рЈЦрЈЇрЈє
­ЪЋљ№ИЈ	00, 1, 1:00, рјарЈЪрјарјхрЈњрјб, рЈїрЈЅ, рЈїрЈЅ рјарЈЪрјарјхрЈњ, рЈЕрЈЦ
­ЪЋЉ№ИЈ	00, 2, 2:00, рјарЈЪрјарјхрЈњрјб, рЈћрјх, рЈћрјх рјарЈЪрјарјхрЈњрјб, рЈЕрЈЦ
­ЪЋњ№ИЈ	00, 3, 3:00, рјарЈЪрјарјхрЈњрјб, рЈдрјб, рЈдрјб рјарЈЪрјарјхрЈњрјб, рЈЕрЈЦ
­ЪЋЊ№ИЈ	00, 4, 4:00, рјарЈЪрјарјхрЈњрјб, рЈЁрјЕ, рЈЁрјЕ рјарЈЪрјарјхрЈњрјб, рЈЕрЈЦ
­ЪЋћ№ИЈ	00, 5, 5:00, рјарЈЪрЈЌрјхрЈњрјб, рј»рЈЇрјЕ, рј»рЈЇрјЕ рјарЈЪрјарјхрЈњрјб, рЈЕрЈЦ
­ЪЋЋ№ИЈ	00, 6, 6:00, рјарЈЪрјарјхрЈњрјб, рЈЉрЈЊрјх, рЈЉрЈЊрјх рјарЈЪрјарјхрЈњрјб, рЈЕрЈЦ
­ЪЋќ№ИЈ	00, 7, 7:00, рјарЈЪрјарјхрЈњрјб, рјдрјхрЈЅрјЕ, рјдрјхрЈЅрјЕ рјарЈЪрјарјхрЈњрјб, рЈЕрЈЦ
­ЪЋЌ№ИЈ	00, 8, 8:00, рјарЈЪрјарјхрЈњрјб, рЈДрЈЂрј│, рЈДрЈЂрј│ рјарЈЪрјарјхрЈњрјб, рЈЕрЈЦ
­ЪЋў№ИЈ	00, 9, 9:00, рјарЈЪрјарјхрЈњрјб, рЈљрЈЂрј│, рЈљрЈЂрј│ рјарЈЪрјарјхрЈњрјб, рЈЕрЈЦ
­ЪЋЎ№ИЈ	00, 10, 10:00, рјарЈЪрјарјхрЈњрјб, рЈЇрјфрј», рЈЇрјфрј» рјарЈЊрјарјхрЈњрјб, рЈЕрЈЦ
­ЪЋџ№ИЈ	00, 11, 11:00, рјарЈЪрјарјхрЈњрјб, рЈїрЈџ, рЈїрЈџ рјарЈЪрјарјхрЈЇрЈњ, рЈЕрЈЦ
­ЪЋЏ№ИЈ	00, 12, 12:00, рјарЈЪрјарјхрЈњрјб, рЈћрјхрЈџ, рЈћрјхрЈџ рјарЈЪрјарјхрЈњрјб, рЈЕрЈЦ
­ЪЋ»№ИЈ	рјарЈерЈЇрЈЌ, рјцрјДрјЙрЈФ рјарЈерЈЇрЈЌ
­ЪЋ░№ИЈ	рјарЈ»рЈћрјЙрјИрјб рјарЈарЈЌ рЈЕрЈЦ, рЈЕрЈЦ
­ЪЋ│№ИЈ	рјарЈћрј┤рЈњрјб
­ЪЋ┤№ИЈ	рјарЈЇрјдрЈ», рјарЈЇрјдрЈ» рЈџрјИрЈФрЈЇрЈЊрЈЂрј» рЈДрЈарЈ▒рјГ рЈЊрј┤рј▓рЈЇрјгрјб, рЈЌрјдрјИрЈФрЈЇрЈЊрЈЂрЈЌ, рЈДрЈарЈ▒рјГ
­ЪЋх№ИЈ	рјцрјдрЈЏрЈѓрЈЎрј», рјцрЈЇрЈѕрЈѓрЈ░рЈЌ, рјцрЈЋрјхрЈЊ рјцрјдрЈЏрЈѓрЈЎрј»
­ЪЋХ№ИЈ	рјарјдрјхрЈЇрјгрјб рЈЌрјдрЈўрЈЁрЈЏрЈЌ, рјарјдрЈў, рјцрјхрЈЈрјЕ, рЈЌрјдрЈўрЈЁрЈЌ
­ЪЋи№ИЈ	рјДрј┐рЈЂрЈЇрјЕ, рЈЦрЈЇрјфрЈ»
­ЪЋИ№ИЈ	рјцрЈЈрј│рЈЏрјб, рјДрј┐рЈЂрЈЇрјЕ, рјДрј┐рЈЂрЈЇрјЕ рјцрЈЈрј│рЈЏрјб
­ЪЋ╣№ИЈ	рјерЈўрЈ┤рЈЇрЈЌ, рЈЌрЈЂрЈЪрЈЎрЈЌ, рЈЌрЈЊрЈ┤рј│рЈЏрЈЇрјЕ рЈЌрЈЂрЈЪрЈЎрЈЌ
­ЪќЄ№ИЈ	рјфрЈфрјх рЈЌрјдрЈѓрЈ┤рЈЎрЈЌ, рјФрЈЊрјИрЈЎрЈЌ, рЈЌрјФрЈЊрјИрЈЁрјб рјфрЈфрјх рЈЌрјдрЈѓрЈ┤рЈЎрЈЌ
­Ъќі№ИЈ	рјдрЈљрЈєрјИрЈФрјфрЈЇрЈЊрЈ┤ рЈЌрјфрЈфрјХрЈЌ, рЈЌрјфрЈфрјХрЈЌ
­ЪќІ№ИЈ	рјарЈцрЈгрјЕ, рјарЈцрЈгрјЕ рЈЌрјфрЈфрјХрЈЌ, рЈЌрјфрЈфрјХрЈЌ
­Ъќї№ИЈ	рјарЈЉрЈФрЈЇрЈЎрЈЌ, рјарЈЉрЈФрЈњрјб
­ЪќЇ№ИЈ	рЈЌрЈЉрЈФрЈЇрЈЎрЈЌ рјфрЈфрјХрЈЎрЈЌ
­Ъќљ№ИЈ	рјбрЈДрЈЊрјх, рјцрЈїрј│рЈЊ рјцрЈгрЈ▒ рјбрЈДрЈЊрјх рЈЋрјдрЈ░рЈїрЈЏ, рјцрЈгрЈ▒, рјдрЈ░рЈїрЈЏ
­ЪќЦ№ИЈ	рјарјдрЈЎрјЦрј»рЈЇрЈЌрЈЇрјЕ рјарЈЇрЈєрЈѓрјфрЈЌрЈЇрјЕ, рјдрЈЇрјЕрјХрјЕ рјдрЈџ, рјдрЈЇрјЕрјХрјЕ рјдрЈџ рјарјдрЈЎрјЦрј»рЈЇрЈЌрЈЇрјЕ рјарЈЇрЈєрЈѓрјфрЈЌрЈЇрјЕ
­Ъќе№ИЈ	рјарјдрЈЎрјЦрј»рЈЇрЈЌрЈЇрјЕ рјарЈЇрЈєрЈѓрјфрЈЌрЈЇрјЕ, рЈЌрјдрј┤рЈ┤рЈЌрЈЇрјЕ
­Ъќ▒№ИЈ	рјарјдрЈЎрјЦрј»рЈЇрЈЌрЈЇрјЕ рјарЈЇрЈєрЈѓрјфрЈЌрЈЇрјЕ, рјарјдрЈЎрјЦрј»рЈЇрЈЌрЈЇрјЕ рјарЈЇрЈєрЈѓрјфрЈЌрЈЇрјЕ рЈЦрЈЇрЈЋрЈЦ
­Ъќ▓№ИЈ	рјарјдрЈЎрјЦрј»рЈЇрЈЌрЈЇрјЕ рјарЈЇрЈєрЈѓрјфрЈЌрЈЇрјЕ, рјфрјирЈЁрЈЊрЈЇрЈєрЈърЈЇрЈЌ
­Ъќ╝№ИЈ	рјцрЈфрЈў рјарЈЇрЈє.рјфрЈЏрјб, рјдрЈўрЈЁрЈЌрјб, рЈЌрЈЪрјХрЈЇрЈћрЈЁрјб, рЈЌрЈЪрјХрЈЇрЈћрЈЁрјб рјдрЈўрЈЁрЈћрЈЁрјб
­ЪЌѓ№ИЈ	рјарЈЇрЈЊрЈЕрЈЏрЈЇрЈЌ, рЈєрЈѓрЈ▓рЈЇрЈЌ, рЈєрЈѓрЈ▓рЈЇрЈЌ рјарЈЇрЈЊрЈЕрЈЏрЈЇрЈЌ рЈћрјх рЈ▒рјдрЈЌрЈЇрјЕ, рЈћрјх рјбрјдрЈЌрЈЇрјЕ
­ЪЌЃ№ИЈ	рјарЈєрЈѓрЈ▓рЈЇрЈЌ, рјарЈєрЈѓрЈ▓рЈЇрЈЌ рјарЈЦрј│ рјцрЈБрЈЇрјдрЈў рјДрЈЂрЈї, рјарЈЦрј│ рјцрЈБрЈЇрјдрЈў, рјДрЈЂрЈїрјб
­ЪЌё№ИЈ	рјарЈЇрјфрЈѓрјфрЈЎрЈЌ рјдрЈЇрјЕрјИ, рјарЈЇрЈѓрјфрЈЎрЈЌ, рјдрЈЇрјЕрјИ, рЈЏрЈЇрЈєрЈѓрјфрЈЌрЈЇрјгрјб
­ЪЌЉ№ИЈ	рјцрЈ▓рЈЕрЈЌрЈЁрЈЌ рЈћрјирЈБ
­ЪЌњ№ИЈ	рјцрЈЇрЈЌ рјфрЈфрјх, рјдрЈёрЈќрЈ▓рјИ, рјдрЈёрЈќрЈ▓рјИ рјфрЈфрјХрЈЌ рјфрЈфрјх, рјфрЈфрјХрЈЌ рјфрЈфрјх
­ЪЌЊ№ИЈ	рјдрЈёрЈќрЈ▓рјИ, рјдрЈёрЈќрЈ▓рјИ рЈЁрЈЊ рЈЌрЈјрЈЇрЈЌ, рјфрЈфрјХрЈЌ рјфрЈфрјх, рЈЁрЈЊ рЈЌрЈјрЈЇрЈЌ
­ЪЌю№ИЈ	рјгрЈѓрЈ▒рЈЎрЈЌ, рјгрЈћрЈѓрЈЊрЈЇрЈЌ, рјгрЈЎрЈЌ, рЈЇрЈЊрЈ▒ рјарЈљрЈЁрЈЇрЈЎрЈЌ
­ЪЌЮ№ИЈ	рјарЈЊрЈЃрј»рЈјрј», рјцрЈфрЈў, рјцрЈфрЈў рЈЇрЈџрјбрЈЇрЈЌ, рјдрЈљрјЙрј│рЈЏрјб, рЈЇрЈџрјбрЈЇрЈЌ
­ЪЌА№ИЈ	рјарјхрЈЇрЈЋрјИрЈЎрЈЌ, рјарЈ░рј│рЈЇрЈЌ, рЈЌрјдрЈўрЈЇрЈЌ
­ЪЌБ№ИЈ	рјарЈЇрјфрјх, рјцрјДрЈЏ, рјцрЈЎрЈбрЈњрјб, рјДрЈЂрјд, рјДрЈЂрјЕ, рјДрЈЂрјЕ рјарЈЇрјфрјх
­ЪЌе№ИЈ	рјарјдрЈЇрјдрЈѓ рјдрЈгрЈѓрј»рЈЇрЈЌрјб рјцрЈєрјирЈњрјб, рјдрЈгрЈѓрј»рЈЇрЈЌрјб, рЈЌрЈЪрЈЃрј«рЈЌ
­ЪЌ»№ИЈ	рјарјдрЈўрЈЈ рјцрј┐рјИрј» рјцрЈєрјирЈњрјб, рјцрј┐рјИрј», рјцрЈЃрј┤ рјарЈ▓рЈЎрЈЌ, рјцрЈєрјирЈњрјб
­ЪЌ│№ИЈ	рјДрЈЂрЈї, рЈЌрЈЎрјЕрЈ»рЈЇрјЕ рјцрјДрјхрЈЈрЈљрЈЌ, рЈЌрЈЎрјЕрЈ»рЈЇрјЕ рјДрЈЂрЈї рјЙрЈЇрјЕ рјгрЈЌ рЈЌрЈЎрјЕрЈ»рЈЇрјЕ рјцрјДрјхрЈЈрЈљрЈЌ
­ЪЌ║№ИЈ	рјАрјХрј», рјАрјХрј» рјАрјХрј» рЈЊрЈЪрјХрЈЇрЈЏрјб, рјАрјХрј» рЈЊрЈЪрјХрЈЇрЈЏрјб
­Ъўљ№ИЈ	рјцрјДрЈЏ, рЈЃрјхрјфрЈЏрјЙ, рЈЃрјхрјфрЈЏрјЙ рјцрјДрЈЏ, рЈёрЈ░рЈЦрЈЇрјгрјЙ
­ЪџЄ№ИЈ	рјцрЈћрјЙ рЈЌрјдрЈџрј▓, рЈЌрјдрЈБрЈёрјх рЈДрЈфрЈЊрЈЇрЈЌ
­ЪџЇ№ИЈ	рЈѓрЈЊрЈ│рЈЇрЈЌрЈЏ, рЈЌрјЙрЈЋрјХрЈєрЈЇрјЕ рјцрјЙрЈдрЈЎрЈЌ, рЈЌрјЙрЈЋрјХрЈєрЈЇрјЕ рјцрјЙрЈдрЈЎрЈЌ рЈѓрЈЊрЈ│рЈЇрЈЌрЈЏ
­ЪџЉ№ИЈ	рЈЎрЈєрј┤рјх, рЈДрЈѓрЈбрјЕ рЈЌрЈ»рЈЁрј»рЈЎрј»
­Ъџћ№ИЈ	рЈѓрЈЊрЈ│рЈЇрЈЌрЈЏ, рЈѓрЈЊрЈ│рЈЇрЈЌрЈЏ рЈЌрЈЊрЈѓрјЕрЈЇрјЕ рЈЎрј┤рј│, рЈЌрЈЊрЈѓрЈ▒рЈЇрјЕ, рЈЎрЈєрј┤рјх
­Ъџў№ИЈ	рЈѓрЈЊрЈ│рЈЇрЈЌрЈЏ, рЈѓрЈЊрЈ│рЈЇрЈЌрЈЏ рЈЎрј┤рј│, рЈЎрЈєрј┤рјх
­ЪџГ№ИЈ	рјбрЈ»рЈЏрЈЂрЈЌрјб рЈѓрјерЈњрјЙ, рјЦрЈЮ, рјдрЈЁрЈЇрЈЎрЈЇрјд, рјфрјЕрЈЇрјгрјб, рЈѓрјерЈњрјЙ, рЈърЈЇрЈЌ рЈ▓рјдрЈЇрјерЈЇрЈЌ
­Ъџ▓№ИЈ	рЈћрјх рЈЌрјдрЈєрЈў, рЈћрјх рЈЌрјдрЈєрЈў рјарјЕрјИрЈЎрЈЌ
­Ъџ╣№ИЈ	wc, рјарЈѓрЈЇрјдрЈ» рјцрЈѓрЈ┤рЈЇрЈЌ, рјарЈЇрјдрЈ», рјцрјЙрЈЊрЈЁрјдрЈЪрЈЌ рјДрЈЁрЈЉрјИ, рЈЎрЈ▒ рјцрјЙрЈерЈЇрЈЌ
­Ъџ║№ИЈ	wc, рјарјерЈ», рјарјерЈ» рјцрЈ┤рЈЇрЈЌрјб, рјцрјЙрЈЊрЈЁрјдрЈЪрЈЌ рјДрЈЁрЈЉрјИ, рЈЎрЈ▒ рјцрјЙрЈерЈЇрЈЌ
­Ъџ╝№ИЈ	рјцрЈЇрЈЌ, рјцрЈЇрЈЌ рЈЌрЈЪрјХрЈЇрЈћрЈЁрјб, рЈЏрјдрЈЂрЈЪрЈ┤рјАрј▓рјб
­ЪЏІ№ИЈ	рјарЈерЈЇрЈЌ, рјдрЈЁрј»рЈЊ рјдрЈЇрјЕрјХ, рјдрЈЁрј»рЈЊ рјдрЈЇрјЕрјХ рјарј┤ рјарЈерЈЇрЈЌ, рЈДрЈѓрЈњрЈЇрЈЌ
­ЪЏЇ№ИЈ	рјарЈЊрј┐рј┐рјЕрја, рјарЈЊрј┐рј┐рјЕрја рЈЌрЈЋрјдрјхрЈЪрЈЌ, рЈЋрјдрјхрЈЪрЈЌ, рЈДрЈѓрЈњрЈЇрЈЌ
­ЪЏј№ИЈ	рјарЈФрјЙ рјарјхрЈЇрЈЋрјИрј»рЈЎрј», рјарЈФрјЙ рјарјхрЈЇрЈЋрјИрј»рЈЎрј» рјцрјГрјИрЈѓ, рјцрјГрјИрЈѓ, рЈДрЈѓрЈњрЈЇрЈЌ
­ЪЏЈ№ИЈ	рјдрЈѓрЈЪ, рјдрЈбрЈЁрЈЌ, рЈДрЈѓрЈњрЈЇрЈЌ
­ЪЏа№ИЈ	рјгрЈЁрЈЕрјХрЈЇрЈЌ, рјгрЈЁрЈЕрјХрЈЇрЈЌ рјарј┤ рЈЌрјдрЈџрЈЕрјИрЈЋрЈЇрЈЎрЈЌ, рјгрЈћрЈѓрЈЊрЈЇрЈЌ, рЈЌрјдрЈџрЈЕрјИрЈЋрЈЇрЈЎрЈЌ
­ЪЏА№ИЈ	рјарјхрЈЇрЈЋрјИрЈЎрЈЌ, рјарЈџрЈбрЈЎрЈЌ
­ЪЏб№ИЈ	рјфрјб, рјфрјб рЈњрЈЎрјЙ, рЈњрЈЎрјЙ
­ЪЏБ№ИЈ	рјцрЈћрјЙ рЈЁрЈЃрј», рјдрј│рЈЁрЈЏ, рЈЁрЈЃрј»
­ЪЏц№ИЈ	рјарЈЦрј│ рЈЁрЈЃрј», рЈЌрјдрЈБрЈёрјх
­ЪЏЦ№ИЈ	рјдрЈБрЈёрјх рЈЦрЈ│, рЈЦрЈ│
­ЪЏЕ№ИЈ	рјцрЈЇрЈЌ рЈЦрЈ│ рјдрЈЃрј»рјхрЈЎрј», рЈЦрЈ│ рјдрЈЃрј»рјхрЈЎрј»
­ЪЏ░№ИЈ	рјцрЈЪрЈЁрЈЏрјб, рјдрјИрјХрј» рјарјдрЈќрЈЃрјхрЈЎ
­ЪЏ│№ИЈ	рјАрЈє рЈЦрЈ│, рЈ┤рЈФ рјарЈБрЈЇрјЕ, рЈ┤рЈФ рјарЈБрЈЇрјЕ рјАрЈє рЈЦрЈ│
