ğŸ˜±	Munch, face, face screaming in fear, fear, scared, scream
ğŸ¥µ	feverish, flushed, heat stroke, hot, hot face, red-faced, sweating
ğŸ¤­	face with hand over mouth, whoops
ğŸ˜ˆ	devil, face, fantasy, horns, smile
ğŸ‘¦	boy, young, young person
ğŸ‘§	Virgo, girl, young person, zodiac
ğŸ‘¨â€ğŸ’¼	business man, manager, office worker, white collar
ğŸ‘©â€ğŸ’¼	business woman, manager, office worker, white collar
ğŸ‘¨â€ğŸ¤	entertainer, man, performer, rock singer, star
ğŸ‘©â€ğŸ¤	entertainer, performer, rock singer, star, woman
ğŸ‘¨â€ğŸ¨	artist, man, painter, palette
ğŸ‘©â€ğŸ¨	artist, painter, palette, woman
ğŸ‘¨â€ğŸš’	fire truck, firefighter, man
ğŸ‘©â€ğŸš’	fire truck, firefighter, woman
ğŸ•µ	detective, investigator, sleuth, spy
ğŸ•µâ€â™‚	detective, investigator, man, sleuth, spy
ğŸ•µâ€â™€	detective, investigator, sleuth, spy, woman
ğŸ…	Christmas, Father Christmas, Santa, Santa Claus, celebration
ğŸ¤¶	Christmas, Mrs Claus, Mrs Santa Claus, celebration
ğŸ’‡â€â™‚	haircut, hairdresser, man, man getting haircut
ğŸ’‡â€â™€	haircut, hairdresser, woman, woman getting haircut
ğŸ§–â€â™€	sauna, steam room, woman in steam room, woman in steamy room
ğŸ§–â€â™‚	man in steam room, man in steamy room, sauna, steam room
ğŸ›€	bath, bathtub, person taking bath, tub
ğŸ›Œ	hotel, person in bed, sleep, sleeping
ğŸŒ	ball, golf, golfer, person golfing
ğŸŒâ€â™‚	golf, golfer, man, man golfing
ğŸŒâ€â™€	golf, golfer, woman, woman golfing
ğŸ„	person surfing, surfer, surfing
ğŸ„â€â™‚	man, surfer, surfing
ğŸ„â€â™€	surfer, surfing, woman
ğŸš£	boat, person, person rowing boat, rowboat
ğŸŠ	person swimming, swim, swimmer
ğŸŠâ€â™‚	man, man swimming, swim, swimmer
ğŸŠâ€â™€	swim, swimmer, woman, woman swimming
ğŸš´	bicycle, biking, cyclist, person biking, person riding a bike
ğŸš´â€â™‚	bicycle, biking, cyclist, man, man riding a bike
ğŸš´â€â™€	bicycle, biking, cyclist, woman, woman riding a bike
ğŸ¤¹	balance, juggle, multi-task, skill
ğŸ¤¹â€â™‚	juggling, man, multi-task
ğŸ¤¹â€â™€	juggling, multi-task, woman
ğŸ––	Vulcan salute, finger, hand, spock, vulcan
ğŸ‘”	tie
ğŸ‘•	clothing, shirt, t-shirt, tee, tshirt
ğŸ‘–	clothing, jeans, pants, trousers
ğŸ‘—	clothing, dress, womanâ€™s clothes
ğŸ‘™	bikini, clothing, swim suit, two-piece
ğŸ‘š	blouse, clothing, top, woman, womanâ€™s clothes
ğŸ‘›	accessories, coin, purse
ğŸ‘œ	accessories, bag, handbag, tote
ğŸ‘	accessories, bag, clutch bag, pouch
ğŸ‘Ÿ	athletic, clothing, running shoe, shoe, sneaker, trainer
ğŸ§¢	baseball cap
ğŸ¦Œ	deer, stag
ğŸ¦	rhino, rhinoceros
ğŸ­	face, mouse, pet
ğŸ	mouse, pet, rodent
ğŸ€	pet, rat, rodent
ğŸ¨	bear, koala, marsupial
ğŸ¦ƒ	bird, poultry, turkey
ğŸ”	bird, chicken, poultry
ğŸ¦…	bird of prey, eagle
ğŸ¦‰	bird of prey, owl, wise
ğŸ¦œ	bird, pirate, talk
ğŸ¬	dolphin, porpoise
ğŸ 	fish, reef fish, tropical
ğŸ¦€	crab, crustacean, seafood, shellfish
ğŸ¦	bisque, claws, lobster, seafood, shellfish
ğŸ¦	prawn, seafood, shellfish, shrimp
ğŸ¦‘	decapod, seafood, squid
ğŸŒ	mollusc, snail
ğŸ¦‹	butterfly, insect, moth
ğŸ›	bug, caterpillar, insect, worm
ğŸ•·	arachnid, spider
ğŸ¦Ÿ	dengue, fever, insect, malaria, virus
ğŸŠ	fruit, mandarin, orange
ğŸŒ¶	chilli, pepper
ğŸ¥–	French stick, baguette, bread, food, french
ğŸ¥¯	bagel, bakery
ğŸ”	hamburger
ğŸŸ	chips, fries
ğŸ¥™	falafel, flatbread, food, gyro, kebab, pita, pita roll, stuffed
ğŸ¥—	food, garden, garden salad, salad
ğŸ¤	battered, battered prawn, fried, prawn, shrimp, tempura
ğŸ¥Ÿ	dumpling, empanada, gyÅza, pastie, samosa
ğŸ¥¡	takeaway container, takeout
ğŸ¦	cream, dessert, ice cream, soft serve, sweet
ğŸ§	dessert, granita, ice, sweet
ğŸ¨	cream, dessert, ice cream, sweet
ğŸª	cookie
ğŸ®	baked custard, dessert, pudding, sweet
ğŸ¥¢	chopsticks, pair of chopsticks
ğŸ—»	Fuji, mount Fuji, mountain
ğŸŸ	arena, stadium
ğŸ•Œ	Islam, Muslim, mosque, religion
â›©	Shinto, Shinto shrine, religion, shrine
ğŸ•‹	Islam, Kaaba, Muslim, religion
ğŸŒŒ	Milky Way, space
ğŸ 	merry-go-round
ğŸª	big top, circus
ğŸšƒ	car, electric, railway, train, tram, trolley bus
ğŸšŠ	light rail, oncoming, oncoming light rail, tram, trolleybus
ğŸš‹	car, tram, trolley bus
ğŸš	bus, tram, trolley, trolley bus
ğŸš’	fire truck
ğŸš™	4WD, four-wheel drive
ğŸš›	articulated truck, lorry, semi, truck
ğŸ›£	freeway, highway, road
â›½	diesel, fuel, gas, petrol pump, pump, station
ğŸš¥	horizontal traffic lights, lights, signal, traffic
ğŸš¦	lights, signal, traffic, vertical traffic lights
ğŸšŸ	cable, cable railway, railway, suspension
ğŸš 	cable, cableway, gondola, mountain
ğŸš¡	cable car
ğŸ›	bell, hotel, porter, porter bell
âŒ›	hourglass, sand, timer
â²	timer
ğŸ•°	clock
â›±	beach, beach umbrella, sand, sun, umbrella
ğŸ‰	celebration, party, popper, ta-da
ğŸ	Japanese, bamboo, bamboo decoration, celebration, decoration
ğŸ	gift
ğŸŸ	admission, entry, ticket
ğŸ†	celebration, prize, trophy
ğŸ…	celebration, medal, sports
ğŸ³	ball, game, tenpin bowling
ğŸ	cricket game
ğŸ¥…	goal cage
â›³	flag, golf, hole
â›¸	ice, ice skating, skate
ğŸ£	fish, fishing, fishing rod, pole, rod
ğŸ¿	ski, skiing, snow
ğŸ›·	sled, sledge, sleigh
ğŸ¥Œ	curling, game, rock, stone
ğŸ§¿	amulet, charm, evil-eye, evil-eye amulet, nazar, talisman
ğŸ°	game, pokie, pokies
â™¦	card, diamonds, game
â™£	card, clubs, game
ğŸ”ˆ	low, quiet, soft, speaker, volume
ğŸ“»	AM, FM, radio, wireless
ğŸ¹	instrument, keyboard, music, organ, piano
ğŸ¥	drum, drumsticks, music, percussions
â˜	land line, phone, telephone
ğŸ’»	PC, computer, laptop, personal
ğŸ’¾	computer, disk, diskette, floppy
ğŸ’¿	CD, computer, disk, optical
ğŸ“€	DVD, blu-ray, computer, disk, dvd, optical
ğŸ¥	camera, cinema, movie, movie camera
ğŸ¬	clapper, film
ğŸ“º	TV, television, video
ğŸ“¼	VHS, tape, video, videocassette
ğŸ’¡	bulb, comic, electric, globe, idea, light, light globe
ğŸ’¹	chart, chart increasing with yen, graph, graph increasing with yen, growth, money, yen
ğŸ“¤	box, letter, mail, out tray, outbox, sent, tray
ğŸ“¥	box, in tray, inbox, letter, mail, receive, tray
ğŸ“«	closed, closed letterbox with raised flag, mail, mailbox, postbox
ğŸ“ª	closed, closed letterbox with lowered flag, lowered, mail, mailbox, postbox
ğŸ“¬	mail, mailbox, open, open letterbox with raised flag, postbox
ğŸ“­	lowered, mail, mailbox, open, open letterbox with lowered flag, postbox
ğŸ—‚	index card dividers
ğŸ“‡	index card
ğŸ“ˆ	chart, chart increasing, graph, graph increasing, growth, trend, upward
ğŸ“‰	chart, chart decreasing, down, graph, graph decreasing, trend
ğŸ“Š	bar graph
ğŸ“Œ	drawing-pin, pin
ğŸ“	pin, pushpin, round drawing-pin
ğŸ—„	filing cabinet
ğŸ› 	hammer, hammer and spanner, spanner, tool, wrench
ğŸ”«	gun
ğŸ§¬	DNA, biologist, dna, evolution, gene, genetics, life
ğŸ“¡	satellite dish
ğŸ›‹	couch, couch and lamp, hotel, lamp, sofa, sofa and lamp
ğŸš½	WC, facilities, loo, toilet
â™¿	access, disabled access, wheelchair symbol
ğŸš¼	baby, baby symbol, change room, changing
ğŸš¾	WC, amenities, bathroom, restroom, toilet, water closet, wc
â›”	denied, entry, forbidden, no, prohibited, traffic
ğŸš«	denied, entry, forbidden, no, prohibited
ğŸš­	denied, forbidden, no, prohibited, smoking
ğŸš¯	denied, forbidden, litter, no, no littering, prohibited
ğŸš±	non-drinkable water, non-drinking, non-potable, water
ğŸš·	denied, forbidden, no, no pedestrians, pedestrian, prohibited
âœ	Christian, Christian cross, cross, religion
â™	Virgo, virgin, zodiac
â™	Sagittarius, archer, centaur, zodiac
â™’	Aquarius, water bearer, zodiac
â©	fast forward button
ğŸ”†	bright button, brightness, brightness button
â™¾	eternal, forever, unbound, universal
â˜‘	ballot, ballot box with check, box, tick
âœ”	heavy tick mark, mark, tick
â€¼	double exclamation mark, exclamation, mark, punctuation
â‰	exclamation, mark, punctuation, question
ğŸ” 	input Latin uppercase
ğŸ”¡	input Latin lowercase
ğŸ”¤	input Latin letters
