ЁЯП╗	ркЖркЫрлЛ ркдрлНрк╡ркЪрк╛ркирлЛ рк░ркВркЧ, ркЪрк╛ркоркбрлАркирлЛ ркЖркЫрлЛ рк░ркВркЧ, ркдрлНрк╡ркЪрк╛ркирлЛ рккрлНрк░ркХрк╛рк░-1-2, ркдрлНрк╡ркЪрк╛ркирлЛ рк░ркВркЧ
ЁЯП╝	ркЪрк╛ркоркбрлАркирлЛ ркоркзрлНркпрко ркЖркЫрлЛ рк░ркВркЧ, ркдрлНрк╡ркЪрк╛ркирлЛ рккрлНрк░ркХрк╛рк░-3, ркдрлНрк╡ркЪрк╛ркирлЛ рк░ркВркЧ, ркоркзрлНркпрко ркЖркЫрлЛ ркдрлНрк╡ркЪрк╛ркирлЛ рк░ркВркЧ
ЁЯП╜	ркдрлНрк╡ркЪрк╛ркирлЛ рккрлНрк░ркХрк╛рк░-4, ркдрлНрк╡ркЪрк╛ркирлЛ рк░ркВркЧ, ркоркзрлНркпрко ркЪрк╛ркоркбрлАркирлЛ рк░ркВркЧ, ркоркзрлНркпрко ркдрлНрк╡ркЪрк╛ркирлЛ рк░ркВркЧ
ЁЯП╛	ркдрлНрк╡ркЪрк╛ркирлЛ рккрлНрк░ркХрк╛рк░-5, ркдрлНрк╡ркЪрк╛ркирлЛ рк░ркВркЧ, ркоркзрлНркпрко ркШрлЗрк░рлЛ ркЪрк╛ркоркбрлАркирлЛ рк░ркВркЧ, ркоркзрлНркпрко ркШрлЗрк░рлЛ ркдрлНрк╡ркЪрк╛ркирлЛ рк░ркВркЧ
ЁЯП┐	ркШрлЗрк░рлЛ ркЪрк╛ркоркбрлАркирлЛ рк░ркВркЧ, ркШрлЗрк░рлЛ ркдрлНрк╡ркЪрк╛ркирлЛ рк░ркВркЧ, ркдрлНрк╡ркЪрк╛ркирлЛ рккрлНрк░ркХрк╛рк░-6, ркдрлНрк╡ркЪрк╛ркирлЛ рк░ркВркЧ
ЁЯША	ркЪрк╣рлЗрк░рлЛ, рк╕рлНркорк┐ркд, рк╕рлНркорк┐ркд ркХрк░ркдрлЛ ркЪрк╣рлЗрк░рлЛ
ЁЯШБ	ркЖркВркЦ, ркЪрк╣рлЗрк░рлЛ, рк╕рлНркорк┐ркд, рк╣рк╕ркдрлА ркЖркВркЦрлЛ рк╕рк╛ркерлЗркирлЛ рк╕рлНркорк┐ркд ркХрк░ркдрлЛ ркЪрк╣рлЗрк░рлЛ, рк╣рк╕рк╡рлБркВ
ЁЯШВ	ркЕрк╢рлНрк░рлБ, ркЖркиркВркж, ркЪрк╣рлЗрк░рлЛ, рк╣рк░рлНрк╖ркирк╛ ркЖркВрк╕рлБ рк╕рк╛ркерлЗркирлЛ ркЪрк╣рлЗрк░рлЛ, рк╣рк╛рк╕рлНркп
ЁЯдг	ркЪрк╣рлЗрк░рлЛ, ркЬркорлАрки, ркЬркорлАрки рккрк░ рк▓рлЛркЯрлАркирлЗ рк╣рк╕рк╡рлБркВ, рк▓рлЛркЯрк╡рлБркВ, рк╣рк╕рк╡рлБркВ
ЁЯШГ	ркЦрлБрк▓рлНрк▓рк╛ ркорлЛркВ рк╕рк╛ркерлЗркирлЛ рк╕рлНркорк┐ркд ркХрк░ркдрлЛ ркЪрк╣рлЗрк░рлЛ, ркЦрлБрк▓рлНрк▓рлБркВ, ркЪрк╣рлЗрк░рлЛ, ркорлЛркЯрлА ркЖркВркЦрлЛ рк╕рк╛ркерлЗ рк╕рлНркорк┐ркд ркХрк░ркдрлЛ ркЪрк╣рлЗрк░рлЛ, рк╕рлНркорк┐ркд
ЁЯШД	ркЖркВркЦ, ркЦрлБрк▓рлНрк▓рк╛ ркорлЛркВ ркЕркирлЗ рк╣рк╕ркдрлА ркЖркВркЦрлЛ рк╕рк╛ркерлЗркирлЛ рк╕рлНркорк┐ркд ркХрк░ркдрлЛ ркЪрк╣рлЗрк░рлЛ, ркЦрлБрк▓рлНрк▓рлБркВ, ркЪрк╣рлЗрк░рлЛ, ркорлЛркВ, рк╕рлНркорк┐ркд, рк╣рк╕ркдрлА ркЖркВркЦрлЛ рк╕рк╛ркерлЗ рк╕рлНркорк┐ркд ркХрк░ркдрлЛ ркЪрк╣рлЗрк░рлЛ
ЁЯШЕ	ркЦрлБрк▓рлНрк▓рк╛ ркорлЛркВ ркЕркирлЗ ркаркВркбрк╛ рккрк░рк╕рлЗрк╡рк╛ рк╕рк╛ркерлЗркирлЛ рк╕рлНркорк┐ркд ркХрк░ркдрлЛ ркЪрк╣рлЗрк░рлЛ, ркЦрлБрк▓рлНрк▓рлЛ, ркЪрк╣рлЗрк░рлЛ, ркаркВркбрлЛ, рккрк░рк╕рлЗрк╡рлЛ, рккрк░рк╕рлЗрк╡рлЛ рк╕рк╛ркерлЗ рк╕рлНркорк┐ркд ркХрк░ркдрлЛ ркЪрк╣рлЗрк░рлЛ, рк╕рлНркорк┐ркд
ЁЯШЖ	ркЦрлБрк▓рлНрк▓рк╛ ркорлЛркВ ркЕркирлЗ ркЪрлБрк╕рлНркдрккркгрлЗ ркмркВркз ркЖркВркЦрлЛ рк╕рк╛ркерлЗркирлЛ рк╕рлНркорк┐ркд ркХрк░ркдрлЛ ркЪрк╣рлЗрк░рлЛ, ркЦрлБрк▓рлНрк▓рк╛ ркорлЛркВркП рк╣рк╛рк╕рлНркп, ркЦрлБрк▓рлНрк▓рлБркВ ркорлЛркврлБркВ, ркЪрк╣рлЗрк░рлЛ, ркмркВркз ркЖркВркЦрлЛ, ркмркВркз ркЖркВркЦрлЛ рк╕рк╛ркерлЗркирлБркВ рк╣рк╛рк╕рлНркп
ЁЯШЙ	ркЖркВркЦ ркорк╛рк░ркдрлЛ ркЪрк╣рлЗрк░рлЛ, ркЖркВркЦ ркорк╛рк░рк╡рлА, ркЪрк╣рлЗрк░рлЛ
ЁЯШК	ркЪрк╣рлЗрк░рлЛ, рк╣рк╕ркдрлА ркЖркВркЦрлЛ, рк╣рк╕ркдрлЛ ркЪрк╣рлЗрк░рлЛ, рк╣рк╕ркдрлЛ ркЪрк╣рлЗрк░рлЛ ркЕркирлЗ ркЖркВркЦрлЛ, рк╣рк╕рлНркдрлА ркЖркВркЦрлЛ рк╕рк╛ркерлЗркирлЛ рк╕рлНркорк┐ркд ркХрк░ркдрлЛ ркЪрк╣рлЗрк░рлЛ, рк╣рк╛рк╕рлНркп
ЁЯШЛ	ркЪрк╣рлЗрк░рлЛ, ркпрко ркпрко ркорк╕рлНркд, рк╕рлНрк╡рк╛ркжрк┐рк╖рлНркЯ, рк╕рлНрк╡рк╛ркжрк┐рк╖рлНркЯ ркнрлЛркЬрки, рк╕рлНрк╡рк╛ркжрк┐рк╖рлНркЯркирк╛ ркнрк╛рк╡рк╡рк╛рк│рлЛ ркЪрк╣рлЗрк░рлЛ, рк╣рк╕ркдрлЛ ркЪрк╣рлЗрк░рлЛ
ЁЯШО	ркХрлВрк▓, ркЪрк╣рлЗрк░рлЛ, ркдрлЗркЬрк╕рлНрк╡рлА, рк╕ркиркЧрлНрк▓рк╛рк╕рлЗрк╕, рк╕ркиркЧрлНрк▓рк╛рк╕рлЗрк╕ рк╕рк╛ркерлЗ рк╣рк╕ркдрлЛ ркЪрк╣рлЗрк░рлЛ, рк╕рлВрк░рлНркп
ЁЯШН	ркЖркВркЦрлЛ, ркЪрк╣рлЗрк░рлЛ, рккрлНрк░рлЗрко, рк╕рлНркорк┐ркд, рк╣рлГркжркпрк╛ркХрк╛рк░ркирлА ркЖркВркЦрлЛ рк╕рк╛ркерлЗркирлЛ рк╕рлНркорк┐ркд ркХрк░ркдрлЛ ркЪрк╣рлЗрк░рлЛ, рк╣рлНрк░ркжркпрк╛ркХрк╛рк░ркирлА ркЖркВркЦрлЛ рк╕рк╛ркерлЗркирлЛ рк╕рлНркорк┐ркд ркХрк░ркдрлЛ ркЪрк╣рлЗрк░рлЛ
ЁЯШШ	ркЪрк╣рлЗрк░рлЛ, ркЪрлБркВркмрки, ркЪрлБркВркмрки ркЙркЫрк╛рк│ркдрлЛ ркЪрк╣рлЗрк░рлЛ
ЁЯе░	3 рк╣рлНрк░ркжркп рк╕рк╛ркерлЗ рк╣рк╕ркдрлЛ ркЪрк╣рлЗрк░рлЛ
ЁЯШЧ	ркЪрк╣рлЗрк░рлЛ, ркЪрлБркВркмрки, ркЪрлБркВркмрки ркХрк░ркдрлЛ ркЪрк╣рлЗрк░рлЛ
ЁЯШЩ	ркЖркВркЦрлЛ, ркЪрк╣рлЗрк░рлЛ, ркЪрлБркВркмрки, рк╣рк╕ркдрлА ркЖркВркЦрлЛ рк╕рк╛ркерлЗркирлЛ ркЪрлБркВркмрки ркХрк░ркдрлЛ ркЪрк╣рлЗрк░рлЛ, рк╣рк╛рк╕рлНркп
ЁЯШЪ	ркЖркВркЦ, ркЪрк╣рлЗрк░рлЛ, ркЪрлБркВркмрки, ркмркВркз, ркмркВркз ркЖркВркЦрлЛ рк╕рк╛ркерлЗ ркЪрлБркВркмрки ркХрк░ркдрлЛ ркЪрк╣рлЗрк░рлЛ
ЁЯЩВ	ркЪрк╣рлЗрк░рлЛ, ркорлБркЦ, рк╕рк╣рлЗркЬ рк╕рлНркорк┐ркд ркХрк░ркдрлЛ ркЪрк╣рлЗрк░рлЛ, рк╕рлНркорк┐ркд, рк╣рк╛рк╕рлНркп
ЁЯдЧ	ркЖрк▓рк┐ркВркЧрки, ркЖрк▓рк┐ркВркЧрки ркХрк░ркдрлЛ ркЪрк╣рлЗрк░рлЛ, ркЖрк▓рк┐ркВркЧрки ркХрк░рк╡рлБркВ, ркЪрк╣рлЗрк░рлЛ
ЁЯдй	рк╕рлНркЯрк╛рк░ рк╕рлНркЯрлНрк░ркХ
ЁЯдФ	ркЪрк╣рлЗрк░рлЛ, рк╡рк┐ркЪрк╛рк░ ркХрк░ркдрлЛ, рк╡рк┐ркЪрк╛рк░рк╢рлАрк▓ ркЪрк╣рлЗрк░рлЛ
ЁЯди	ркКркВркЪрлА ркнрлНрк░ркорк░ рк╕рк╛ркерлЗркирлЛ ркЪрк╣рлЗрк░рлЛ
ЁЯШС	ркЕркХркеркирлАркп ркЪрк╣рлЗрк░рлЛ, ркХрлЛркИ ркЯрк┐рккрлНрккркгрлА ркирк╣рлАркВ, ркЪрк╣рлЗрк░рлЛ, ркнрк╛рк╡рк╢рлВркирлНркп ркЪрк╣рлЗрк░рлЛ, ркорлБркЦ, рк╣рк╛рк╡ркнрк╛рк╡рк╡рк┐рк╣рлАрки
ЁЯШ╢	ркЪрк╣рлЗрк░рлЛ, ркорлБркЦ, ркорлЛркВркврк╛ рк╡ркЧрк░ркирлЛ, ркорлЛркВркврк╛ рк╡ркЧрк░ркирлЛ ркЪрк╣рлЗрк░рлЛ
ЁЯЩД	ркЖркВркЦрлЛ, ркЖркВркЦрлЛ рклрлЗрк░рк╡ркдрлЛ ркЪрк╣рлЗрк░рлЛ, ркЪрк╣рлЗрк░рлЛ, рклрлЗрк░рк╡рк╡рлБркВ
ЁЯШП	ркХрлГркдрлНрк░рк┐рко, ркХрлГркдрлНрк░рк┐рко рк╣рк╕ркдрлЛ ркЪрк╣рлЗрк░рлЛ, ркЪрк╣рлЗрк░рлЛ
ЁЯШг	ркЪрк╣рлЗрк░рлЛ, ркЬркмрк░ркжрк╕рлНркд ркЪрк╣рлЗрк░рлЛ, рк╕ркЦркд ркЪрк╣рлЗрк░рлЛ, рк╕рлНркерк╛ркпрлА
ЁЯШе	ркЖрк╡рлЛ, ркЙркжрк╛рк╕рлА рккрк░ркВркдрлБ рк░рк╛рк╣ркд ркЪрк╣рлЗрк░рлЛ, ркЪрк╣рлЗрк░рлЛ, ркирк╛ркЦрлБрк╢ рккрк░ркВркдрлБ рк░рк╛рк╣ркдрк╡рк╛рк│рлЛ ркЪрк╣рлЗрк░рлЛ, ркирк┐рк░рк╛рк╢, рк░рк╛рк╣ркд
ЁЯШо	ркЦрлБрк▓рлНрк▓рк╛ркВ ркорлЛркВркврк╛рк╡рк╛рк│рлЛ ркЪрк╣рлЗрк░рлЛ, ркЦрлБрк▓рлНрк▓рлБркВ ркорлЛркврлБркВ, ркЪрк╣рлЗрк░рлЛ, ркорлЛркВркврлБркВ, рк╕рк╣рк╛ркирлБркнрлВркдрк┐
ЁЯдР	ркЪрк╣рлЗрк░рлЛ, ркЭрк┐рккркерлА ркмркВркз ркХрк░рлЗрк▓рлЛ ркорлЛркврлБркВ, ркорлБркЦ, ркорлЛркврк╛ рккрк░ ркЭрк┐ркк рк╕рк╛ркерлЗркирлЛ ркЪрк╣рлЗрк░рлЛ
ЁЯШп	ркЕркЪркВркнрк┐ркд, ркЕрк╡рк╛ркХ, ркЪрк╣рлЗрк░рлЛ, рк╢рк╛ркВркд ркЪрк╣рлЗрк░рлЛ
ЁЯШк	ркКркВркШркдрлБркВ, ркКркВркШркдрлЛ ркЪрк╣рлЗрк░рлЛ, ркЪрк╣рлЗрк░рлЛ
ЁЯШл	ркЪрк╣рлЗрк░рлЛ, ркерк╛ркХрлЗрк▓рлЛ, ркерк╛ркХрлЗрк▓рлЛ ркЪрк╣рлЗрк░рлЛ
ЁЯШ┤	ркЪрк╣рлЗрк░рлЛ, ркирк┐ркВркжрлНрк░рк╛ркзрлАрки ркЪрк╣рлЗрк░рлЛ, ркирк┐ркжрлНрк░рк╛ркорк╛ркВ, ркирк┐ркжрлНрк░рк╛ркорк╛ркВркирлЛ ркЪрк╣рлЗрк░рлЛ
ЁЯШМ	ркЪрк╣рлЗрк░рлЛ, рк░рк╛рк╣ркдркирк╛ ркнрк╛рк╡рк╡рк╛рк│рлЛ ркЪрк╣рлЗрк░рлЛ, рк░рк╛рк╣ркдрк╡рк╛рк│рлЛ ркЪрк╣рлЗрк░рлЛ
ЁЯШЫ	ркЪрк╣рлЗрк░рлЛ, ркЬрлАркн, ркЬрлАркн ркмрк╣рк╛рк░ ркХрк╛ркврлЗрк▓рлЛ ркЪрк╣рлЗрк░рлЛ, ркмрк╣рк╛рк░ ркХрк╛ркврлЗрк▓рлА ркЬрлАркн рк╕рк╛ркерлЗркирлЛ ркЪрк╣рлЗрк░рлЛ
ЁЯШЬ	ркЖркВркЦ, ркЖркВркЦ ркорк╛рк░рк╡рк╛ркирлА рк╕рк╛ркерлЗ ркЬрлАркн ркмрк╣рк╛рк░ ркХрк╛рквркдрлЛ ркЪрк╣рлЗрк░рлЛ, ркЖркВркЦ ркорк╛рк░рк╡рлА, ркЪрк╣рлЗрк░рлЛ, ркЬрлАркн, ркЬрлАркн рк╕рк╛ркерлЗ ркЖркВркЦ ркорк╛рк░ркдрлЛ ркЪрк╣рлЗрк░рлЛ, ркоркЬрк╛ркХ
ЁЯШЭ	ркЖркВркЦ, ркЪрк╣рлЗрк░рлЛ, ркЪрлБрк╕рлНркдрккркгрлЗ ркмркВркз ркЖркВркЦрлЛ рк╕рк╛ркерлЗ ркЬрлАркн ркмрк╣рк╛рк░ ркХрк╛рквркдрлЛ ркЪрк╣рлЗрк░рлЛ, ркЬрлАркн, ркЬрлАркн рк╕рк╛ркерлЗ ркЪрлБрк╕рлНркдрккркгрлЗ ркмркВркз ркЖркВркЦрлЛрк╡рк╛рк│рлЛ ркЪрк╣рлЗрк░рлЛ, ркнркпрк╛ркиркХ, рк╕рлНрк╡рк╛ркж
ЁЯдд	ркЪрк╣рлЗрк░рлЛ, рк▓рк╛рк│, рк▓рк╛рк│ ркЯрккркХрк╡рк╛рк╡рк╛рк│рлЛ ркЪрк╣рлЗрк░рлЛ
ЁЯШТ	ркЪрк╣рлЗрк░рлЛ, ркжрлБркГркЦрлА, ркирк╛ркЦрлБрк╢, ркирк╛ркЦрлБрк╢ ркЪрк╣рлЗрк░рлЛ
ЁЯШУ	ркЪрк╣рлЗрк░рлЛ, ркаркВркбрк╛ рккрк░рк╕рлЗрк╡рк╛ рк╕рк╛ркерлЗркирлЛ ркЪрк╣рлЗрк░рлЛ, ркаркВркбрлЛ, ркдркХрк▓рлАрклрлЛркирлА рк╕рк╛ркерлЗ ркирк┐рк░рк╛рк╢рк╛ркЬркиркХ ркЪрк╣рлЗрк░рлЛ, рккрк░рк╕рлЗрк╡рлЛ
ЁЯШФ	ркЪрк╣рлЗрк░рлЛ, ркирк╛рк╕рлАрккрк╛рк╕, рк╡рк┐ркЪрк╛рк░ркЧрлНрк░рк╕рлНркд, рк╡рк┐ркЪрк╛рк░ркЧрлНрк░рк╕рлНркд ркЪрк╣рлЗрк░рлЛ
ЁЯШХ	ркЪрк╣рлЗрк░рлЛ, ркорлВркВркЭрк╛ркпрлЗрк▓, ркорлВркВркЭрк╛ркпрлЗрк▓ ркЪрк╣рлЗрк░рлЛ
ЁЯЩГ	ркКркВркзрлЛ, ркКркВркзрлЛ ркЪрк╣рлЗрк░рлЛ, ркЪрк╣рлЗрк░рлЛ, ркорлБркЦ
ЁЯдС	ркЪрк╣рлЗрк░рлЛ, ркзрки, ркзркирк╡рк╛рк│рлЛ ркЪрк╣рлЗрк░рлЛ, ркорлБркЦ
ЁЯШ▓	ркЖркШрк╛ркд, ркЖрк╢рлНркЪрк░рлНркп, ркЖрк╢рлНркЪрк░рлНркпркЪркХрк┐ркд ркЪрк╣рлЗрк░рлЛ, ркЪрк╣рлЗрк░рлЛ, ркдркжрлНркжрки
ЁЯЩБ	ркЧркоркЧрлАрки, ркЪрк╣рлЗрк░рлЛ, ркерлЛркбрлЛ ркЧркоркЧрлАрки ркЪрк╣рлЗрк░рлЛ, ркорлБркЦ
ЁЯШЦ	ркЖркХрлБрк│рк╡рлНркпрк╛ркХрлБрк│, ркЖркХрлБрк│рк╡рлНркпрк╛ркХрлБрк│ ркЪрк╣рлЗрк░рлЛ, ркЪрк╣рлЗрк░рлЛ
ЁЯШЮ	ркЪрк╣рлЗрк░рлЛ, ркирк┐рк░рк╛рк╢, ркирк┐рк░рк╛рк╢ ркЪрк╣рлЗрк░рлЛ
ЁЯШЯ	ркЪрк╣рлЗрк░рлЛ, ркЪрк┐ркВркдрк╛ркЧрлНрк░рк╕рлНркд, ркЪрк┐ркВркдрк╛ркЧрлНрк░рк╕рлНркд ркЪрк╣рлЗрк░рлЛ
ЁЯШд	ркЪрк╣рлЗрк░рлЛ, ркорлЗркВ ркдрлЗ ркЬрлАркдрлНркпрк╛ркирлЛ ркЪрк╣рлЗрк░рлЛ, рк╡рк┐ркЬркп, рк╡рк┐ркЬркпрлА ркжрлЗркЦрк╛рк╡, рк╣рлБркВ ркЬрлАркдрлНркпрлЛ
ЁЯШв	ркЖркВрк╕рлБркУ, ркЪрк╣рлЗрк░рлЛ, ркжрлБркГркЦрлА, рк░ркбркдрлЛ ркЪрк╣рлЗрк░рлЛ, рк░ркбрк╡рлБркВ
ЁЯШн	ркЕрк╢рлНрк░рлБ, ркЪрк╣рлЗрк░рлЛ, ркорлЛркЯрлЗркерлА рк░ркбркдрлЛ ркЪрк╣рлЗрк░рлЛ, ркорлЛркЯрлЗркерлА рк░ркбрк╡рлБркВ, рк░ркбрк╡рлБркВ, рк░рлБркжрки
ЁЯШж	ркЦрлБрк▓рлНрк▓рк╛ркВ ркорлЛркВркврк╛ рк╕рк╛ркерлЗ ркнрк╡рк╛ркВ ркЪркбрк╛рк╡ркдрлЛ ркЪрк╣рлЗрк░рлЛ, ркЦрлБрк▓рлНрк▓рлБркВ, ркЪрк╣рлЗрк░рлЛ, ркнрк╡рк╛ркВ, ркорлБркЦ
ЁЯШз	ркЪрк╣рлЗрк░рлЛ, ркжрлБркГркЦрлА, ркжрлБркГркЦрлА ркЪрк╣рлЗрк░рлЛ
ЁЯШи	ркЪрк╣рлЗрк░рлЛ, ркнркпркЧрлНрк░рк╕рлНркд, ркнркпркнрлАркд, ркнркпркнрлАркд ркЪрк╣рлЗрк░рлЛ
ЁЯШй	ркХркВркЯрк╛рк│рк╛ркЬркиркХ, ркХркВркЯрк╛рк│рк╛ркЬркиркХ ркЪрк╣рлЗрк░рлЛ, ркЪрк╣рлЗрк░рлЛ, ркерк╛ркХрлЗрк▓рлЛ
ЁЯдп	рклрк╛ркЯркдрлБркВ ркорк╛ркерлБркВ
ЁЯШм	ркЪрк╣рлЗрк░рлЛ, ркЪрлЗркиркЪрк╛рк│рк╛, ркЪрлЗркиркЪрк╛рк│рк╛ ркХрк░ркдрлЛ ркЪрк╣рлЗрк░рлЛ
ЁЯШ░	ркЦрлБрк▓рлНрк▓рк╛ ркорлЛркВ ркЕркирлЗ ркаркВркбрк╛ рккрк░рк╕рлЗрк╡рк╛ рк╕рк╛ркерлЗркирлЛ ркЪрк╣рлЗрк░рлЛ, ркЦрлБрк▓рлНрк▓рлБркВ ркорлЛркврлБркВ, ркЪрк╣рлЗрк░рлЛ, ркаркВркбрк╛ рккрк░рк╕рлЗрк╡рк╛ рк╕рк╛ркерлЗркирлЛ рк╡рк╛ркжрк│рлА ркЪрк╣рлЗрк░рлЛ, ркаркВркбрлЛ рккрк░рк╕рлЗрк╡рлЛ, ркзрк╕рлЗрк▓рлЛ ркЪрк╣рлЗрк░рлЛ
ЁЯШ▒	ркЪрк╣рлЗрк░рлЛ, ркнркп, ркнркпркЧрлНрк░рк╕рлНркд, ркнркпркнрлАркд, ркнркпркорк╛ркВ ркЪрлАрк╕рлЛ рккрк╛ркбркдрлЛ ркЪрк╣рлЗрк░рлЛ, ркнркпркорк╛ркВ ркЪрлАрк╕рлЛ рккрк╛ркбрк╡рлА
ЁЯе╡	рк▓рк╛рк▓ркЪрлЛрк│ ркЪрк╣рлЗрк░рлЛ
ЁЯе╢	ркаркВркбрлЛ ркЪрк╣рлЗрк░рлЛ
ЁЯШ│	ркЪрк╣рлЗрк░рлЛ, рклрлНрк▓рк╢рлНркб, рк╕рлНркдркмрлНркз, рк╕рлНркдркмрлНркз ркЪрк╣рлЗрк░рлЛ, рк╕рлНркдркмрлНркзркдрк╛ркорк╛ркВ
ЁЯдк	ркЙркирлНркоркдрлНркд ркЪрк╣рлЗрк░рлЛ
ЁЯШ╡	ркЪркХрлНркХрк░, ркЪркХрлНркХрк░ ркЖрк╡ркдрлЛ ркЪрк╣рлЗрк░рлЛ, ркЪрк╣рлЗрк░рлЛ
ЁЯШб	ркЧрлБрк╕рлНрк╕рлЗрк▓, ркЪрк╣рлЗрк░рлЛ, рккрк╛ркЧрк▓, рк░рк┐рк╕рк╛рк╡рлБркВ, рк▓рк╛рк▓ ркЪрк╣рлЗрк░рлЛ, рк▓рк╛рк▓ рк░рк┐рк╕рк╛ркпрлЗрк▓рлЛ ркЪрк╣рлЗрк░рлЛ
ЁЯШа	ркЧрлБрк╕рлНрк╕рлЗрк▓, ркЧрлБрк╕рлНрк╕рлЗрк▓ ркЪрк╣рлЗрк░рлЛ, ркЪрк╣рлЗрк░рлЛ, рккрк╛ркЧрк▓
ЁЯдм	ркорлБркЦ рккрк░ ркЪрк┐рк╣рлНркирлЛ рк╕рк╛ркерлЗркирлЛ ркЪрк╣рлЗрк░рлЛ
ЁЯШ╖	ркЪрк╣рлЗрк░рлЛ, ркаркВркбрлЛ, ркдркмрлАркмрлА ркорк╛рк╕рлНркХ, ркорк╛рк╕рлНркХ, ркорк╛рк╕рлНркХрк╡рк╛рк│рлЛ ркЪрк╣рлЗрк░рлЛ, рк╣рк╡рк╛ркорк╛рки рк╣рлЗркарк│
ЁЯдТ	ркЪрк╣рлЗрк░рлЛ, ркерк░рлНркорлЛркорлАркЯрк░, ркерк░рлНркорлЛркорлАркЯрк░ рк╕рк╛ркерлЗркирлЛ ркЪрк╣рлЗрк░рлЛ, ркмрлАркорк╛рк░, ркорк╛ркВркжрлБркВ, ркорлБркЦ
ЁЯдХ	ркИркЬрк╛, ркШрк╛, ркЪрк╣рлЗрк░рлЛ, рккркЯрлНркЯрлА, ркорк╛ркерлЗ рккркЯрлНркЯрлАрк╡рк╛рк│рлЛ ркЪрк╣рлЗрк░рлЛ, ркорлБркЦ
ЁЯдв	ркКрк▓ркЯрлА, ркЪрк╣рлЗрк░рлЛ, ркЪрлАркдрк░рлА ркЪркбрлЗрк▓рлЛ, ркЪрлАркдрк░рлА ркЪркбрлЗрк▓рлЛ ркЪрк╣рлЗрк░рлЛ
ЁЯдо	ркЙрк▓ркЯрлА ркХрк░ркдрлЛ ркЪрк╣рлЗрк░рлЛ
ЁЯдз	ркЪрк╣рлЗрк░рлЛ, ркЫрлАркВркХ, ркЫрлАркВркХ ркЦрк╛ркдрлЛ ркЪрк╣рлЗрк░рлЛ
ЁЯШЗ	ркЪрк╣рлЗрк░рлЛ, рккрлНрк░ркнрк╛рк╡рк▓ркп, рккрлНрк░ркнрк╛рк╡рк▓ркп рк╕рк╛ркерлЗркирлБркВ рк╣рк╛рк╕рлНркп, рккрлНрк░ркнрк╛рк╡рк▓ркп рк╕рк╛ркерлЗркирлЛ рк╕рлНркорк┐ркд ркХрк░ркдрлЛ ркЪрк╣рлЗрк░рлЛ, ркорлБркЦ, рк╣рк╛рк╕рлНркп
ЁЯда	ркХрк╛ркЙркЧрк░рлНрк▓, ркХрк╛ркЙркмрлЙркп, ркХрк╛ркЙркмрлЙркп рк╣рлЕркЯрк╡рк╛рк│рлЛ ркЪрк╣рлЗрк░рлЛ, ркЪрк╣рлЗрк░рлЛ, рк╣рлЕркЯ
ЁЯе│	рккрк╛рк░рлНркЯрлА ркХрк░ркдрлЛ ркЪрк╣рлЗрк░рлЛ
ЁЯе┤	рк╡рлЛркЭрлА ркЪрк╣рлЗрк░рлЛ
ЁЯе║	ркжркпрк╛рк╡рк╛рк│рлЛ ркЪрк╣рлЗрк░рлЛ
ЁЯде	ркЦрлЛркЯрлБркВ, ркЦрлЛркЯрлБркВ ркмрлЛрк▓рк╡рк╛рк╡рк╛рк│рлЛ ркЪрк╣рлЗрк░рлЛ, ркЪрк╣рлЗрк░рлЛ
ЁЯдл	ркЪрлВркк ркХрк░ркдрлЛ ркЪрк╣рлЗрк░рлЛ
ЁЯдн	ркорлЛркВ рккрк░ рк╣рк╛рке ркорлВркХрлЗрк▓рлЛ ркЪрк╣рлЗрк░рлЛ
ЁЯзР	ркорлЛркирлЛркХрк▓ рк╕рк╛ркерлЗ ркЪрк╣рлЗрк░рлЛ
ЁЯдУ	ркЪрк╣рлЗрк░рлЛ, ркнрлЛрк│рккркг, ркнрлЛрк│рккркгркирк╛ ркнрк╛рк╡рк╡рк╛рк│рлЛ ркЪрк╣рлЗрк░рлЛ, ркорлБркЦ, ркорлБрк░рлНркЦркдрк╛ркирк╛ ркнрк╛рк╡рк╡рк╛рк│рлЛ ркЪрк╣рлЗрк░рлЛ
ЁЯШИ	ркЪрк╣рлЗрк░рлЛ, рк╢рк┐ркВркЧркбрк╛, рк╢рк┐ркВркЧркбрк╛ рк╕рк╛ркерлЗркирлБркВ рк╣рк╛рк╕рлНркп, рк╢рк┐ркВркЧркбрк╛ рк╕рк╛ркерлЗркирлЛ рк╕рлНркорк┐ркд ркХрк░ркдрлЛ ркЪрк╣рлЗрк░рлЛ, рк╣рк╛рк╕рлНркп
ЁЯС┐	ркХрк╛рк▓рлНрккркирк┐ркХ, ркЪрк╣рлЗрк░рлЛ, ркерлЛркнрлЛ, рк░рк╛ркХрлНрк╖рк╕, рк╢рк┐ркВркЧркбрк╛ рк╕рк╛ркерлЗ ркЧрлБрк╕рлНрк╕рлЛ ркЪрк╣рлЗрк░рлЛ, рк╢рлЗркдрк╛рки
ЁЯдб	ркЪрк╣рлЗрк░рлЛ, рк╡рк┐ркжрлВрк╖ркХ, рк╡рк┐ркжрлВрк╖ркХрк╡рк╛рк│рлЛ ркЪрк╣рлЗрк░рлЛ
ЁЯС╣	ркУркирлА, ркЪрк╣рлЗрк░рлЛ, ркЬрк╛рккрк╛ркирлА ркжрлИркдрлНркп, ркжрлИркдрлНркп, рккрк░рлА ркХркерк╛, рк░рк╛ркХрлНрк╖рк╕
ЁЯС║	ркЪрк╣рлЗрк░рлЛ, ркЬрк╛рккрк╛ркирлА рккрлНрк░рлЗркд, ркЯрлЗркирлНркЧрлБ, рккрк░рлА ркХркерк╛, рккрлНрк░рлЗркд, рк░рк╛ркХрлНрк╖рк╕
ЁЯТА	ркЦрлЛрккрк░рлА, ркЪрк╣рлЗрк░рлЛ, рккрк░рлА ркХркерк╛, рк╢рк░рлАрк░
ЁЯС╗	ркЪрк╣рлЗрк░рлЛ, рккрк░рлА ркХркерк╛, ркнрлВркд
ЁЯС╛	UFO, ркЪрк╣рлЗрк░рлЛ, рккрк░ркЧрлНрк░рк╣рк╡рк╛рк╕рлА рк░рк╛ркХрлНрк╖рк╕, рккрк░рлА ркХркерк╛, рк░рк╛ркХрлНрк╖рк╕
ЁЯдЦ	ркЪрк╣рлЗрк░рлЛ, ркорк╢рлАркирлА ркорк╛ркирк╡, ркорлБркЦ, рк░рлЛркмрлЛркЯ, рк░рлЛркмрлЛркЯркирлЛ ркЪрк╣рлЗрк░рлЛ
ЁЯТй	ркЦрлВркВркЯрлЛ, ркЫрк╛ркг, рккрлВркк
ЁЯШ║	ркЦрлБрк▓рлНрк▓рк╛ ркорлЛркврлЗ рк╣рк╕ркдрлА ркмрк┐рк▓рк╛ркбрлАркирлЛ ркЪрк╣рлЗрк░рлЛ, ркЦрлБрк▓рлНрк▓рлБркВ, ркЪрк╣рлЗрк░рлЛ, ркмрк┐рк▓рк╛ркбрлА, ркмрк┐рк▓рк╛ркбрлАркирлЛ ркЪрк╣рлЗрк░рлЛ, ркорлЛркВркврлБркВ, рк╕рлНркорк┐ркд ркХрк░ркдрлА ркмрк┐рк▓рк╛ркбрлАркирлЛ ркЪрк╣рлЗрк░рлЛ
ЁЯШ╕	ркЪрк╣рлЗрк░рлЛ, ркмрк┐рк▓рк╛ркбрлА, ркмрк┐рк▓рк╛ркбрлАркирлЛ ркЪрк╣рлЗрк░рлЛ, рк╣рк╕ркдрлА, рк╣рк╕ркдрлА ркЖркВркЦрлЛ ркЕркирлЗ ркЕркЯрлНркЯрк╣рк╛рк╕рлНркп рк╕рк╛ркерлЗркирлЛ ркмрк┐рк▓рк╛ркбрлАркирлЛ ркЪрк╣рлЗрк░рлЛ, рк╣рк╕ркдрлА ркЖркВркЦрлЛ ркЕркирлЗ рк╣рк╕рк╡рк╛ рк╕рк╛ркерлЗркирлЛ ркмрк┐рк▓рк╛ркбрлАркирлЛ ркЪрк╣рлЗрк░рлЛ, рк╣рк╕ркдрлА ркмрк┐рк▓рк╛ркбрлАркирлЛ ркЪрк╣рлЗрк░рлЛ
ЁЯШ╣	ркЖркиркВркжрк╛рк╢рлНрк░рлБ, ркЖркиркВркжрк╛рк╢рлНрк░рлБ рк╕рк╛ркерлЗркирлЛ ркмрк┐рк▓рк╛ркбрлАркирлЛ ркЪрк╣рлЗрк░рлЛ, ркЪрк╣рлЗрк░рлЛ, ркмрк┐рк▓рк╛ркбрлА, ркмрк┐рк▓рк╛ркбрлАркирлЛ ркЪрк╣рлЗрк░рлЛ
ЁЯШ╗	ркЖркВркЦрлЛ, ркЪрк╣рлЗрк░рлЛ, рккрлНрк░рлЗрко, рккрлНрк░рлЗркоркорк╛ркВ, ркмрк┐рк▓рк╛ркбрлА, ркмрк┐рк▓рк╛ркбрлАркирлЛ ркЪрк╣рлЗрк░рлЛ, рк╕рлНркорк┐ркд ркХрк░ркдрлА ркмрк┐рк▓рк╛ркбрлАркирлЛ ркЪрк╣рлЗрк░рлЛ, рк╣рлГркжркп, рк╣рлГркжркпрк╛ркХрк╛рк░ ркЖркВркЦрлЛ рк╕рк╛ркерлЗ рк╣рк╕ркдрлА ркмрк┐рк▓рк╛ркбрлАркирлЛ ркЪрк╣рлЗрк░рлЛ
ЁЯШ╝	ркЪрк╣рлЗрк░рлЛ, ркмрк┐рк▓рк╛ркбрлА, ркмрк┐рк▓рк╛ркбрлАркирлЛ ркЪрк╣рлЗрк░рлЛ, ркорк╛рк░рлНркорк┐ркХ рк╣рк╛рк╕рлНркп, рк╡рлНркпркВркЧрккрлВрк░рлНркг, рк╡рлНркпркВркЧрккрлВрк░рлНркг ркмрк┐рк▓рк╛ркбрлАркирлЛ ркЪрк╣рлЗрк░рлЛ, рк╡рлНркпркВркЧрккрлВрк░рлНркг рк╕рлНркорк┐ркд рк╕рк╛ркерлЗркирлЛ ркмрк┐рк▓рк╛ркбрлАркирлЛ ркЪрк╣рлЗрк░рлЛ
ЁЯШ╜	ркЖркВркЦрлЛ, ркЪрк╣рлЗрк░рлЛ, ркЪрлБркВркмрки, ркЪрлБркВркмрки ркХрк░ркдрлА, ркЪрлБркВркмрки ркХрк░ркдрлА ркмрк┐рк▓рк╛ркбрлА, ркмркВркз, ркмркВркз ркЖркВркЦрлЛ рк╕рк╛ркерлЗ ркЪрлБркВркмрки ркХрк░ркдрлЛ ркмрк┐рк▓рк╛ркбрлАркирлЛ ркЪрк╣рлЗрк░рлЛ, ркмрк┐рк▓рк╛ркбрлА
ЁЯЩА	ркХркВркЯрк╛рк│рк╛ркЬркиркХ ркмрк┐рк▓рк╛ркбрлАркирлЛ ркЪрк╣рлЗрк░рлЛ, ркЦрк░рлЗркЦрк░ ркЖрк╢рлНркЪрк░рлНркпркЪркХрк┐ркд, ркЪрк╣рлЗрк░рлЛ, рккрк░рлЗрк╢рк╛рки ркеркпрлЗрк▓ ркмрк┐рк▓рк╛ркбрлАркирлЛ ркЪрк╣рлЗрк░рлЛ, ркмрк┐рк▓рк╛ркбрлА, рк╣рлЗ ркнркЧрк╡рк╛рки
ЁЯШ┐	ркЪрк╣рлЗрк░рлЛ, ркмрк┐рк▓рк╛ркбрлА, ркмрк┐рк▓рк╛ркбрлАркирлЛ ркЪрк╣рлЗрк░рлЛ, рк░ркбркдрлА ркмрк┐рк▓рк╛ркбрлАркирлЛ ркЪрк╣рлЗрк░рлЛ, рк░ркбрк╡рлБркВ, рк░рлБркжрки
ЁЯШ╛	ркЪрк╣рлЗрк░рлЛ, ркмрк┐рк▓рк╛ркбрлА, ркмрк┐рк▓рк╛ркбрлАркирлЛ ркЪрк╣рлЗрк░рлЛ, рк░рк┐рк╕рк╛ркпрлЗрк▓ ркмрк┐рк▓рк╛ркбрлАркирлЛ ркЪрк╣рлЗрк░рлЛ, рк░рк┐рк╕рк╛рк╡рлБркВ
ЁЯЩИ	ркЦрк░рк╛ркм ркЬрлЛрк╢рлЛ ркирк╣рлАркВ, ркЦрк░рк╛ркм ркЬрлЛрк╢рлЛ ркирк╣рлАркВ ркмркдрк╛рк╡ркдрлЛ рк╡рк╛ркВркжрк░рлЛ, рк╡рк╛ркВркжрк░рлЛ
ЁЯЩЙ	ркЦрк░рк╛ркм рк╕рк╛ркВркнрк│рк╢рлЛ ркирк╣рлАркВ, ркЦрк░рк╛ркм рк╕рк╛ркВркнрк│рк╢рлЛ ркирк╣рлАркВ ркмркдрк╛рк╡ркдрлЛ рк╡рк╛ркВркжрк░рлЛ, рк╡рк╛ркВркжрк░рлЛ
ЁЯЩК	ркЦрк░рк╛ркм ркмрлЛрк▓рк╢рлЛ ркирк╣рлАркВ, ркЦрк░рк╛ркм ркмрлЛрк▓рк╢рлЛ ркирк╣рлАркВ ркмркдрк╛рк╡ркдрлЛ рк╡рк╛ркВркжрк░рлЛ, рк╡рк╛ркВркжрк░рлЛ
ЁЯС╢	рк▓рлЛркХрлЛ, рк╢рк┐рк╢рлБ
ЁЯзТ	ркмрк╛рк│ркХ
ЁЯСж	ркЫрлЛркХрк░рлЛ, ркпрлБрк╡рк╛рки
ЁЯСз	ркХркирлНркпрк╛, ркЫрлЛркХрк░рлА, ркпрлБрк╡рк╛рки, рк░рк╛рк╢рк┐
ЁЯзС	ркЕркирк┐рк░рлНркжрк┐рк╖рлНркЯ рк▓рк┐ркВркЧ, рккрлБркЦрлНркд, рк▓рк┐ркВркЧ-ркдркЯрк╕рлНрке, рк╡рлНркпркХрлНркдрк┐
ЁЯС▒	рккрлАрк│рк╛рк╢ рккркбркдрк╛ркВ рк╡рк╛рк│рк╡рк╛рк│рлА рк╡рлНркпркХрлНркдрк┐, рк▓рлЛркХрлЛ
ЁЯСи	рккрлБркЦрлНркд, рккрлБрк░рлБрк╖
ЁЯС▒тАНтЩВ	рккрлАрк│рк╛рк╢ рккркбркдрк╛ркВ рк╡рк╛рк│рк╡рк╛рк│рлЛ рккрлБрк░рлБрк╖, рккрлБрк░рлБрк╖, рк╕рлЛркирлЗрк░рлА рк╡рк╛рк│рк╡рк╛рк│рлБркВ
ЁЯзФ	ркжрк╛ркврлА рк╡рк╛рк│рлА рк╡рлНркпркХрлНркдрк┐
ЁЯСй	рккрлБркЦрлНркд, рк╕рлНркдрлНрк░рлА
ЁЯС▒тАНтЩА	рккрлАрк│рк╛рк╢ рккркбркдрк╛ркВ рк╡рк╛рк│рк╡рк╛рк│рлА рк╕рлНркдрлНрк░рлА, рк╕рлЛркирлЗрк░рлА рк╡рк╛рк│рк╡рк╛рк│рлБркВ, рк╕рлНркдрлНрк░рлА
ЁЯзУ	ркЕркирк┐рк░рлНркжрк┐рк╖рлНркЯ рк▓рк┐ркВркЧ, ркЬрлВркирк╛, ркЬрлВркирлА рк╡рлНркпркХрлНркдрк┐, рккрлБркЦрлНркд, рк▓рк┐ркВркЧ-ркдркЯрк╕рлНрке, рк╡рлГркжрлНркз рк╡рлНркпркХрлНркдрк┐
ЁЯС┤	рккрлБркЦрлНркд, рккрлБрк░рлБрк╖, рк╡рлГркжрлНркз, рк╡рлГркжрлНркз рккрлБрк░рлБрк╖
ЁЯС╡	рккрлБркЦрлНркд, рк╡рлГркжрлНркз, рк╡рлГркжрлНркз рк╕рлНркдрлНрк░рлА, рк╕рлНркдрлНрк░рлА
ЁЯСитАНтЪХ	ркЖрк░рлЛркЧрлНркпрк╕ркВркнрк╛рк│, ркЙрккркЪрк╛рк░ркХ, ркбрлЙркХрлНркЯрк░, ркирк░рлНрк╕, рккрлБрк░рлБрк╖, рккрлБрк░рлБрк╖ ркЖрк░рлЛркЧрлНркп ркХрк╛рк░рлНркпркХрк░рлНркдрк╛
ЁЯСйтАНтЪХ	ркЖрк░рлЛркЧрлНркпрк╕ркВркнрк╛рк│, ркЙрккркЪрк╛рк░ркХ, ркбрлЙркХрлНркЯрк░, ркирк░рлНрк╕, рк╕рлНркдрлНрк░рлА, рк╕рлНркдрлНрк░рлА ркЖрк░рлЛркЧрлНркп ркХрк╛рк░рлНркпркХрк░рлНркдрк╛
ЁЯСитАНЁЯОУ	рккрлБрк░рлБрк╖, рк╡рк┐ркжрлНркпрк╛рк░рлНркерлА, рк╕рлНркирк╛ркдркХ
ЁЯСйтАНЁЯОУ	рк╡рк┐ркжрлНркпрк╛рк░рлНркерк┐ркирлА, рк╕рлНркдрлНрк░рлА, рк╕рлНркирк╛ркдркХ
ЁЯСитАНЁЯПл	рккрлБрк░рлБрк╖, рккрлНрк░рк╢рк┐ркХрлНрк╖ркХ, рккрлНрк░рлЛрклрлЗрк╕рк░, рк╢рк┐ркХрлНрк╖ркХ
ЁЯСйтАНЁЯПл	рккрлНрк░рк╢рк┐ркХрлНрк╖ркХ, рккрлНрк░рлЛрклрлЗрк╕рк░, рк╢рк┐ркХрлНрк╖ркХрк╛, рк╢рк┐ркХрлНрк╖рк┐ркХрк╛, рк╕рлНркдрлНрк░рлА
ЁЯСитАНтЪЦ	ркдрк░рк╛ркЬрлБ, ркирлНркпрк╛ркп, ркирлНркпрк╛ркпрк╛ркзрлАрк╢, рккрлБрк░рлБрк╖
ЁЯСйтАНтЪЦ	ркдрк░рк╛ркЬрлБ, ркирлНркпрк╛ркп, рк╕рлНркдрлНрк░рлА, рк╕рлНркдрлНрк░рлА ркирлНркпрк╛ркпрк╛ркзрлАрк╢
ЁЯСитАНЁЯМ╛	ркЦрлЗркбрлВркд, рккрлБрк░рлБрк╖, ркорк╛рк│рлА, рк░рлЗркирлНркЪрк░
ЁЯСйтАНЁЯМ╛	ркЦрлЗркбрлВркд, ркорк╛рк│рлА, рк░рлЗркирлНркЪрк░, рк╕рлНркдрлНрк░рлА, рк╕рлНркдрлНрк░рлА ркЦрлЗркбрлВркд
ЁЯСитАНЁЯН│	рккрлБрк░рлБрк╖, ркорк╣рк╛рк░рк╛ркЬ, рк░рк╕рлЛркЗркпрлЛ, рк░рк╕рлЛркИркпрлЛ
ЁЯСйтАНЁЯН│	рк░рк╕рлЛркпркг, рк░рк╛ркВркзрк╡рлБркВ, рк╕рлНркдрлНрк░рлА
ЁЯСитАНЁЯФз	ркЗрк▓рлЗркХрлНркЯрлНрк░рк┐рк╢рки, ркХрк╛рк░рлАркЧрк░, рккрлБрк░рлБрк╖, рккрлНрк▓ркорлНркмрк░, ркорлЗркХрлЕркирк┐ркХ
ЁЯСйтАНЁЯФз	ркЗрк▓рлЗркХрлНркЯрлНрк░рк┐рк╢рки, рккрлНрк▓ркорлНркмрк░, ркорлЗркХрлЕркирк┐ркХ, рк╕рлНркдрлНрк░рлА, рк╕рлНркдрлНрк░рлА ркорлЗркХрлЕркирк┐ркХ
ЁЯСитАНЁЯПн	ркФркжрлНркпрлЛркЧрк┐ркХ, ркХрк╛рк░рлНркпркХрк░рлНркдрк╛, рккрлБрк░рлБрк╖, рккрлБрк░рлБрк╖ рклрлЕркХрлНркЯрк░рлА ркХрк╛рк░рлНркпркХрк░рлНркдрк╛, рклрлЕркХрлНркЯрк░рлА, ркоркВркбрк▓рлА
ЁЯСйтАНЁЯПн	ркФркжрлНркпрлЛркЧрк┐ркХ, ркХрк╛рк░рлНркпркХрк░рлНркдрк╛, рклрлЕркХрлНркЯрк░рлА, ркоркВркбрк▓рлА, рк╕рлНркдрлНрк░рлА, рк╕рлНркдрлНрк░рлА рклрлЕркХрлНркЯрк░рлА ркХрк╛рк░рлНркпркХрк░рлНркдрк╛
ЁЯСитАНЁЯТ╝	ркЖрк░рлНркХрк┐ркЯрлЗркХрлНркЯ, ркСрклрк┐рк╕, рккрлБрк░рлБрк╖, рккрлБрк░рлБрк╖ ркСрклрк┐рк╕ ркХрк╛рк░рлНркпркХрк░рлНркдрк╛, рк╡рлНркпрк╡рк╕рк╛ркп, рк╕ркВркЪрк╛рк▓ркХ
ЁЯСйтАНЁЯТ╝	ркЖрк░рлНркХрк┐ркЯрлЗркХрлНркЯ, ркСрклрк┐рк╕, рк╡рлНркпрк╡рк╕рк╛ркп, рк╕ркВркЪрк╛рк▓ркХ, рк╕рлНркдрлНрк░рлА, рк╕рлНркдрлНрк░рлА ркСрклрк┐рк╕ ркХрк╛рк░рлНркпркХрк░рлНркдрк╛
ЁЯСитАНЁЯФм	ркПркирлНркЬрк┐ркирк┐ркЕрк░, ркЧркгрк┐ркдрк╢рк╛рк╕рлНркдрлНрк░рлА, ркЬрлАрк╡рк╡рк┐ркЬрлНркЮрк╛ркирлА, рккрлБрк░рлБрк╖, рккрлБрк░рлБрк╖ рк╡рлИркЬрлНркЮрк╛ркирк┐ркХ, ркнрлМркдрк┐ркХрк╡рк┐ркЬрлНркЮрк╛ркирлА, рк░рк╕рк╛ркпркгрк╢рк╛рк╕рлНркдрлНрк░рлА, рк╡рлИркЬрлНркЮрк╛ркирк┐ркХ
ЁЯСйтАНЁЯФм	ркПркирлНркЬрк┐ркирк┐ркЕрк░, ркЧркгрк┐ркдрк╢рк╛рк╕рлНркдрлНрк░рлА, ркЬрлАрк╡рк╡рк┐ркЬрлНркЮрк╛ркирлА, ркнрлМркдрк┐ркХрк╡рк┐ркЬрлНркЮрк╛ркирлА, рк░рк╕рк╛ркпркгрк╢рк╛рк╕рлНркдрлНрк░рлА, рк╡рлИркЬрлНркЮрк╛ркирк┐ркХ, рк╕рлНркдрлНрк░рлА, рк╕рлНркдрлНрк░рлА рк╡рлИркЬрлНркЮрк╛ркирк┐ркХ
ЁЯСитАНЁЯТ╗	ркХрлЛркбрк░, ркЯрлЗркХрлНркирлЙрк▓рлЛркЬрк┐рк╕рлНркЯ, рккрлБрк░рлБрк╖, рккрлБрк░рлБрк╖ ркЯрлЗркХрлНркирлЙрк▓рлЛркЬрк┐рк╕рлНркЯ, рк╡рк┐ркХрк╛рк╕ркХрк░рлНркдрк╛, рк╢рлЛркзркХ, рк╕рлЛрклрлНркЯрк╡рлЗрк░
ЁЯСйтАНЁЯТ╗	ркХрлЛркбрк░, ркЯрлЗркХрлНркирлЙрк▓рлЛркЬрк┐рк╕рлНркЯ, рк╡рк┐ркХрк╛рк╕ркХрк░рлНркдрк╛, рк╢рлЛркзркХ, рк╕рлЛрклрлНркЯрк╡рлЗрк░, рк╕рлНркдрлНрк░рлА, рк╕рлНркдрлНрк░рлА ркЯрлЗркХрлНркирлЙрк▓рлЛркЬрк┐рк╕рлНркЯ
ЁЯСитАНЁЯОд	ркЕркнрк┐ркирлЗркдрк╛, ркЧрк╛ркпркХ, рккрлБрк░рлБрк╖, ркоркирлЛрк░ркВркЬркиркХрк░рлНркдрк╛, рк░рлЙркХ, рк╕рлНркЯрк╛рк░
ЁЯСйтАНЁЯОд	ркЕркнрк┐ркирлЗркдрк╛, ркЧрк╛ркпрк┐ркХрк╛, ркоркирлЛрк░ркВркЬркиркХрк░рлНркдрк╛, рк░рлЙркХ, рк╕рлНркЯрк╛рк░, рк╕рлНркдрлНрк░рлА
ЁЯСитАНЁЯОи	ркХрк▓рк╛ркХрк╛рк░, ркЪрк┐ркдрлНрк░ркХрк╛рк░, рккрлБрк░рлБрк╖, рккрлБрк░рлБрк╖ ркХрк▓рк╛ркХрк╛рк░
ЁЯСйтАНЁЯОи	ркХрк▓рк╛ркХрк╛рк░, ркЪрк┐ркдрлНрк░ркХрк╛рк░, рк╕рлНркдрлНрк░рлА, рк╕рлНркдрлНрк░рлА ркХрк▓рк╛ркХрк╛рк░
ЁЯСитАНтЬИ	рккрк╛ркЗрк▓ркЯ, рккрлБрк░рлБрк╖, рккрлБрк░рлБрк╖ рккрк╛ркЗрк▓ркЯ, рк╡рк┐ркорк╛рки
ЁЯСйтАНтЬИ	рккрк╛ркЗрк▓ркЯ, рк╡рк┐ркорк╛рки, рк╕рлНркдрлНрк░рлА, рк╕рлНркдрлНрк░рлА рккрк╛ркЗрк▓ркЯ
ЁЯСитАНЁЯЪА	ркЕрк╡ркХрк╛рк╢, ркЕрк╡ркХрк╛рк╢ркпрк╛ркдрлНрк░рлА, рккрлБрк░рлБрк╖, рккрлБрк░рлБрк╖ ркЕрк╡ркХрк╛рк╢ркпрк╛ркдрлНрк░рлА, рк░рлЙркХрлЗркЯ
ЁЯСйтАНЁЯЪА	ркЕрк╡ркХрк╛рк╢, ркЕрк╡ркХрк╛рк╢ркпрк╛ркдрлНрк░рлА, рк░рлЙркХрлЗркЯ, рк╕рлНркдрлНрк░рлА, рк╕рлНркдрлНрк░рлА ркЕрк╡ркХрк╛рк╢ркпрк╛ркдрлНрк░рлА
ЁЯСитАНЁЯЪТ	ркЕркЧрлНркирк┐рк╢рк╛ркоркХ, рккрлБрк░рлБрк╖, рккрлБрк░рлБрк╖ ркЕркЧрлНркирк┐рк╢рк╛ркоркХ
ЁЯСйтАНЁЯЪТ	ркЕркЧрлНркирк┐рк╢рк╛ркоркХ, рк╕рлНркдрлНрк░рлА, рк╕рлНркдрлНрк░рлА ркЕркЧрлНркирк┐рк╢рк╛ркоркХ
ЁЯСо	ркЕркзрк┐ркХрк╛рк░рлА, рккрлЛрк▓рлАрк╕, рккрлЛрк▓рлАрк╕ ркЕркзрк┐ркХрк╛рк░рлА, рк▓рлЛркХрлЛ
ЁЯСотАНтЩВ	ркЕркзрк┐ркХрк╛рк░рлА, рккрлБрк░рлБрк╖, рккрлБрк░рлБрк╖ рккрлЛрк▓рлАрк╕, рккрлЛрк▓рлАрк╕
ЁЯСотАНтЩА	ркЕркзрк┐ркХрк╛рк░рлА, рккрлЛрк▓рлАрк╕, рк╕рлНркдрлНрк░рлА, рк╕рлНркдрлНрк░рлА рккрлЛрк▓рлАрк╕
ЁЯХ╡тАНтЩВ	ркЧрлБрккрлНркдркЪрк░, ркЬрк╛рк╕рлВрк╕, рккрлБрк░рлБрк╖
ЁЯХ╡тАНтЩА	ркЧрлБрккрлНркдркЪрк░, ркЬрк╛рк╕рлВрк╕, рк╕рлНркдрлНрк░рлА, рк╕рлНркдрлНрк░рлА ркЬрк╛рк╕рлВрк╕
ЁЯТВ	ркЪрлЛркХрлАркжрк╛рк░, рк▓рлЛркХрлЛ, рк╕рлБрк░ркХрлНрк╖рк╛ркХрк░рлНркорлА
ЁЯТВтАНтЩВ	ркЪрлЛркХрлАркжрк╛рк░, рккрлБрк░рлБрк╖, рк╕рлБрк░ркХрлНрк╖рк╛ркХрк░рлНркорлА рккрлБрк░рлБрк╖
ЁЯТВтАНтЩА	ркЪрлЛркХрлАркжрк╛рк░, рк╕рлБрк░ркХрлНрк╖рк╛ркХрк░рлНркорлА рк╕рлНркдрлНрк░рлА, рк╕рлНркдрлНрк░рлА
ЁЯС╖	ркХрк╛рк░рлАркЧрк░, ркмрк╛ркВркзркХрк╛рко, ркмрк╛ркВркзркХрк╛рко ркХрк╛рк░рлАркЧрк░, рк╣рлЗркЯ
ЁЯС╖тАНтЩВ	ркХрк╛рк░рлАркЧрк░, рккрлБрк░рлБрк╖, рккрлБрк░рлБрк╖ ркмрк╛ркВркзркХрк╛рко ркХрк╛рк░рлАркЧрк░, ркмрк╛ркВркзркХрк╛рко
ЁЯС╖тАНтЩА	ркХрк╛рк░рлАркЧрк░, ркмрк╛ркВркзркХрк╛рко, рк╕рлНркдрлНрк░рлА, рк╕рлНркдрлНрк░рлА ркмрк╛ркВркзркХрк╛рко ркХрк╛рк░рлАркЧрк░
ЁЯд┤	рк░рк╛ркЬркХрлБркорк╛рк░
ЁЯС╕	рккрк░рлА ркХркерк╛, рк░рк╛ркЬркХрлБркорк╛рк░рлА, рк▓рлЛркХрлЛ
ЁЯС│	рккрк╛ркШркбрлА, рккрк╛ркШркбрлАрк╡рк╛рк│рлЛ рк╡рлНркпркХрлНркдрк┐, рккрлБрк░рлБрк╖, рк▓рлЛркХрлЛ
ЁЯС│тАНтЩВ	рккрк╛ркШркбрлА, рккрк╛ркШркбрлАрк╡рк╛рк│рлЛ рккрлБрк░рлБрк╖, рккрлБрк░рлБрк╖
ЁЯС│тАНтЩА	рккрк╛ркШркбрлА, рккрк╛ркШркбрлА рк╡рк╛рк│рлА рк╕рлНркдрлНрк░рлА, рк╕рлНркдрлНрк░рлА
ЁЯС▓	ркЧрлБркЖ рккрлА ркорк╛ркУ, ркЧрлБркЖ рккрлА ркорк╛ркУ рк╕рк╛ркерлЗркирлЛ рккрлБрк░рлБрк╖, ркЪрлАркирлА ркЯрлЛрккрлА рк╕рк╛ркерлЗркирлЛ рккрлБрк░рлБрк╖, рккрлБрк░рлБрк╖, рк▓рлЛркХрлЛ
ЁЯзХ	ркорк╛ркерк╛ркирк╛ рк╕рлНркХрк╛ркл рк╕рк╛ркерлЗ рк╕рлНркдрлНрк░рлА
ЁЯд╡	ркЯркХрлНрк╕рлАркбрлЛ, ркЯркХрлНрк╕рлАркбрлЛ рккрк╣рлЗрк░рлЗрк▓рлЛ ркорк╛ркгрк╕, ркорк╛ркгрк╕, рк╡рк░рк░рк╛ркЬрк╛
ЁЯС░	ркШрлВркВркШркЯ, ркШрлВркВркШркЯ ркдрк╛ркгрлЗрк▓рлА ркирк╡рк╡ркзрлБ, ркдрк╛ркгрлЗрк▓рлА ркирк╡рк╡ркзрлБ, ркирк╡рк╡ркзрлБ, рк▓рлЛркХрлЛ
ЁЯд░	рк╕ркЧрк░рлНркнрк╛, рк╕ркЧрк░рлНркнрк╛ рк╕рлНркдрлНрк░рлА, рк╕рлНркдрлНрк░рлА
ЁЯд▒	рк╕рлНркдркирккрк╛рки
ЁЯС╝	ркЪрк╣рлЗрк░рлЛ, ркжрлЗрк╡ркжрлВркд, рккрк░рлА ркХркерк╛, ркмрк╛рк│ ркжрлЗрк╡ркжрлВркд
ЁЯОЕ	ркЙркЬрк╡ркгрлА, ркирк╛ркдрк╛рк▓, рклрк╛ркзрк░ ркХрлНрк░рк┐рк╕ркорк╕, рк╕рк╛ркВркдрк╛, рк╕рк╛ркВркдрк╛ ркХрлНрк▓рлЛркЭ
ЁЯд╢	ркХрлНрк░рк┐рк╕рлНркорк╕, ркоркзрк░, ркоркзрк░ ркХрлНрк░рк┐рк╕рлНркорк╕
ЁЯж╕	ркЧрлБркгрк╡рк╛рки, рк╕рлБрккрк░рккрк╛рк╡рк░, рк╕рлБрккрк░рк╣рлАрк░рлЛ, рк╣рлАрк░рлЛ, рк╣рлАрк░рлЛркЗрки
ЁЯж╕тАНтЩА	ркЧрлБркгрк╡рк╛рки, рк╕рлБрккрк░рккрк╛рк╡рк░, рк╕рлНркдрлНрк░рлА, рк╕рлНркдрлНрк░рлА рк╕рлБрккрк░рк╣рлАрк░рлЛ, рк╣рлАрк░рлЛ, рк╣рлАрк░рлЛркЗрки
ЁЯж╕тАНтЩВ	ркЧрлБркгрк╡рк╛рки, рккрлБрк░рлБрк╖, рккрлБрк░рлБрк╖ рк╕рлБрккрк░рк╣рлАрк░рлЛ, рк╕рлБрккрк░рккрк╛рк╡рк░, рк╣рлАрк░рлЛ
ЁЯж╣	ркЦрк▓ркирк╛ркпркХ, ркЧрлБркирлЗркЧрк╛рк░, ркжрлБрк╖рлНркЯ, рк╡рк┐рк▓рки, рк╕рлБрккрк░рккрк╛рк╡рк░, рк╕рлБрккрк░рк╡рк┐рк▓рки
ЁЯж╣тАНтЩА	ркЦрк▓ркирк╛ркпркХ, ркЧрлБркирлЗркЧрк╛рк░, ркжрлБрк╖рлНркЯ, рк╡рк┐рк▓рки, рк╕рлБрккрк░рккрк╛рк╡рк░, рк╕рлНркдрлНрк░рлА, рк╕рлНркдрлНрк░рлА рк╕рлБрккрк░рк╡рк┐рк▓рки
ЁЯж╣тАНтЩВ	ркЦрк▓ркирк╛ркпркХ, ркЧрлБркирлЗркЧрк╛рк░, ркжрлБрк╖рлНркЯ, рккрлБрк░рлБрк╖, рккрлБрк░рлБрк╖ рк╕рлБрккрк░рк╡рк┐рк▓рки, рк╡рк┐рк▓рки, рк╕рлБрккрк░рккрк╛рк╡рк░
ЁЯзЩ	ркорлЗркЬ
ЁЯзЩтАНтЩА	рк╕рлНркдрлНрк░рлА ркорлЗркЬ
ЁЯзЩтАНтЩВ	рккрлБрк░рлБрк╖ ркорлЗркЬ
ЁЯзЪ	рккрк░рлА
ЁЯзЪтАНтЩА	рк╕рлНркдрлНрк░рлА рккрк░рлА
ЁЯзЪтАНтЩВ	рккрлБрк░рлБрк╖ рккрк░рлА
ЁЯзЫ	рккрк┐ркЪрк╛рк╢
ЁЯзЫтАНтЩА	ркорк╣рк┐рк▓рк╛ рккрк┐рк╢рк╛ркЪ
ЁЯзЫтАНтЩВ	рккрлБрк░рлБрк╖ рккрк┐ркЪрк╛рк╢
ЁЯзЬ	ркорк░рккрк░рлНрк╕рки
ЁЯзЬтАНтЩА	ркорк░ркорлЗркИркб
ЁЯзЬтАНтЩВ	ркорк░ркорлЗрки
ЁЯзЭ	ркИрк▓рлНркл
ЁЯзЭтАНтЩА	рк╕рлНркдрлНрк░рлА ркИрк▓рлНркл
ЁЯзЭтАНтЩВ	рккрлБрк░рлБрк╖ ркИрк▓рлНркл
ЁЯзЮ	ркЬрлАркирлА
ЁЯзЮтАНтЩА	рк╕рлНркдрлНрк░рлА ркЬрлАркирлА
ЁЯзЮтАНтЩВ	рккрлБрк░рлБрк╖ ркЬрлАркирлА
ЁЯзЯ	ркЭрлЛркорлНркмрлА
ЁЯзЯтАНтЩА	рк╕рлНркдрлНрк░рлА ркЭрлЛркорлНркмрлА
ЁЯзЯтАНтЩВ	рккрлБрк░рлБрк╖ ркЭрлЛркорлНркмрлА
ЁЯЩН	ркнрк╡рк╛ркВ ркЪркбрк╛рк╡рк╡рк╛ркВ, ркнрк╡рк╛ркВ ркЪркбрк╛рк╡рлЗрк▓ рк╡рлНркпркХрлНркдрк┐, рк╡рлНркпркХрлНркдрк┐, рк╣рк╛рк╡ркнрк╛рк╡
ЁЯЩНтАНтЩВ	рккрлБрк░рлБрк╖, ркнрк╡рк╛ркВ ркЪркбрк╛рк╡рк╡рк╛ркВ, ркнрк╡рк╛ркВ ркЪркбрк╛рк╡рк╡рк╛ркВрк╡рк╛рк│рлЛ рккрлБрк░рлБрк╖, рк╣рк╛рк╡ркнрк╛рк╡
ЁЯЩНтАНтЩА	ркнрк╡рк╛ркВ ркЪркбрк╛рк╡рк╡рк╛ркВ, ркнрк╡рк╛ркВ ркЪркбрк╛рк╡рк╡рк╛ркВрк╡рк╛рк│рлА рк╕рлНркдрлНрк░рлА, рк╕рлНркдрлНрк░рлА, рк╣рк╛рк╡ркнрк╛рк╡
ЁЯЩО	рк░рк┐рк╕рк╛ркдрлА рк╡рлНркпркХрлНркдрк┐, рк░рк┐рк╕рк╛рк╡рлБркВ, рк╡рлНркпркХрлНркдрк┐, рк╣рк╛рк╡ркнрк╛рк╡
ЁЯЩОтАНтЩВ	рккрлБрк░рлБрк╖, рк░рк┐рк╕рк╛ркпрлЗрк▓рлЛ рккрлБрк░рлБрк╖, рк░рк┐рк╕рк╛рк╡рлБркВ, рк╣рк╛рк╡ркнрк╛рк╡
ЁЯЩОтАНтЩА	рк░рк┐рк╕рк╛ркпрлЗрк▓рлА рк╕рлНркдрлНрк░рлА, рк░рк┐рк╕рк╛рк╡рлБркВ, рк╕рлНркдрлНрк░рлА, рк╣рк╛рк╡ркнрк╛рк╡
ЁЯЩЕ	ркЪрк╣рлЗрк░рлЛ, ркирк╣рлАркВ, рккрлНрк░ркдрк┐ркмркВркзрк┐ркд, рк╕рк╛рк░рлБркВ ркиркерлА, рк╕рк╛рк░рлБркВ ркирк╣рлАркВркирлЛ рк╣рк╛рк╡ркнрк╛рк╡, рк╣рк╛рк╡ркнрк╛рк╡
ЁЯЩЕтАНтЩВ	ркЪрк╣рлЗрк░рлЛ, ркирк╣рлАркВ, рккрлБрк░рлБрк╖, рккрлНрк░ркдрк┐ркмркВркзрк┐ркд, рк╕рк╛рк░рлБркВ ркиркерлА, рк╕рк╛рк░рлБркВ ркирк╣рлАркВркирлЛ рк╣рк╛рк╡ркнрк╛рк╡ рккрлБрк░рлБрк╖, рк╣рк╛рк╡ркнрк╛рк╡
ЁЯЩЕтАНтЩА	ркЪрк╣рлЗрк░рлЛ, ркирк╣рлАркВ, рккрлНрк░ркдрк┐ркмркВркзрк┐ркд, рк╕рк╛рк░рлБркВ ркиркерлА, рк╕рк╛рк░рлБркВ ркирк╣рлАркВркирлЛ рк╣рк╛рк╡ркнрк╛рк╡ рк╕рлНркдрлНрк░рлА, рк╕рлНркдрлНрк░рлА, рк╣рк╛рк╡ркнрк╛рк╡
ЁЯЩЖ	ркСркХрлЗ рк╣рк╛рк╡ркнрк╛рк╡, ркСркХрлЗркирлЛ рк╣рк╛рк╡ркнрк╛рк╡, ркЪрк╣рлЗрк░рлЛ, ркмркзрлБркВ ркмрк░рк╛ркмрк░ ркЫрлЗ, рк╣рк╛рк╡ркнрк╛рк╡
ЁЯЩЖтАНтЩВ	ркСркХрлЗ рк╣рк╛рк╡ркнрк╛рк╡, ркЪрк╣рлЗрк░рлЛ, рккрлБрк░рлБрк╖, рккрлБрк░рлБрк╖ ркСркХрлЗркирлЛ рк╣рк╛рк╡ркнрк╛рк╡, ркмркзрлБркВ ркмрк░рк╛ркмрк░ ркЫрлЗ, рк╣рк╛рк╡ркнрк╛рк╡
ЁЯЩЖтАНтЩА	ркСркХрлЗ рк╣рк╛рк╡ркнрк╛рк╡, ркЪрк╣рлЗрк░рлЛ, ркмркзрлБркВ ркмрк░рк╛ркмрк░ ркЫрлЗ, рк╕рлНркдрлНрк░рлА, рк╕рлНркдрлНрк░рлА, ркСркХрлЗркирлЛ рк╣рк╛рк╡ркнрк╛рк╡, рк╣рк╛рк╡ркнрк╛рк╡
ЁЯТБ	ркорк╛рк╣рк┐ркдрлА, ркорк╛рк╣рк┐ркдрлА ркЖрккркдрлА рк╡рлНркпркХрлНркдрк┐, ркорк╛рк╣рк┐ркдрлА ркбрлЗрк╕рлНркХ, рк▓рлЛркХрлЛ, рк╕рк╣рк╛ркп
ЁЯТБтАНтЩВ	рккрлБрк░рлБрк╖, ркорк╛рк╣рк┐ркдрлА, ркорк╛рк╣рк┐ркдрлА ркЖрккркдрлЛ рккрлБрк░рлБрк╖, ркорк╛рк╣рк┐ркдрлА ркбрлЗрк╕рлНркХ, рк╕рк╣рк╛ркп
ЁЯТБтАНтЩА	ркорк╛рк╣рк┐ркдрлА, ркорк╛рк╣рк┐ркдрлА ркЖрккркдрлА рк╕рлНркдрлНрк░рлА, ркорк╛рк╣рк┐ркдрлА ркбрлЗрк╕рлНркХ, рк╕рк╣рк╛ркп, рк╕рлНркдрлНрк░рлА
ЁЯЩЛ	ркЙрккрк░ рк╣рк╛рке ркЙркарк╛рк╡рк╡рлЛ, ркЦрлБрк╢, рк╡рлНркпркХрлНркдрк┐, рк╣рк╛рке ркЙрккрк░ ркЙркарк╛рк╡ркдрлА ркЦрлБрк╢ рк╡рлНркпркХрлНркдрк┐, рк╣рк╛рке ркЙрккрк░ ркЙркарк╛рк╡рлЗрк▓ рк╡рлНркпркХрлНркдрк┐, рк╣рк╛рк╡ркнрк╛рк╡
ЁЯЩЛтАНтЩВ	ркЙрккрк░ рк╣рк╛рке ркЙркарк╛рк╡рк╡рлЛ, рккрлБрк░рлБрк╖, рк╣рк╛рке ркЙрккрк░ ркЙркарк╛рк╡ркдрлЛ ркЦрлБрк╢ рккрлБрк░рлБрк╖, рк╣рк╛рк╡ркнрк╛рк╡
ЁЯЩЛтАНтЩА	ркЙрккрк░ рк╣рк╛рке ркЙркарк╛рк╡рк╡рлЛ, рк╕рлНркдрлНрк░рлА, рк╣рк╛рке ркЙрккрк░ ркЙркарк╛рк╡ркдрлА ркЦрлБрк╢ рк╕рлНркдрлНрк░рлА, рк╣рк╛рк╡ркнрк╛рк╡
ЁЯЩЗ	ркКркВркбрлЗркерлА ркиркорлЗрк▓, ркиркорк╡рлБркВ, ркоркирлЗ ркорк╛ркл ркХрк░рк╢рлЛ, ркорк╛ркл ркХрк░рк╢рлЛ, рк╡ркВркжрки ркХрк░ркдрлА рк╡рлНркпркХрлНркдрк┐, рк╡рлНркпркХрлНркдрк┐, рк╣рк╛рк╡ркнрк╛рк╡
ЁЯЩЗтАНтЩВ	ркКркВркбрлЗркерлА ркиркорлЗрк▓, ркиркорк╡рлБркВ, рккрлБрк░рлБрк╖, ркоркирлЗ ркорк╛ркл ркХрк░рк╢рлЛ, ркорк╛ркл ркХрк░рк╢рлЛ, рк╡ркВркжрки ркХрк░ркдрлЛ рккрлБрк░рлБрк╖, рк╣рк╛рк╡ркнрк╛рк╡
ЁЯЩЗтАНтЩА	ркКркВркбрлЗркерлА ркиркорлЗрк▓, ркиркорк╡рлБркВ, ркоркирлЗ ркорк╛ркл ркХрк░рк╢рлЛ, ркорк╛ркл ркХрк░рк╢рлЛ, рк╡ркВркжрки ркХрк░ркдрлА рк╕рлНркдрлНрк░рлА, рк╕рлНркдрлНрк░рлА, рк╣рк╛рк╡ркнрк╛рк╡
ЁЯдж	ркЕрк╡рк┐рк╢рлНрк╡рк╛рк╕, ркЪрк╣рлЗрк░рлЛ, ркорк╛ркерк╛ ркЙрккрк░ рк╣рк╛рке ркжрлЗрк╡рлЛ, рк░рлЛрк╖, рк╣рк╛рке
ЁЯджтАНтЩВ	ркЕрк╡рк┐рк╢рлНрк╡рк╛рк╕, рккрлБрк░рлБрк╖, ркорк╛ркерк╛ ркЙрккрк░ рк╣рк╛рке ркжрлЗркдрлЛ рккрлБрк░рлБрк╖, ркорк╛ркерк╛ ркЙрккрк░ рк╣рк╛рке ркжрлЗрк╡рлЛ, рк░рлЛрк╖, рк╣рк╛рке
ЁЯджтАНтЩА	ркЕрк╡рк┐рк╢рлНрк╡рк╛рк╕, ркорк╛ркерк╛ ркЙрккрк░ рк╣рк╛рке ркжрлЗркдрлА рк╕рлНркдрлНрк░рлА, ркорк╛ркерк╛ ркЙрккрк░ рк╣рк╛рке ркжрлЗрк╡рлЛ, рк░рлЛрк╖, рк╕рлНркдрлНрк░рлА, рк╣рк╛рке
ЁЯд╖	ркЕркЬрлНркЮрк╛рки, ркмрлЗркжрк░ркХрк╛рк░рлА, рк▓рк╛рккрк░рк╡рк╛ркИ, рк╢ркВркХрк╛
ЁЯд╖тАНтЩВ	ркЕркЬрлНркЮрк╛рки, рккрлБрк░рлБрк╖, ркмрлЗркжрк░ркХрк╛рк░рлА, ркмрлЗркжрк░ркХрк╛рк░рлА рккрлБрк░рлБрк╖, рк▓рк╛рккрк░рк╡рк╛ркИ, рк╢ркВркХрк╛
ЁЯд╖тАНтЩА	ркЕркЬрлНркЮрк╛рки, ркмрлЗркжрк░ркХрк╛рк░рлА, ркмрлЗркжрк░ркХрк╛рк░рлА рк╕рлНркдрлНрк░рлА, рк▓рк╛рккрк░рк╡рк╛ркИ, рк╢ркВркХрк╛, рк╕рлНркдрлНрк░рлА
ЁЯТЖ	рклрлЗрк╕ ркорк╕рк╛ркЬ, ркорк╕рк╛ркЬ, рк╕рк▓рлБрки
ЁЯТЖтАНтЩВ	ркЪрк╣рлЗрк░рлЛ, рккрлБрк░рлБрк╖, рклрлЗрк╕ ркорк╕рк╛ркЬ рк▓рлЗркдрлЛ рккрлБрк░рлБрк╖, ркорк╕рк╛ркЬ
ЁЯТЖтАНтЩА	ркЪрк╣рлЗрк░рлЛ, рклрлЗрк╕ ркорк╕рк╛ркЬ рк▓рлЗркдрлА рк╕рлНркдрлНрк░рлА, ркорк╕рк╛ркЬ, рк╕рлНркдрлНрк░рлА
ЁЯТЗ	рккрк╛рк░рлНрк▓рк░, ркмрлНркпрлБркЯрлАрккрк╛рк░рлНрк▓рк░, рк╕рлБркВркжрк░ркдрк╛, рк╣рлЗрк░ркХркЯ
ЁЯТЗтАНтЩВ	рккрлБрк░рлБрк╖, рк╣рлЗрк░ркХркЯ, рк╣рлЗрк░ркХркЯ ркХрк░рк╛рк╡ркдрлЛ рккрлБрк░рлБрк╖
ЁЯТЗтАНтЩА	рк╕рлНркдрлНрк░рлА, рк╣рлЗрк░ркХркЯ, рк╣рлЗрк░ркХркЯ ркХрк░рк╛рк╡ркдрлА рк╕рлНркдрлНрк░рлА
ЁЯЪ╢	рккркжркпрк╛ркдрлНрк░рлА, рк░рк╛рк╣ркжрк╛рк░рлА
ЁЯЪ╢тАНтЩВ	ркЪрк╛рк▓рк╡рлБркВ, рккркжркпрк╛ркдрлНрк░рлА ркХрк░ркдрлЛ рккрлБрк░рлБрк╖, рккрлБрк░рлБрк╖, рк╣рк╛ркИркХ
ЁЯЪ╢тАНтЩА	ркЪрк╛рк▓рк╡рлБркВ, рккркжркпрк╛ркдрлНрк░рлА ркХрк░ркдрлА рк╕рлНркдрлНрк░рлА, рк╕рлНркдрлНрк░рлА, рк╣рк╛ркИркХ
ЁЯПГ	ркЦрлЗрк▓ ркХрлВркж, ркжрлЛркб, ркжрлЛркбрк╡рлАрк░, ркорлЗрк░рк╛ркерлЛрки
ЁЯПГтАНтЩВ	ркЦрлЗрк▓ ркХрлВркж, ркжрлЛркб, ркжрлЛркбркдрлЛ рккрлБрк░рлБрк╖, рккрлБрк░рлБрк╖, ркорлЗрк░рк╛ркерлЛрки
ЁЯПГтАНтЩА	ркЦрлЗрк▓ ркХрлВркж, ркжрлЛркб, ркжрлЛркбркдрлА рк╕рлНркдрлНрк░рлА, ркорлЗрк░рк╛ркерлЛрки, рк╕рлНркдрлНрк░рлА
ЁЯТГ	ркирлГркдрлНркп, ркирлГркдрлНркпрк╛ркВркЧркирк╛, рк▓рлЛркХрлЛ
ЁЯХ║	ркбрк╛ркирлНрк╕, ркбрк╛ркирлНрк╕ ркХрк░ркдрлЛ ркорк╛ркгрк╕, ркорк╛ркгрк╕
ЁЯСп	ркЫрлЛркХрк░рлА, ркирлГркдрлНркпрк╛ркВркЧркирк╛, рккрк╛рк░рлНркЯрлА ркХрк░ркдрлА рк╕рлНркдрлНрк░рлАркУ, рк▓рлЛркХрлЛ, рк╕рк╕рк▓рк╛ ркЬрлЗрк╡рк╛ ркХрк╛рки, рк╕рк╕рк▓рк╛ ркЬрлЗрк╡рлА рк▓рк╛ркЧркдрлА ркЫрлЛркХрк░рлА, рк╕рлНркдрлНрк░рлА
ЁЯСптАНтЩВ	ркбрк╛ркирлНрк╕рк░, ркирлГркдрлНркпрк╛ркВркЧркирк╛, рккрк╛рк░рлНркЯрлА, рккрк╛рк░рлНркЯрлА ркХрк░ркдрк╛ рккрлБрк░рлБрк╖рлЛ, рккрлБрк░рлБрк╖рлЛ, рк╕рк╕рк▓рк╛ ркЬрлЗрк╡рк╛ ркХрк╛рки
ЁЯСптАНтЩА	ркбрк╛ркирлНрк╕рк░, ркирлГркдрлНркпрк╛ркВркЧркирк╛, рккрк╛рк░рлНркЯрлА, рк╕рк╕рк▓рк╛ ркЬрлЗрк╡рк╛ ркХрк╛рки, рк╕рлНркдрлНрк░рлАркУ, рк╕рлНркдрлНрк░рлАркУ рккрк╛рк░рлНркЯрлА ркХрк░рлЗ ркЫрлЗ
ЁЯзЦ	ркмрк╛рклрк╡рк╛рк│рк╛ рк░рлВркоркорк╛ркВ рк╡рлНркпркХрлНркдрк┐, рк╕рлЙркирк╛, рк╕рлНркЯрлАрко рк░рлВрко
ЁЯзЦтАНтЩА	рк╕рлЙркирк╛, рк╕рлНркЯрлАрко рк░рлВрко, рк╕рлНркЯрлАркорлА рк░рлВркоркорк╛ркВ рк╕рлНркдрлНрк░рлА
ЁЯзЦтАНтЩВ	рк╕рлЙркирк╛, рк╕рлНркЯрлАрко рк░рлВрко, рк╕рлНркЯрлАркорк╡рк╛рк│рк╛ рк░рлВркоркорк╛ркВ рккрлБрк░рлБрк╖
ЁЯзЧ	ркЙрккрк░ ркЪрквркирк╛рк░, рк╡рлНркпркХрлНркдрк┐ ркЪркврк╛ркИ рккрк░
ЁЯзЧтАНтЩА	ркЙрккрк░ ркЪрквркирк╛рк░, рк╕рлНркдрлНрк░рлА ркЪркврк╛ркИ рккрк░
ЁЯзЧтАНтЩВ	ркЙрккрк░ ркЪрквркирк╛рк░, рккрлБрк░рлБрк╖ ркЪркврк╛ркИ рккрк░
ЁЯзШ	ркзрлНркпрк╛рки, ркпрлЛркЧ, рк╡рлНркпркХрлНркдрк┐ ркХркорк│ ркЬрлЗрк╡рлА рк╕рлНркерк┐ркдрк┐ркорк╛ркВ
ЁЯзШтАНтЩА	ркзрлНркпрк╛рки, ркпрлЛркЧ, рк╕рлНркдрлНрк░рлА ркХркорк│ ркЬрлЗрк╡рлА рк╕рлНркерк┐ркдрк┐ркорк╛ркВ
ЁЯзШтАНтЩВ	ркзрлНркпрк╛рки, рккрлБрк░рлБрк╖ ркХркорк│ ркЬрлЗрк╡рлА рк╕рлНркерк┐ркдрк┐ркорк╛ркВ, ркпрлЛркЧ
ЁЯЫА	рк╕рлНркирк╛рки, рк╕рлНркирк╛рки ркХрк░ркдрлА рк╡рлНркпркХрлНркдрк┐
ЁЯЫМ	ркКркВркШ, ркирк┐ркВркжрлНрк░рк╛, рккркерк╛рк░рлАркорк╛ркВ рк╕рлВркдрлА рк╡рлНркпркХрлНркдрк┐, рк╣рлЛркЯрк▓
ЁЯСд	рккрк╛рк░рлНрк╢рлНрк╡ркЪрк┐ркдрлНрк░, рккрлЗркЯркерлА ркЙрккрк▓рк╛ ркнрк╛ркЧркирлБркВ рккрк╛рк░рлНрк╢рлНрк╡ркЪрк┐ркдрлНрк░, рккрлЗркЯркерлА ркЙрккрк▓рлЛ ркнрк╛ркЧ, рк▓рлЛркХрлЛ
ЁЯСе	рккрк╛рк░рлНрк╢рлНрк╡ркЪрк┐ркдрлНрк░, рккрлЗркЯркерлА ркЙрккрк▓рк╛ ркнрк╛ркЧркирк╛ рккрк╛рк░рлНрк╢рлНрк╡ркЪрк┐ркдрлНрк░, рккрлЗркЯркерлА ркЙрккрк▓рк╛ ркнрк╛ркЧркирлБркВ рккрк╛рк░рлНрк╢рлНрк╡ркЪрк┐ркдрлНрк░, рккрлЗркЯркерлА ркЙрккрк▓рлЛ ркнрк╛ркЧ, рк▓рлЛркХрлЛ
ЁЯд║	ркдрк▓рк╡рк╛рк░, рклрлЗркирлНрк╕рк░, рклрлЗркирлНрк╕рк┐ркВркЧ, ркорк╛ркгрк╕, рк╕рлНрккрлЙрк░рлНркЯ
ЁЯПЗ	ркЦрлЗрк▓ ркХрлВркж, ркШрлЛркбрк╛ ркжрлЛркб, ркШрлЛркбрлЛ, ркЬрлЛркХрлА, ркжрлЛркб, рк░рлЗрк╕ркирлЛ ркШрлЛркбрлЛ
ЁЯПМтАНтЩВ	ркЧрлЛрк▓рлНркл, ркЧрлЛрк▓рлНркл рк░ркоркирк╛рк░ рккрлБрк░рлБрк╖, рккрлБрк░рлБрк╖
ЁЯПМтАНтЩА	ркЧрлЛрк▓рлНркл, ркЧрлЛрк▓рлНркл рк░ркоркирк╛рк░ рк╕рлНркдрлНрк░рлА, рк╕рлНркдрлНрк░рлА
ЁЯПДтАНтЩВ	рккрлБрк░рлБрк╖, рк╕рк░рлНрклрк┐ркВркЧ, рк╕рк░рлНрклрк┐ркВркЧ ркХрк░ркдрлЛ рккрлБрк░рлБрк╖
ЁЯПДтАНтЩА	рк╕рк░рлНрклрк┐ркВркЧ, рк╕рк░рлНрклрк┐ркВркЧ ркХрк░ркдрлА рк╕рлНркдрлНрк░рлА, рк╕рлНркдрлНрк░рлА
ЁЯЪг	ркирк╛рк╡ркбрлА, рк╡рк╛рк╣рки, рк╣рлЛркбрлА
ЁЯЪгтАНтЩВ	рккрлБрк░рлБрк╖, рк╣рлЛркбрлА, рк╣рлЛркбрлА ркЪрк▓рк╛рк╡ркдрлЛ рккрлБрк░рлБрк╖
ЁЯЪгтАНтЩА	рк╕рлНркдрлНрк░рлА, рк╣рлЛркбрлА, рк╣рлЛркбрлА ркЪрк▓рк╛рк╡ркдрлА рк╕рлНркдрлНрк░рлА
ЁЯПКтАНтЩВ	рккрлБрк░рлБрк╖, рк╕рлНрк╡рк┐рко, рк╕рлНрк╡рк┐рко ркХрк░ркдрлЛ рккрлБрк░рлБрк╖
ЁЯПКтАНтЩА	рк╕рлНркдрлНрк░рлА, рк╕рлНрк╡рк┐рко, рк╕рлНрк╡рк┐рко ркХрк░ркдрлА рк╕рлНркдрлНрк░рлА
тЫ╣тАНтЩВ	рккрлБрк░рлБрк╖, ркмрлЛрк▓, ркмрлЛрк▓ рк╕рк╛ркерлЗркирлЛ рккрлБрк░рлБрк╖
тЫ╣тАНтЩА	ркмрлЛрк▓, ркмрлЛрк▓ рк╕рк╛ркерлЗркирлА рк╕рлНркдрлНрк░рлА, рк╕рлНркдрлНрк░рлА
ЁЯПЛтАНтЩВ	рккрлБрк░рлБрк╖, рк╡рлЗркЯ рк▓рк┐рклрлНркЯ ркХрк░ркдрлЛ рккрлБрк░рлБрк╖, рк╡рлЗркЯ рк▓рк┐рклрлНркЯрк░
ЁЯПЛтАНтЩА	рк╡рлЗркЯ рк▓рк┐рклрлНркЯ ркХрк░ркдрлА рк╕рлНркдрлНрк░рлА, рк╡рлЗркЯ рк▓рк┐рклрлНркЯрк░, рк╕рлНркдрлНрк░рлА
ЁЯЪ┤	ркмрк╛ркЗркХ, ркмрк╛ркЗрк╕рк┐ркХрк▓ рк╕рк╡рк╛рк░, рк╕рк╛ркЗркХрк▓ рк╕рк╡рк╛рк░
ЁЯЪ┤тАНтЩВ	рккрлБрк░рлБрк╖, ркмрк╛ркЗркХрк┐ркВркЧ, ркмрк╛ркЗрк╕рк┐ркХрк▓, ркмрк╛ркЗрк╕рк┐ркХрк▓ ркЪрк▓рк╛рк╡ркдрлЛ рккрлБрк░рлБрк╖, рк╕рк╛ркЗркХрлНрк▓рк┐рк╕рлНркЯ
ЁЯЪ┤тАНтЩА	ркмрк╛ркЗркХрк┐ркВркЧ, ркмрк╛ркЗрк╕рк┐ркХрк▓, ркмрк╛ркЗрк╕рк┐ркХрк▓ ркЪрк▓рк╛рк╡ркдрлА рк╕рлНркдрлНрк░рлА, рк╕рк╛ркЗркХрлНрк▓рк┐рк╕рлНркЯ, рк╕рлНркдрлНрк░рлА
ЁЯЪ╡	рккрк░рлНрк╡ркд, рккрк░рлНрк╡ркдрк╛рк░рлЛрк╣ркгркирк╛ ркмрк╛ркЗрк╕рк┐ркХрк▓ рк╕рк╡рк╛рк░, ркмрк╛ркЗркХ, рк╕рк╛ркЗркХрк▓ рк╕рк╡рк╛рк░
ЁЯЪ╡тАНтЩВ	рккрк░рлНрк╡ркд, рккрк░рлНрк╡ркд ркЙрккрк░ ркмрк╛ркЗрк╕рк┐ркХрк▓ ркЪрк▓рк╛рк╡ркдрлЛ рккрлБрк░рлБрк╖, рккрлБрк░рлБрк╖, ркмрк╛ркЗркХрк┐, ркмрк╛ркЗрк╕рк┐ркХрк▓, рк╕рк╛ркЗркХрлНрк▓рк┐рк╕рлНркЯ
ЁЯЪ╡тАНтЩА	рккрк░рлНрк╡ркд, рккрк░рлНрк╡ркд ркЙрккрк░ ркмрк╛ркЗрк╕рк┐ркХрк▓ ркЪрк▓рк╛рк╡ркдрлА рк╕рлНркдрлНрк░рлА, ркмрк╛ркЗркХрк┐, ркмрк╛ркЗрк╕рк┐ркХрк▓, рк╕рк╛ркЗркХрлНрк▓рк┐рк╕рлНркЯ, рк╕рлНркдрлНрк░рлА
ЁЯд╕	ркХрк╛рк░рлНркЯрк╡рлНрк╣рлАрк▓, ркЬрк┐ркорлНркирлЗрк╕рлНркЯрк┐ркХрлНрк╕, ркорк╛ркгрк╕, рк╕рлНрккрлЙрк░рлНркЯ
ЁЯд╕тАНтЩВ	ркХрк╛рк░рлНркЯрк╡рлНрк╣рлАрк▓, ркХрк╛рк░рлНркЯрк╡рлНрк╣рлАрк▓ ркХрк░ркдрлЛ рккрлБрк░рлБрк╖, ркЬрк┐ркорлНркирлЗрк╕рлНркЯрк┐ркХрлНрк╕, рккрлБрк░рлБрк╖, ркорк╛ркгрк╕, рк╕рлНрккрлЙрк░рлНркЯ
ЁЯд╕тАНтЩА	ркХрк╛рк░рлНркЯрк╡рлНрк╣рлАрк▓, ркХрк╛рк░рлНркЯрк╡рлНрк╣рлАрк▓ ркХрк░ркдрлА рк╕рлНркдрлНрк░рлА, ркЬрк┐ркорлНркирлЗрк╕рлНркЯрк┐ркХрлНрк╕, ркорк╛ркгрк╕, рк╕рлНркдрлНрк░рлА, рк╕рлНрккрлЙрк░рлНркЯ
ЁЯд╝	ркХрлБрк╕рлНркдрлА, рккрк╣рлЗрк▓рк╡рк╛рки, рккрк╣рлЗрк▓рк╡рк╛ркирлЛ, ркорк╛ркгрк╕, рк╕рлНрккрлЙрк░рлНркЯ
ЁЯд╝тАНтЩВ	ркХрлБрк╕рлНркдрлА, ркХрлБрк╕рлНркдрлА ркХрк░ркдрк╛ рккрлБрк░рлБрк╖рлЛ, рккрк╣рлЗрк▓рк╡рк╛рки, рккрлБрк░рлБрк╖, ркорк╛ркгрк╕, рк╕рлНрккрлЙрк░рлНркЯ
ЁЯд╝тАНтЩА	ркХрлБрк╕рлНркдрлА, ркХрлБрк╕рлНркдрлА ркХрк░ркдрлА рк╕рлНркдрлНрк░рлАркУ, рккрк╣рлЗрк▓рк╡рк╛рки, ркорк╛ркгрк╕, рк╕рлНркдрлНрк░рлА, рк╕рлНрккрлЙрк░рлНркЯ
ЁЯд╜	рккрлЛрк▓рлЛ, ркорк╛ркгрк╕, рк╡рлЙркЯрк░, рк╡рлЙркЯрк░ рккрлЛрк▓рлЛ, рк╕рлНрккрлЙрк░рлНркЯ
ЁЯд╜тАНтЩВ	рккрлБрк░рлБрк╖, рккрлЛрк▓рлЛ, рк╡рлЙркЯрк░, рк╡рлЙркЯрк░ рккрлЛрк▓рлЛ ркХрк░ркдрлЛ рккрлБрк░рлБрк╖, рк╕рлНрккрлЙрк░рлНркЯ
ЁЯд╜тАНтЩА	рккрлЛрк▓рлЛ, рк╡рлЙркЯрк░, рк╡рлЙркЯрк░ рккрлЛрк▓рлЛ ркХрк░ркдрлА рк╕рлНркдрлНрк░рлА, рк╕рлНркдрлНрк░рлА, рк╕рлНрккрлЙрк░рлНркЯ
ЁЯд╛	ркмрлЛрк▓, ркорк╛ркгрк╕, рк╕рлНрккрлЙрк░рлНркЯ, рк╣рлЕркирлНркбркмрлЛрк▓
ЁЯд╛тАНтЩВ	рккрлБрк░рлБрк╖, рк╕рлНрккрлЙрк░рлНркЯ, рк╣рлЕркирлНркбркмрлЛрк▓, рк╣рлЕркирлНркбркмрлЛрк▓ рк░ркоркдрлЛ рккрлБрк░рлБрк╖
ЁЯд╛тАНтЩА	рк╕рлНркдрлНрк░рлА, рк╕рлНрккрлЙрк░рлНркЯ, рк╣рлЕркирлНркбркмрлЛрк▓, рк╣рлЕркирлНркбркмрлЛрк▓ рк░ркоркдрлА рк╕рлНркдрлНрк░рлА
ЁЯд╣	ркХрлМрк╢рк▓рлНркп, ркЬркЧрк▓, ркЬркЧрк▓рк┐ркВркЧ, ркмрк╣рлБ ркХрк╛рк░рлНркп, рк╕ркВркдрлБрк▓рки
ЁЯд╣тАНтЩВ	ркЬркЧрк▓рк┐ркВркЧ, ркЬркЧрк▓рк┐ркВркЧ ркХрк░ркдрлЛ рккрлБрк░рлБрк╖, рккрлБрк░рлБрк╖, ркорк▓рлНркЯрлАркЯрк╛рк╕рлНркХ
ЁЯд╣тАНтЩА	ркЬркЧрк▓рк┐ркВркЧ, ркЬркЧрк▓рк┐ркВркЧ ркХрк░ркдрлА рк╕рлНркдрлНрк░рлА, ркорк▓рлНркЯрлАркЯрк╛рк╕рлНркХ, рк╕рлНркдрлНрк░рлА
ЁЯСл	ркПркХркмрлАркЬрк╛ркирк╛ркВ рк╣рк╛рке рккркХркбрк╡рк╛, ркПркХркмрлАркЬрк╛ркирк╛ркВ рк╣рк╛рке рккркХркбрлЗрк▓ рккрлБрк░рлБрк╖ ркЕркирлЗ рк╕рлНркдрлНрк░рлА, рккрлБрк░рлБрк╖, рккрлБрк░рлБрк╖ ркЕркирлЗ рк╕рлНркдрлНрк░рлА, ркпрлБркЧрк▓, рк▓рлЛркХрлЛ, рк╕рлНркдрлНрк░рлА
ЁЯСм	ркПркХркмрлАркЬрк╛ркирк╛ рк╣рк╛рке рккркХркбрлЗрк▓рк╛ ркмрлЗ рккрлБрк░рлБрк╖рлЛ, рккрлБрк░рлБрк╖, ркмрлЗ рккрлБрк░рлБрк╖, ркпрлБркЧрк▓, рк▓рлЛркХрлЛ, рк╣рк╛рке рккркХркбрк╡рк╛
ЁЯСн	ркПркХркмрлАркЬрк╛ркирк╛ркВ рк╣рк╛рке рккркХркбрлЗрк▓рлА ркмрлЗ рк╕рлНркдрлНрк░рлАркУ, ркмрлЗ рк╕рлНркдрлНрк░рлА, ркпрлБркЧрк▓, рк▓рлЛркХрлЛ, рк╕рлНркдрлНрк░рлА, рк╣рк╛рке рккркХркбрк╡рк╛
ЁЯТП	ркЪрлБркВркмрки, ркЪрлБркВркмрки ркХрк░ркдрк╛ркВ, рк░рлЛркорк╛ркВрк╕, рк▓рлЛркХрлЛ
ЁЯТС	ркжрк┐рк▓, ркжрк┐рк▓ рк╕рк╛ркерлЗркирлБркВ ркпрлБркЧрк▓, ркпрлБркЧрк▓, рк░рлЛркорк╛ркВрк╕, рк▓рлЛркХрлЛ
ЁЯд│	ркХрлЕркорк░рк╛, рклрлЛрки, рк╕рлЗрк▓рлНрклрлА
ЁЯТк	рклрк▓рлЗркХрлНрк╕, ркмрк╛рк╡ркбрлБ, ркоркЬркмрлВркд, рк░ркорлВркЬрлА, рк╕рлНркирк╛ркпрлБ
ЁЯж╡	рккркЧ
ЁЯж╢	рккркВркЬрлЛ
ЁЯЦХ	ркЖркВркЧрк│рлА, ркоркзрлНркпркорк╛, рк╡ркЪрк▓рлА ркЖркВркЧрк│рлА, рк╡ркЪрлНркЪрлЗркирлА ркЖркВркЧрк│рлА, рк╢рк░рлАрк░, рк╣рк╛рке
ЁЯдЮ	ркХрлНрк░рлЙрк╕, ркХрлНрк░рлЙрк╕рлНркб рклрк┐ркВркЧрк░рлНрк╕, рклрк┐ркВркЧрк░, ркнрк╛ркЧрлНркп, рк╣рк╛рке
ЁЯЦЦ	ркЖркВркЧрк│рлА, рк╡рк▓рлНркХрки, рк╢рк░рлАрк░, рк╕рлЗрк▓рлНркпрлБркЯркирлА ркПркХ рк░рлАркд, рк╕рлНрккрлЛркЕркХ, рк╣рк╛рке
ЁЯдШ	ркЖркВркЧрк│рлА, рк░рлЛркХ-ркСрки, рк╢рк░рлАрк░, рк╢рк┐ркВркЧркбрк╛ркВ, рк╢рк┐ркВркЧркбрк╛ркирлБркВ ркЪрк┐рк╣рлНрки, рк╣рк╛рке
ЁЯдЩ	ркХрлЙрк▓, ркоркирлЗ ркХрлЙрк▓ ркХрк░рлЛ рк╣рк╛рке, рк╣рк╛рке
тЬЛ	ркЙркарк╛рк╡рлЗрк▓рлЛ рк╣рк╛рке, рк╣рк╛рке
ЁЯСМ	ркЪрк┐рк╣рлНрки, ркмрк░рк╛ркмрк░, ркмрк░рк╛ркмрк░ ркЪрк┐рк╣рлНрки, рк╣рк╛рке
тЬК	ркЙркарк╛рк╡рлЗрк▓ ркорлБркарлНркарлА, ркорлБркарлНркарлА, рк╣рк╛рке
ЁЯСК	ркмркВркз ркорлБркарлНркарлА, ркорлБркарлНркарлА, рк╣рк╛рке
ЁЯдЫ	ркбрк╛ркмрлАркмрк╛ркЬрлБ, ркбрк╛ркмрлАркмрк╛ркЬрлБркирлА ркорлБркарлНркарлА, ркорлБркарлНркарлА
ЁЯдЬ	ркЬркоркгрлАркмрк╛ркЬрлБ, ркЬркоркгрлАркмрк╛ркЬрлБркирлА ркорлБркарлНркарлА, ркорлБркарлНркарлА
ЁЯдЪ	ркмрлЗркХрк╣рлЗркирлНркб, рк╣рк╛рке
ЁЯСЛ	рк╣рк▓рк╛рк╡рк╡рк╛, рк╣рк╛рке, рк╣рк╛рке рк╣рк▓рк╛рк╡рк╡рк╛
ЁЯдЯ	рк╣рк╛рк╡ркнрк╛рк╡ рккрлНрк░ркдрлНркпрлЗ рккрлНрк░рлЗрко
ЁЯСП	ркЪрк┐рк╣рлНрки, ркдрк╛рк│рлА, ркдрк╛рк│рлА рккрк╛ркбркдрк╛ркВ рк╣рк╛рке, рк╣рк╛рке
ЁЯСР	ркЦрлБрк▓рлНрк▓рк╛ркВ, ркЦрлБрк▓рлНрк▓рк╛ркВ рк╣рк╛рке, ркЦрлБрк▓рлНрк▓рк╛ркВ рк╣рк╛ркеркирлБркВ ркЪрк┐рк╣рлНрки, ркЪрк┐рк╣рлНрки, рк╣рк╛рке
ЁЯЩМ	ркЙркЬрк╡ркгрлА, ркЙркЬрк╡ркгрлАркорк╛ркВ ркмркВркирлЗ рк╣рк╛рке ркЙркарк╛рк╡рк╡рк╛, ркмркВркирлЗ рк╣рк╛рке, рк╣рк╛рке ркЙркарк╛рк╡ркдрлА рк╡рлНркпркХрлНркдрк┐, рк╣рлБрк░рк░рлЗ
ЁЯд▓	рк╣ркерлЗрк│рлАркУ ркПркХ рк╕рк╛ркерлЗ
ЁЯЩП	ркЕркжркм рк╡рк╛рк│рлЗрк▓рк╛ рк╣рк╛рке, рккрлНрк░рк╛рк░рлНркеркирк╛, рккрлНрк░рк╛рк░рлНркеркирк╛ ркХрк░рк╡рлА, рк╡рк╛рк│рлЗрк▓рк╛ рк╣рк╛рке, рк╣рк╛рке, рк╣рк╛рк╡ркнрк╛рк╡
ЁЯдЭ	ркХрк░рк╛рк░, ркорк┐рк▓рк╛рк╡рк╡рлБркВ, ркорлАркЯрк┐ркВркЧ, рк╣рк╛рке, рк╣рк╛рке ркорк┐рк▓рк╛рк╡рк╡рлЛ
ЁЯТЕ	ркХрлЛрк╕рлНркорлЗркЯрк┐ркХрлНрк╕, ркиркЦ, ркиркЦркирлА рк╕ркВркнрк╛рк│, ркирлЗркЗрк▓ рккрлЛрк▓рк┐рк╢, рк╣рк╛рке ркдркерк╛ ркиркЦркирлА рк╕рк╛ркЬрк╕ркВркнрк╛рк│
ЁЯСГ	ркЪрк╣рлЗрк░рлЛ, ркирк╛ркХ, рк╢рк░рлАрк░
ЁЯСг	ркирк┐рк╢рк╛рки, рккркЧ, рккркЧркирк╛ркВ ркирк┐рк╢рк╛рки, рк╢рк░рлАрк░
ЁЯСА	ркЖркВркЦрлЛ, ркЪрк╣рлЗрк░рлЛ, рк╢рк░рлАрк░
ЁЯСБтАНЁЯЧи	ркЖркВркЦ, рк╕рк╛ркХрлНрк╖рлА, рк╕рлНрккрлАркЪ ркмркмрк▓
ЁЯза	ркоркЧркЬ
ЁЯж┤	рк╣рк╛ркбркХрк╛ркВ
ЁЯж╖	ркжрк╛ркВркд
ЁЯСЕ	ркЪрк╣рлЗрк░рлЛ, ркЬрлАркн, рк╢рк░рлАрк░
ЁЯСД	ркЪрк╣рлЗрк░рлЛ, ркорлЛркврлБркВ, рк╢рк░рлАрк░, рк╣рлЛрка
ЁЯж░	ркЖркЫрлЛ ркХрлЗрк╕рк░рлА, рк▓рк╛рк▓ рк╡рк╛рк│, рк▓рк╛рк▓ркорк╛ркерлБркВ
ЁЯж▒	ркЖрклрлНрк░рк┐ркХрки рк╡рк╛рк│, рк╡рк╛ркВркХркбрк┐ркпрк╛, рк╡рк╛ркВркХркбрк┐ркпрк╛ рк╡рк╛рк│, рк╡рк╛ркВркХркбрк┐ркпрк╛рк╡рк╛рк│ркирлА рк▓ркЯ
ЁЯж│	ркЧрлНрк░рлЗ, ркШрк░ркбрк╛ркВ, рк╡рк╛рк│, рк╕рклрлЗркж, рк╕рклрлЗркж рк╡рк╛рк│
ЁЯж▓	ркХрлАркорлЛркерлЗрк░рк╛рккрлА, ркЯркХрлЛ, ркЯрк╛рк▓, рк╡рк╛рк│ ркирк╣рлАркВ, рк╡рк╛рк│ рк╡ркЧрк░
ЁЯТЛ	ркЪрлБркВркмрки, ркЪрлБркВркмркиркирлБркВ ркЪрк┐рк╣рлНрки, рк░рлЛркорк╛ркВрк╕, рк╣рлЛрка
ЁЯТШ	ркдрлАрк░, ркдрлАрк░ рк╕рк╛ркерлЗркирлБркВ рк╣рлГркжркп, ркжрк┐рк▓, ркжрк┐рк▓ ркЕркирлЗ ркдрлАрк░, рккрлНрк░рлЗрко, рк▓рк╛ркЧркгрлА
ЁЯТЭ	ркжрк┐рк▓, рк░рк┐ркмрки, рк░рк┐ркмрки рк╕рк╛ркерлЗркирлБркВ ркжрк┐рк▓, рк▓рк╛ркЧркгрлА, рк╡рлЗрк▓рлЗркирлНркЯрк╛ркЗрки
ЁЯТЦ	ркЪрк│ркХркдрлБркВ, ркЪрк│ркХркдрлБркВ ркжрк┐рк▓, рккрлНрк░рлЗрко, рк░рлЛркорк╛ркВркЪрк┐ркд, рк▓рк╛ркЧркгрлА
ЁЯТЧ	ркжрк┐рк▓, рккрлНрк░рлЗрко, ркорлВркВркЭрк╛ркпрлЗрк▓рлБркВ, рк░рлЛркорк╛ркВркЪрк┐ркд, рк▓рк╛ркЧркгрлА, рк╡ркзркдрлБркВ ркжрк┐рк▓
ЁЯТУ	ркжрк┐рк▓, ркзркбркХркдрлБркВ, ркзркбркХркдрлБркВ ркжрк┐рк▓, ркзркбркХрки, рккрлНрк░рлЗрко, рк▓рк╛ркЧркгрлА
ЁЯТЮ	ркЖрк░рк╛ркзрлНркп, ркжрк┐рк▓, рккрлНрк░рлЗрко, ркнркоркдрк╛, ркнркоркдрк╛ ркжрк┐рк▓, рк▓рк╛ркЧркгрлА, рк╕рлБркВркжрк░
ЁЯТХ	рккрлНрк░рлЗрко, рккрлНрк░рлЗркорлАркУ, ркмрлЗ ркжрк┐рк▓, рк▓рк╛ркЧркгрлА
ЁЯТМ	ркжрк┐рк▓, ркжрк┐рк▓ рк╕рк╛ркерлЗркирлЛ ркорлЗркЗрк▓, рккркдрлНрк░, рккрлНрк░рлЗрко рккркдрлНрк░, рк░рлЛркорк╛ркВрк╕
ЁЯТФ	ркдрлЛркбрк╡рлБркВ, ркнркЧрлНрки, ркнркЧрлНрки рк╣рлГркжркп, рк▓рк╛ркЧркгрлА, рк╣рлГркжркп, рк╣рлГркжркп ркнркВркЧ
ЁЯзб	ркирк╛рк░ркВркЧрлА ркжрк┐рк▓
ЁЯТЫ	ркжрк┐рк▓, рккрлАрк│рлБркВ, рккрлАрк│рлБркВ ркжрк┐рк▓, рк▓рк╛ркЧркгрлА
ЁЯТЪ	ркжрк┐рк▓, рк▓рк╛ркЧркгрлА, рк▓рлАрк▓рлБркВ, рк▓рлАрк▓рлБркВ ркжрк┐рк▓
ЁЯТЩ	ркжрк┐рк▓, рк▓рк╛ркЧркгрлА, рк╡рк╛ркжрк│рлА, рк╡рк╛ркжрк│рлА ркжрк┐рк▓
ЁЯТЬ	ркЬрк╛ркВркмрк▓рлА, ркЬрк╛ркВркмрк▓рлА ркжрк┐рк▓, ркжрк┐рк▓, рк▓рк╛ркЧркгрлА
ЁЯЦд	ркХрк╛рк│рлБркВ, ркХрк╛рк│рлБркВ рк╣рлГркжркп, ркЦрк░рк╛ркм, рк╣рлГркжркп
ЁЯТЯ	ркжрк┐рк▓, ркжрк┐рк▓ркирлЛ рк╢ркгркЧрк╛рк░
ЁЯТд	ркКркВркШркдрлБркВ, ркКркВркШрк░рлЗркЯрлА, ркирк╕ркХрлЛрк░рк╛, рк░ркорлВркЬрлА, рк▓рк╛ркЧркгрлА
ЁЯТв	ркХрлЛркорк┐ркХ, ркЧрлБрк╕рлНрк╕рк╛ркирлБркВ ркЪрк┐рк╣рлНрки, ркЧрлБрк╕рлНрк╕рлЗ ркеркпрлЗрк▓рлБркВ, ркЧрлБрк╕рлНрк╕рлЛ, рк▓рк╛ркЧркгрлА
ЁЯТе	ркЯркХрлНркХрк░, ркЯркХрлНркХрк░ркирлБркВ рккрлНрк░ркдрлАркХ, рк░ркорлВркЬрлА, рк▓рк╛ркЧркгрлА
ЁЯТж	рккрк░рк╕рлЗрк╡рк╛ркирк╛ркВ ркЫрк╛ркВркЯрк╛, рккрк░рк╕рлЗрк╡рк╛ркирк╛ркВ ркЯрлАрккрк╛, рккрк░рк╕рлЗрк╡рлЛ, рккрлНрк░рк╕рлНрк╡рлЗркжркпрлБркХрлНркд, рк░ркорлВркЬрлА, рк▓рк╛ркЧркгрлА
ЁЯТи	ркЪрк╛рк▓рлБ ркбрлЗрк╢, ркбрлЗрк╢рк┐ркВркЧ, ркжрлЛркбрлЛ, ркнрк╛ркЧрк╡рлБркВ, рк░ркорлВркЬрлА, рк▓рк╛ркЧркгрлА
ЁЯТл	ркЪркХрлНркХрк░, ркдрк╛рк░рк╛, ркдрк╛рк░рк╛ ркЬрлЛрк╡рк╛, рк░ркорлВркЬрлА, рк▓рк╛ркЧркгрлА
ЁЯТм	рккрк░рккрлЛркЯрлЛ, рклрлБркЧрлНркЧрлЛ, ркнрк╛рк╖ркг рккрк░рккрлЛркЯрлЛ, ркнрк╛рк╖ркг рклрлБркЧрлНркЧрлЛ, рк░ркорлВркЬрлА, рк╕ркВрк╡рк╛ркж
ЁЯТн	рккрк░рккрлЛркЯрлЛ, рк░ркорлВркЬрлА, рк╡рк┐ркЪрк╛рк░, рк╡рк┐ркЪрк╛рк░ркирлЛ рккрк░рккрлЛркЯрлЛ, рк╡рк┐ркЪрк╛рк░ркирлЛ рклрлБркЧрлНркЧрлЛ
ЁЯе╜	ркЧрлЛркЧрк▓рлНрк╕
ЁЯе╝	рк▓рлЗркм ркХрлЛркЯ
ЁЯСФ	ркХрккркбрк╛ркВ, ркЯрк╛ркЗ, ркирлЗркХркЯрк╛ркЗ
ЁЯСХ	ркХрккркбрк╛ркВ, ркЯрлА-рк╢рк░рлНркЯ, рк╢рк░рлНркЯ
ЁЯСЦ	ркХрккркбрк╛ркВ, ркЬрлАркирлНрк╕, ркЯрлНрк░рк╛ркЙркЭрк░, рккрлЗркирлНркЯ
ЁЯзг	рк╕рлНркХрк╛ркл
ЁЯзд	рк╣рк╛ркеркирк╛ ркорлЛркЬрк╛ркВ
ЁЯзе	ркХрлЛркЯ
ЁЯзж	ркорлЛркЬрк╛ркВ
ЁЯСЧ	ркХрккркбрк╛ркВ, ркбрлНрк░рлЗрк╕, рк╡рки-рккрлАрк╕
ЁЯСШ	ркХрккркбрк╛ркВ, ркХрк┐ркорлЛркирлЛ, ркбрлНрк░рлЗрк╕
ЁЯСЩ	ркХрккркбрк╛ркВ, ркирк╛рк╣рк╡рк╛ркирк╛ркВ ркХрккркбрк╛ркВ, ркмрк┐ркХрлАркирлА
ЁЯСЪ	ркХрккркбрк╛ркВ, рк╕рлНркдрлНрк░рлАркирк╛ркВ ркХрккркбрк╛ркВ
ЁЯСЫ	ркХрккркбрк╛ркВ, рккрк░рлНрк╕, рккрк╛ркХрлАркЯ, рккрлИрк╕рк╛ рк░рк╛ркЦрк╡рк╛ркирлБркВ рккрк╛ркХрлАркЯ, рк╕рк┐ркХрлНркХрлЛ
ЁЯСЬ	ркХрккркбрк╛ркВ, ркмрлЗркЧ, рк╣рлЗркирлНркбркмрлЗркЧ
ЁЯСЭ	ркХрккркбрк╛ркВ, рккрк╛ркЙркЪ, ркмрлЗркЧ
ЁЯОТ	ркжрклркдрк░, рк╕рлНркХрлВрк▓, рк╕рлНркХрлВрк▓ ркмрлЗркЧ, рк╕рлНркХрлВрк▓ркирлБркВ ркжрклркдрк░
ЁЯСЮ	ркХрккркбрк╛ркВ, ркЬрлВркдрк╛, рккрлБрк░рлБрк╖ркирк╛ ркЬрлВркдрк╛
ЁЯСЯ	ркХрккркбрк╛ркВ, ркЦрлЗрк▓ркХрлВркж ркорк╛ркЯрлЗркирк╛ркВ ркЬрлВркдрк╛, ркЬрлВркдрк╛, рк╕рлНркирлАркХрк░
ЁЯе╛	рк╣рк╛ркИркХрлАркВркЧ ркмрлВркЯ
ЁЯе┐	рк╕рккрк╛ркЯ ркмрлВркЯ
ЁЯСа	ркЙркВркЪрлА рк╣рк┐рк▓, ркЙркВркЪрлА рк╣рк┐рк▓рк╡рк╛рк│рк╛ ркЬрлВркдрк╛, ркХрккркбрк╛ркВ, ркЬрлВркдрк╛
ЁЯСб	ркХрккркбрк╛ркВ, рк╕рлЗркирлНркбрк▓, рк╕рлНркдрлНрк░рлА, рк╕рлНркдрлНрк░рлАркирк╛ркВ рк╕рлЗркирлНркбрк▓
ЁЯСв	ркХрккркбрк╛ркВ, ркмрлВркЯ, рк╕рлНркдрлНрк░рлА, рк╕рлНркдрлНрк░рлАркирк╛ ркмрлВркЯ
ЁЯСС	ркХрккркбрк╛ркВ, ркорлБркХрлБркЯ, рк░рк╛ркЬрк╛, рк░рк╛ркгрлА
ЁЯСТ	ркХрккркбрк╛ркВ, рк╕рлНркдрлНрк░рлАркирлА рк╣рлЗркЯ, рк╣рлЗркЯ
ЁЯОй	ркЯрлЛркк рк╣рлЗркЯ, ркоркирлЛрк░ркЬрки, рк╣рлЗркЯ
ЁЯзв	ркмрк┐рк▓рк╡рк╛рк│рлА ркХрлЗркк
ЁЯУ┐	ркЬрк╛ркк, ркЬрк╛рккркирлА ркорк╛рк│рк╛, ркзрк░рлНрко, ркзрк╛рк░рлНркорк┐ркХ, рккрлНрк░рк╛рк░рлНркеркирк╛, ркоркгркХрк╛ркВ, ркорк╛рк│рк╛
ЁЯТД	ркХрлЛрк╕рлНркорлЗркЯрк┐ркХрлНрк╕, ркорлЗркХркЕркк, рк▓рк┐рккрк╕рлНркЯрк┐ркХ
ЁЯТН	ркбрк╛ркпркоркирлНркб, рк╡рлАркВркЯрлА
ЁЯТО	ркЬрлНрк╡рлЗрк▓, ркбрк╛ркпркоркВркб, рк░ркдрлНрки, рк░ркдрлНрки рккркерлНркерк░
ЁЯР╡	ркЪрк╣рлЗрк░рлЛ, рккрлНрк░рк╛ркгрлА, рк╡рк╛ркВркжрк░рк╛ркирлЛ ркЪрк╣рлЗрк░рлЛ, рк╡рк╛ркВркжрк░рлЛ
ЁЯРТ	рккрлНрк░рк╛ркгрлА, рк╡рк╛ркирк░
ЁЯжН	ркЧрлЛрк░рлАрк▓рк╛, рккрлНрк░рк╛ркгрлА
ЁЯР╢	ркЪрк╣рлЗрк░рлЛ, рккрлНрк░рк╛ркгрлА, рк╢рлНрк╡рк╛рки, рк╢рлНрк╡рк╛ркиркирлЛ ркЪрк╣рлЗрк░рлЛ
ЁЯРй	ркХрлБркдрк░рлЛ, рккрлВркбрк▓, рккрлНрк░рк╛ркгрлА
ЁЯР║	ркЪрк╣рлЗрк░рлЛ, рккрлНрк░рк╛ркгрлА, рк╡рк░рлБ, рк╡рк░рлБркирлЛ ркЪрк╣рлЗрк░рлЛ
ЁЯжК	ркЪрк╣рлЗрк░рлЛ, рккрлНрк░рк╛ркгрлА, рк╢рк┐ркпрк╛рк│, рк╢рк┐ркпрк╛рк│ркирлЛ ркЪрк╣рлЗрк░рлЛ
ЁЯжЭ	рк░ркХрлВрки, рк▓рлБркЪрлНркЪрлБркВ, рк╡рк┐ркЪрк┐ркдрлНрк░
ЁЯР▒	ркЪрк╣рлЗрк░рлЛ, рккрлНрк░рк╛ркгрлА, ркмрк┐рк▓рк╛ркбрлА, ркмрк┐рк▓рк╛ркбрлАркирлЛ ркЪрк╣рлЗрк░рлЛ
ЁЯжБ	рк░рк╛рк╢рк┐ ркЪрк┐рк╣рлНрки, рк╕рк┐ркВрк╣, рк╕рк┐ркВрк╣ркирлЛ ркЪрк╣рлЗрк░рлЛ
ЁЯРп	рккрлНрк░рк╛ркгрлА, рк╡рк╛ркШ, рк╡рк╛ркШркирлЛ ркЪрк╣рлЗрк░рлЛ
ЁЯРЕ	рккрлНрк░рк╛ркгрлА, рк╡рк╛ркШ
ЁЯРЖ	ркЪрк┐ркдрлНркдрлЛ, рккрлНрк░рк╛ркгрлА
ЁЯР┤	ркШрлЛркбрк╛ркирлЛ ркЪрк╣рлЗрк░рлЛ, ркШрлЛркбрлЛ, ркЪрк╣рлЗрк░рлЛ, рккрлНрк░рк╛ркгрлА
ЁЯРО	ркШрлЛркбрлЛ, рккрлНрк░рк╛ркгрлА
ЁЯжД	ркПркХ рк╢рк┐ркВркЧркбрк╛рк╡рк╛рк│рлЛ ркХрк╛рк▓рлНрккркирк┐ркХ ркШрлЛркбрлЛ, ркЪрк╣рлЗрк░рлЛ, ркорлБркЦ, ркпрлБркирк┐ркХрлЛрк░рлНрки, ркпрлБркирк┐ркХрлЛрк░рлНркиркирлЛ ркЪрк╣рлЗрк░рлЛ
ЁЯжУ	ркЭрк┐ркмрлНрк░рк╛
ЁЯжМ	рккрлНрк░рк╛ркгрлА, рк╣рк░ркг
ЁЯРо	ркЧрк╛ркп, ркЧрк╛ркпркирлЛ ркЪрк╣рлЗрк░рлЛ, ркЪрк╣рлЗрк░рлЛ, рккрлНрк░рк╛ркгрлА
ЁЯРВ	рккрлНрк░рк╛ркгрлА, ркмрк│ркж
ЁЯРГ	рккрк╛ркгрлА, рккрлНрк░рк╛ркгрлА, ркнрлЗркВрк╕
ЁЯРД	ркЧрк╛ркп, рккрлНрк░рк╛ркгрлА
ЁЯР╖	ркЪрк╣рлЗрк░рлЛ, ркбрлБркХрлНркХрк░, ркбрлБркХрлНркХрк░ркирлЛ ркЪрк╣рлЗрк░рлЛ, рккрлНрк░рк╛ркгрлА
ЁЯРЦ	ркбрлБркХрлНркХрк░, рккрлНрк░рк╛ркгрлА
ЁЯРЧ	рккрлНрк░рк╛ркгрлА, ркнрлВркВркб
ЁЯР╜	ркЪрк╣рлЗрк░рлЛ, ркбрлБркХрлНркХрк░ркирлБркВ ркирк╛ркХ, ркирк╛ркХ, рккрлНрк░рк╛ркгрлА
ЁЯРП	ркирк░ ркШрлЗркЯрлБркВ, рккрлНрк░рк╛ркгрлА, ркорлЗрк╖ рк░рк╛рк╢рк┐ ркЪрк┐рк╣рлНрки
ЁЯРС	ркШрлЗркЯрлБркВ, рккрлНрк░рк╛ркгрлА
ЁЯРР	рккрлНрк░рк╛ркгрлА, ркмркХрк░рлА, ркоркХрк░ рк░рк╛рк╢рк┐ ркЪрк┐рк╣рлНрки
ЁЯРк	ркКркВркЯ, ркПркХ ркЦрлВркВркзрк╡рк╛рк│рлБркВ ркКркВркЯ, ркЦрлВркВркз, ркбрлНрк░рлЛркорлЗркбрк░рлА, рккрлНрк░рк╛ркгрлА
ЁЯРл	ркКркВркЯ, ркЦрлВркВркз, рккрлНрк░рк╛ркгрлА, ркмрлЗ ркЦрлВркВркзрк╡рк╛рк│рлЛ ркКркВркЯ, ркмрлЗркХрлНркЯрлНрк░рк┐ркпрки
ЁЯжЩ	ркЖрк▓рлНрккрк╛ркХрк╛, ркКрки, ркЧрлНркпрлБркирк╛ркХрлЛ, рк▓рк╛ркорк╛, рк╡рлАркХрлНркпрлБркирк╛
ЁЯжТ	ркЬрк┐рк░рк╛ркл
ЁЯРШ	рккрлНрк░рк╛ркгрлА, рк╣рк╛ркерлА
ЁЯжП	ркЧрлЗркВркбрлЛ, рккрлНрк░рк╛ркгрлА
ЁЯжЫ	рк╣рк┐рккрлНрккрлЛ, рк╣рк┐рккрлНрккрлЛрккрлЙркЯрлЗркорк╕
ЁЯРн	ркЙркВркжрк░, ркЙркВркжрк░ркирлЛ ркЪрк╣рлЗрк░рлЛ, ркЪрк╣рлЗрк░рлЛ, рккрлНрк░рк╛ркгрлА
ЁЯРБ	рккрлНрк░рк╛ркгрлА, ркорлВрк╖ркХ
ЁЯРА	ркЙркВркжрк░, рккрлНрк░рк╛ркгрлА
ЁЯР╣	ркЪрк╣рлЗрк░рлЛ, рккрлНрк░рк╛ркгрлА, рк╣рлЗркорлНрк╕рлНркЯрк░, рк╣рлЗркорлНрк╕рлНркЯрк░ркирлЛ ркЪрк╣рлЗрк░рлЛ
ЁЯР░	ркЪрк╣рлЗрк░рлЛ, рккрлНрк░рк╛ркгрлА, рк╕рк╕рк▓рк╛ркирлЛ ркЪрк╣рлЗрк░рлЛ, рк╕рк╕рк▓рлБркВ
ЁЯРЗ	рккрлНрк░рк╛ркгрлА, рк╕рк╕рк▓рлБркВ
ЁЯжФ	рк╣рлЗркЬрк╣рлЛркЧ
ЁЯжЗ	ркЪрк╛ркорк╛ркЪрлАркбрк┐ркпрлБркВ, рккрлНрк░рк╛ркгрлА, рк╡рлЕркорлНрккрк╛ркпрк░
ЁЯР╗	ркЪрк╣рлЗрк░рлЛ, рккрлНрк░рк╛ркгрлА, рк░рлАркВркЫ, рк░рлАркВркЫркирлЛ ркЪрк╣рлЗрк░рлЛ
ЁЯРи	ркХрлЛркЖрк▓рк╛, ркХрлЛркЖрк▓рк╛ рк░рлАркВркЫ, рккрлНрк░рк╛ркгрлА
ЁЯР╝	ркЪрк╣рлЗрк░рлЛ, рккрк╛ркирлНркбрк╛, рккрк╛ркирлНркбрк╛ркирлЛ ркЪрк╣рлЗрк░рлЛ, рккрлНрк░рк╛ркгрлА
ЁЯжШ	ркСрк╕рлНркЯрлНрк░рлЗрк▓рк┐ркпрк╛, ркХрк╛ркВркЧрк╛рк░рлБркВ, ркЬркорлНркк, ркорк╛рк░рлНрк╕рлВрккрк┐ркЕрк▓, ркпрлБрк╡рк╛рки ркХрк╛ркВркЧрк╛рк░рлБркВ
ЁЯжб	рккркЬрк╡ркгрлА ркХрк░ркирк╛рк░, ркмрлЕркЬрк░, рк╣ркирлА ркмрлЕркЬрк░
ЁЯР╛	ркирк┐рк╢рк╛рки, рккркВркЬрк╛ркирлБркВ ркирк┐рк╢рк╛рки, рккркВркЬрлЛ, рккрлНрк░рк╛ркгрлА
ЁЯжГ	ркЯрк░рлНркХрлА
ЁЯРФ	ркЪрк┐ркХрки, рккрлНрк░рк╛ркгрлА, ркорк░ркШрлАркирлБркВ ркмркЪрлНркЪрлБркВ
ЁЯРУ	ркХрлВркХркбрлЛ, рккрлНрк░рк╛ркгрлА
ЁЯРг	рккркХрлНрк╖рлАркирлБркВ ркмркЪрлНркЪрлБркВ, рккрлНрк░рк╛ркгрлА, ркмркЪрлНркЪрлБркВ, ркорк░ркШрлАркирлБркВ ркмркЪрлНркЪрлБркВ, рк╕рлЗрк╡рк╡рлБркВ, рк╕рлЗрк╡рк╛ркИ рк░рк╣рлЗрк▓рлБркВ ркмркЪрлНркЪрлБркВ
ЁЯРд	рккркХрлНрк╖рлАркирлБркВ ркмркЪрлНркЪрлБркВ, рккрлНрк░рк╛ркгрлА, ркмркЪрлНркЪрлБркВ, ркорк░ркШрлАркирлБркВ ркмркЪрлНркЪрлБркВ
ЁЯРе	ркЖркЧрк│ ркдрк░ркл ркЬрлЛркдрлБркВ рккркХрлНрк╖рлАркирлБркВ ркмркЪрлНркЪрлБркВ, рккркХрлНрк╖рлАркирлБркВ ркмркЪрлНркЪрлБркВ, рккрлНрк░рк╛ркгрлА, ркмркЪрлНркЪрлБркВ, ркорк░ркШрлАркирлБркВ ркмркЪрлНркЪрлБркВ, рк╕рк╛ркорлЗ ркЬрлЛркдрлБркВ рккркХрлНрк╖рлАркирлБркВ ркмркЪрлНркЪрлБркВ
ЁЯРз	рккрлЗркВркЧрлНрк╡рк┐рки, рккрлНрк░рк╛ркгрлА
ЁЯжЕ	ркЧрк░рлБркб, рккркХрлНрк╖рлА
ЁЯжЖ	рккркХрлНрк╖рлА, ркмркдркХ
ЁЯжв	ркирк╛ркирлА ркмркдркХ, рккркХрлНрк╖рлА, рк╣ркВрк╕, рк╣ркВрк╕ркирлБркВ ркмркЪрлНркЪрлБркВ
ЁЯжЙ	ркШрлБрк╡ркб, рккркХрлНрк╖рлА, ркмрлБркжрлНркзрк┐ркорк╛рки
ЁЯжЪ	ркврлЗрк▓, рккркХрлНрк╖рлА, ркнрк╡рлНркп, ркорлЛрк░, рк╢рк╛ркиркжрк╛рк░
ЁЯжЬ	ркЪрк╛ркВркЪрк┐ркпрлЛ, рккркХрлНрк╖рлА, рккрлЛрккркЯ, ркмрлЛрк▓ркдрлЛ рккрлЛрккркЯ
ЁЯР╕	ркЪрк╣рлЗрк░рлЛ, ркжрлЗркбркХрк╛ркВркирлЛ ркЪрк╣рлЗрк░рлЛ, ркжрлЗркбркХрлЛ, рккрлНрк░рк╛ркгрлА
ЁЯРК	рккрлНрк░рк╛ркгрлА, ркоркЧрк░
ЁЯРв	ркХрк╛ркЪркмрлЛ, рккрлНрк░рк╛ркгрлА
ЁЯжО	ркЧрк░рлЛрк│рлА, рк╕рк░рк┐рк╕рлГркк
ЁЯРН	рккрлНрк░рк╛ркгрлА, рк╕рк╛ркк
ЁЯР▓	ркЪрк╣рлЗрк░рлЛ, ркжрлИркдрлНркп, ркжрлИркдрлНркпркирлЛ ркЪрк╣рлЗрк░рлЛ, рккрлНрк░рк╛ркгрлА
ЁЯРЙ	ркбрлНрк░рлЗркЧрки, рккрлНрк░рк╛ркгрлА
ЁЯжХ	рк╕рлЛрк░рлЛрккрлЛркб
ЁЯжЦ	ркЯрлА-рк░рлЗркХрлНрк╕
ЁЯР│	рккрк╛ркгрлА ркЙркЫрк╛рк│ркдрлА рк╡рлНрк╣рлЗрк▓, рккрк╛ркгрлА ркЙркЫрк╛рк│рк╡рлБркВ, рккрлНрк░рк╛ркгрлА, рк╡рлНрк╣рлЗрк▓
ЁЯРЛ	рккрлНрк░рк╛ркгрлА, рк╡рлНрк╣рлЗрк▓
ЁЯРм	ркбрлЛрк▓рлНрклрк┐рки, рккрлНрк░рк╛ркгрлА
ЁЯРа	ркЙрк╖рлНркгркХркЯрк┐ркмркВркзрлАркп ркорк╛ркЫрк▓рлА, рккрлНрк░рк╛ркгрлА, ркорк╛ркЫрк▓рлА
ЁЯРб	рккрлНрк░рк╛ркгрлА, ркмрлНрк▓рлЛрклрк┐рк╢, ркмрлНрк▓рлЛрклрлАрк╢, ркорк╛ркЫрк▓рлА
ЁЯжИ	ркорк╛ркЫрк▓рлА, рк╢рк╛рк░рлНркХ
ЁЯРЩ	ркУркХрлНркЯрлЛрккрк╕, рккрлНрк░рк╛ркгрлА
ЁЯРЪ	рккрлНрк░рк╛ркгрлА, рк╢рлЗрк▓, рк╕рк░рлНрккрк╛ркХрк╛рк░ рк╢рлЗрк▓
ЁЯжА	ркХрк░ркЪрк▓рлЛ, ркХрк░рлНркХ, рк░рк╛рк╢рк┐
ЁЯжЮ	ркирк╣рлЛрк░, ркмрк┐рк╕рлНркХ, рк▓рлЙркмрлНрк╕рлНркЯрк░, рк╕рлАрклрлВркб
ЁЯжР	ркХрк░ркЪрк▓рлЛ, ркЭрлАркВркЧрлБркВ, ркирк╛ркирлБркВ, ркнрлЛркЬрки
ЁЯжС	ркнрлЛркЬрки, рк╕рлНркХрлНрк╡рк┐ркб
ЁЯРМ	ркЧрлЛркХрк│ркЧрк╛ркп, рккрлНрк░рк╛ркгрлА
ЁЯжЛ	ркЬркВркдрлБ, ркмркЯрк░рклрлНрк▓рк╛ркЗ, рк╕рлБркВркжрк░
ЁЯРЫ	ркЗркпрк│, ркХрк╛ркиркЦркЬрлВрк░рлЛ, ркЬркВркдрлБ, рккрлНрк░рк╛ркгрлА
ЁЯРЬ	ркХрлАркбрлА, рккрлНрк░рк╛ркгрлА
ЁЯРЭ	рккрлНрк░рк╛ркгрлА, ркоркзркорк╛ркЦрлА, ркоркзрлБркоркХрлНрк╖рк┐ркХрк╛
ЁЯРЮ	рккрлНрк░рк╛ркгрлА, ркнркорк░рлЛ, ркорк╛ркжрк╛, ркорк╛ркжрк╛ ркнркорк░рлА, ркорк╛ркжрк╛ ркорк╛ркВркХркб
ЁЯжЧ	ркХркВрк╕рк╛рк░рлА
ЁЯжВ	рк░рк╛рк╢рк┐, рк╡рлАркВркЫрлА, рк╕рлНркХрлЛрк░рлНрккрк┐ркпрлЛ
ЁЯжЯ	ркЬркВркдрлБ, ркдрк╛рк╡, ркоркЪрлНркЫрк░, ркорк▓рлЗрк░рк┐ркпрк╛, рк░рлЛркЧ, рк╡рк╛ркпрк░рк╕
ЁЯжа	ркЕркорлАркмрк╛, ркЬрлАрк╡рк╛ркгрлБ, ркмрлЗркХрлНркЯрлЗрк░рк┐ркпрк╛, рк╡рк╛ркпрк░рк╕
ЁЯТР	рккрлБрк╖рлНркк, ркмрлБркХрлЗ, рк░рлЛркорк╛ркВрк╕
ЁЯМ╕	ркЪрлЗрк░рлА, ркЪрлЗрк░рлА ркмрлНрк▓рлЛркЭрко, рккрлБрк╖рлНркк, рккрлБрк╖рлНркк ркЬрлЛрк╡рлБркВ
ЁЯТо	рклрлВрк▓, рклрлВрк▓ркирлЛ рк╕рк┐ркХрлНркХрлЛ, рк╢рлНрк╡рлЗркд рклрлВрк▓, рк╕рк░рк╕ ркХрк░рлНркпрлБркВркирлЛ рк╕рк┐ркХрлНркХрлЛ, рк╕рк┐ркХрлНркХрлЛ
ЁЯМ╣	ркЧрлБрк▓рк╛ркм, рклрлВрк▓
ЁЯеА	рклрлВрк▓, ркорлБрк░рлНркЬрк╛ркпрлЗрк▓рлБркВ, ркорлБрк░рлНркЬрк╛ркпрлЗрк▓рлБркВ рклрлВрк▓
ЁЯМ║	ркЬрк╛рк╕рлВркж, рклрлВрк▓
ЁЯМ╗	рклрлВрк▓, рк╕рлВрк░рлНркпркорлБркЦрлА
ЁЯМ╝	ркЪрлЗрк░рлА, рккрлБрк╖рлНркк
ЁЯМ╖	ркЯрлНркпрлВрк▓рк┐ркк, рклрлВрк▓
ЁЯМ▒	ркирк╛ркирлЛ, ркирк╛ркирлЛ ркЫрлЛркб, ркмрлАркЬ
ЁЯМ▓	рк╡рлГркХрлНрк╖, рк╕ркжрк╛ркмрк╣рк╛рк░, рк╕ркжрк╛ркмрк╣рк╛рк░ рк╡рлГркХрлНрк╖
ЁЯМ│	ркЦрк░рк╛ркЙ, ркЦрк░рк╛ркЙ рк╡рлГркХрлНрк╖, рккрк░рлНркг ркЦрк░рк╡рк╛, рк╡рлГркХрлНрк╖
ЁЯМ┤	ркдрк╛ркб, ркдрк╛ркбркирлБркВ рк╡рлГркХрлНрк╖, рк╡рлГркХрлНрк╖
ЁЯМ╡	ркХрлЗркХрлНркЯрк╕, ркЫрлЛркб
ЁЯМ╛	ркЪрлЛркЦрк╛, ркбрк╛ркВркЧрк░, ркбрлВркВркбрлБ
ЁЯМ┐	ркЬркбрлАркмрлБркЯрлНркЯрлА, рккрк░рлНркг
ЁЯНА	ркЪрк╛рк░, ркЪрк╛рк░ рккрк░рлНркг ркдрлНрк░рк┐ркжрк▓, ркдрлНрк░рк┐ркжрк▓, ркирк╕рлАркмркжрк╛рк░, рккрк░рлНркг
ЁЯНБ	ркЦрк░рлА рккркбрлЗрк▓рлБркВ рккрк░рлНркг, рккрк░рлНркг, ркорлЗрккрк▓ рккрк░рлНркг
ЁЯНВ	ркЦрк░ркдрлА, ркЦрк░ркдрлА рккрк╛ркВркжркбрлАркУ, ркЦрк░рлЗрк▓рлА, рккрк╛ркВркжркбрлА, рккрк╛ркВркжркбрлАркУ
ЁЯНГ	рккрк░рлНркг, рккрк╡рки, рккрк╡ркиркорк╛ркВ ркЙркбркдрлБркВ рккрк░рлНркг, рклрлВркВркХрк╛ркдрлЛ рккрк╡рки, рклрлВркВркХрк╛рк╡рлБркВ
ЁЯНЗ	ркжрлНрк░рк╛ркХрлНрк╖, рклрк│
ЁЯНИ	ркЯрлЗркЯрлА, ркдрк░ркмрлВркЪ, рклрк│
ЁЯНЙ	ркдрк░ркмрлВркЪ, рклрк│
ЁЯНК	ркирк╛ркирлБркВ ркЪрккркЯрлБркВ рк╕ркВркдрк░рлБркВ, ркирк╛рк░ркВркЧрлА, рклрк│
ЁЯНЛ	ркЦрк╛ркЯрлБркВ, рклрк│, рк▓рлАркВркмрлБ
ЁЯНМ	ркХрлЗрк│рлБркВ, рклрк│
ЁЯНН	ркЕркирк╛ркирк╛рк╕, рклрк│
ЁЯен	ркХрлЗрк░рлА, рклрк│
ЁЯНО	рклрк│, рк▓рк╛рк▓, рк▓рк╛рк▓ рк╕рклрк░ркЬрки, рк╕рклрк░ркЬрки
ЁЯНП	рклрк│, рк▓рлАрк▓рлБркВ, рк▓рлАрк▓рлБркВ рк╕рклрк░ркЬрки, рк╕рклрк░ркЬрки
ЁЯНР	ркирк╛рк╕рккрк╛ркдрлА, рклрк│
ЁЯНС	ркЖрк▓рлВ, рклрк│
ЁЯНТ	ркЪрлЗрк░рлА рклрк│, ркЪрлЗрк░рлАркЭ
ЁЯНУ	рклрк│, ркмрлЗрк░рлА, рк╕рлНркЯрлНрк░рлЛркмрлЗрк░рлА
ЁЯеЭ	ркХрк┐рк╡рлА, ркХрк┐рк╡рлА рклрк│, рклрк│, ркнрлЛркЬрки
ЁЯНЕ	ркЯрк╛ркорлЗркЯрлБркВ, рк╢рк╛ркХ
ЁЯее	ркирк╛рк░рк┐ркпрлЗрк│
ЁЯеС	ркНрк╡ркХрк╛ркбрлЛ, рклрк│, ркнрлЛркЬрки
ЁЯНЖ	ркмрлЗркВркЧрки, рк░рлАркВркЧркг, рк░рлАркВркЧркг, рк╢рк╛ркХ, рк╢рк╛ркХ
ЁЯеФ	ркмркЯрк╛ркХрлЛ, ркнрлЛркЬрки, рк╢рк╛ркХркнрк╛ркЬрлА
ЁЯеХ	ркЧрк╛ркЬрк░, ркнрлЛркЬрки, рк╢рк╛ркХркнрк╛ркЬрлА
ЁЯМ╜	ркбрлЛркбрлЛ, ркоркХрк╛ркИ
ЁЯеТ	ркЕркерк╛ркгрлБркВ, ркХрк╛ркХркбрлА, ркнрлЛркЬрки, рк╢рк╛ркХркнрк╛ркЬрлА
ЁЯем	ркХрлЗрк▓, ркХрлЛркмрлА, ркмрлЙркХ ркЪрлЛркп, рк▓рлАрк▓рк╛ рккрк╛ркВркжрк│рк╛рк╡рк╛рк│рк╛, рк▓рлЗркЯрк┐рк╕
ЁЯеж	ркмрлНрк░рлЛркХрлЛрк▓рлА
ЁЯНД	ркЭрк╛ркб, ркорк╢рк░рлБрко
ЁЯеЬ	ркЕркЦрк░рлЛркЯ, ркнрлЛркЬрки, ркоркЧрклрк│рлА, рк╢рк╛ркХркнрк╛ркЬрлА
ЁЯМ░	ркЭрк╛ркб, ркмркжрк╛рко, ркмркжрк╛рко ркЬрлЗрк╡рлБркВ ркПркХ рклрк│
ЁЯНЮ	ркмрлНрк░рлЗркб, ркмрлНрк░рлЗркбркирлЛ рк░рлЛркЯрк▓рлЛ, рк░рлЗрк╕рлНркЯрлЛрк░ркирлНркЯ
ЁЯеР	ркХрлНрк░рлЛркЗрк╕рлИрки, рклрлНрк░рлЗркирлНркЪ, ркнрлЛркЬрки, рк░рлЛркЯрк▓рлА
ЁЯеЦ	рклрлНрк░рлЗркирлНркЪ, ркмрлЗркЧрлЗркЯ, ркмрлЗркЧрлЗркЯ рк░рлЛркЯрк▓рлА, ркнрлЛркЬрки, рк░рлЛркЯрк▓рлА
ЁЯеи	ркЯрлНрк╡рк┐рк╕рлНркЯрлЗркб, рккрлНрк░рлЗркЯрлНркЭрк▓
ЁЯеп	ркмрлЗркХрк░рлА, ркмрлЗркЧрк▓, рк╕рлНркХркорк┐ркпрк░
ЁЯеЮ	рккрлЕркирлНркХрлЗркХ, ркнрлЛркЬрки, рк╣рлЙркЯркХрлЗркХ
ЁЯзА	ркЪрлАркЭ, ркЪрлАркЭркирлЛ ркдрлНрк░рк┐ркХрлЛркгрк╛ркХрк╛рк░ ркЯрлБркХркбрлЛ, ркЯрлБркХркбрлЛ
ЁЯНЦ	ркорк╛ркВрк╕, рк░рлЗрк╕рлНркЯрлЛрк░ркирлНркЯ, рк╣рк╛ркбркХрк╛ркВ рккрк░ркирлБркВ ркорк╛ркВрк╕
ЁЯНЧ	ркЪрк┐ркХрки ркЯркВркЧркбрлА, ркЯркВркЧркбрлА, рккрлЛрк▓рлНркЯрлНрк░рлА, рк░рлЗрк╕рлНркЯрлЛрк░ркирлНркЯ
ЁЯей	ркЪрлЛркк, рккрлЛрк░рлНркХркЪрлЛркк, ркорк╛ркВрк╕ркирлЛ ркЯрлБркХркбрлЛ, рк▓рлЗркорлНркмркЪрлЛркк, рк╕рлНркЯрлЗркХ
ЁЯеУ	ркмрлЗркХрки, ркнрлЛркЬрки, ркорк╛ркВрк╕
ЁЯНФ	ркмрк░рлНркЧрк░, рк░рлЗрк╕рлНркЯрлЛрк░ркирлНркЯ, рк╣рлЗркоркмрк░рлНркЧрк░
ЁЯНЯ	рклрлНрк░рк╛ркЗрк╕, рклрлНрк░рлЗркирлНркЪ рклрлНрк░рк╛ркЗрк╕, рк░рлЗрк╕рлНркЯрлЛрк░ркирлНркЯ
ЁЯНХ	рккрк┐ркЭрк╛, рк░рлЗрк╕рлНркЯрлЛрк░ркирлНркЯ, рк╕рлНрк▓рк╛ркЗрк╕
ЁЯМн	рклрлНрк░рлЗркВркХрклрк░рлНркЯрк░, рк╕рлЛрк╕рлЗркЬ, рк╣рлЛркЯ ркбрлЛркЧ
ЁЯек	ркмрлНрк░рлЗркб, рк╕рлЕркирлНркбрк╡рк┐ркЪ
ЁЯМо	ркЯрк╛ркХрлЛ, ркорлЗркХрлНрк╕рк┐ркХрки, ркорлЗркХрлНрк╕рк┐ркХрки рк╡рк╛ркиркЧрлА
ЁЯМп	ркмрк░рк┐ркЯрлЛ, ркорлЗркХрлНрк╕рк┐ркХрки, ркорлЗркХрлНрк╕рк┐ркХрки рк╡рк╛ркиркЧрлА
ЁЯеЩ	ркХркмрк╛ркм, рклрк▓рк╛рклрк▓, рклрк▓рлЗркЯркмрлНрк░рлЗркб, ркнрк░рлЗрк▓рлА рклрк▓рлЗркЯркмрлНрк░рлЗркб, ркнрк░рлЗрк▓рлБркВ, ркнрлЛркЬрки
ЁЯеЪ	ркИркВркбрлБ, ркнрлЛркЬрки
ЁЯН│	ркХркбрк╛ркИ, рк░рк╛ркВркзрк╡рлБркВ, рк░рлЗрк╕рлНркЯрлЛрк░ркирлНркЯ
ЁЯеШ	ркХрлЕрк╕рк░рлЛрк▓, ркЫрлАркЫрк░рлЛ, ркЫрлАркЫрк░рлЛ ркдрк╡рлЛ, ркдрк╡рлЛ, ркнрлЛркЬрки
ЁЯН▓	ркнрлЛркЬркиркирлБркВ рк╡рк╛рк╕ркг, рк░рлЗрк╕рлНркЯрлЛрк░ркирлНркЯ, рк╡рк╛рк╕ркгркорк╛ркВркирлЛ ркЦрлЛрк░рк╛ркХ, рк╕рлНркЯрлНркпрлВ
ЁЯег	ркХрлЛркирлНркЬрлА, ркмрлНрк░рлЗркХрклрк╛рк╕рлНркЯ, рк╕рк┐рк░рлАркЕрк▓, рк╕рлНрккрлВрки рк╕рк╛ркерлЗ ркмрлЛрк▓
ЁЯеЧ	ркнрлЛркЬрки, рк▓рлАрк▓рлБркВ, рк▓рлАрк▓рлБркВ рк╕рлЕрк▓ркб, рк╕рлЕрк▓ркб
ЁЯН┐	рккрлЙрккркХрлЛрк░рлНрки, ркоркХрк╛ркИркирк╛ рк╢рлЗркХрлЗрк▓рк╛ ркжрк╛ркгрк╛
ЁЯзВ	ркорк╕рк╛рк▓рк╛ркирлА ркбркмрлА, ркорк╕рк╛рк▓рлЛ, ркорлАркарлБркВ
ЁЯел	ркХрлЕрки, ркХрлЗркирлНркб рклрлВркб
ЁЯН▒	ркмрлЗркирлНркЯрлЛ, ркмрлЗркирлНркЯрлЛ ркмрлЛркХрлНрк╕, ркмрлЛркХрлНрк╕, рк░рлЗрк╕рлНркЯрлЛрк░ркирлНркЯ
ЁЯНШ	ркЪрлЛркЦрк╛, ркЪрлЛркЦрк╛ркирлА ркХркХрк░рлА ркмрк┐рк╕рлНркХрлАркЯ, ркЪрлЛркЦрк╛ркирлА┬аркХркХрк░рлА ркмрк┐рк╕рлНркХрлАркЯ
ЁЯНЩ	ркУркирк┐ркЧрк┐рк░рлА, ркнрк╛ркдркирк╛ркВ рк╡ркбрк╛, рк░рлЗрк╕рлНркЯрлЛрк░ркирлНркЯ
ЁЯНЪ	ркЪрлЛркЦрк╛, ркнрк╛ркд, рк░рлЗрк╕рлНркЯрлЛрк░рлЗркирлНркЯ
ЁЯНЫ	ркХркврлА, ркХркврлА ркЕркирлЗ ркнрк╛ркд, ркнрк╛ркд, рк░рлЗрк╕рлНркЯрлЛрк░рлЗркирлНркЯ
ЁЯНЬ	ркирлБркбрк▓, ркирлБркбрк▓рлНрк╕, ркирлБркбрк▓рлНрк╕ркирлЛ рк╡рк╛ркЯркХрлЛ, рк░ркорлЗрки, рк░рлЗрк╕рлНркЯрлЛрк░ркирлНркЯ, рк╡рк░рк╛рк│ ркирлАркХрк│ркдрк╛ркВ, рк╡рк░рк╛рк│ ркирлАркХрк│ркдрлЛ рккрлНркпрк╛рк▓рлЛ, рк╡рк╛ркЯркХрлЛ
ЁЯНЭ	рккрк╛рк╕рлНркдрк╛, рк░рлЗрк╕рлНркЯрлЛрк░ркирлНркЯ, рк╕рлНрккркЧрлЗркЯрлА
ЁЯНа	ркЧрк│рлНркпрлБркВ, рк░рлЗрк╕рлНркЯрлЛрк░ркирлНркЯ, рк╢ркХрлНркХрк░рк┐ркпрлБркВ, рк╢рлЗркХрлЗрк▓рк╛ркВ ркмркЯрк╛ркХрк╛, рк╢рлЗркХрлЗрк▓рлБркВ, рк╢рлЗркХрлЗрк▓рлБркВ рк╢ркХрлНркХрк░рк┐ркпрлБркВ
ЁЯНв	ркУркбрлЗрки, рк░рлЗрк╕рлНркЯрлЛрк░ркирлНркЯ, рк╕рлА рклрлВркб, рк╕рлНркЯрлАркХ, рк╕рлНркЯрлАркХ рккрк░ рк╕рлА рклрлВркб
ЁЯНг	рк░рлЗрк╕рлНркЯрлЛрк░ркирлНркЯ, рк╕рлБрк╢рлА
ЁЯНд	ркЭрлАркВркЧрк╛, ркдрк│рлЗрк▓рлА ркЭрлАркВркЧрк╛ ркорк╛ркЫрк▓рлА, рк░рлЗрк╕рлНркЯрлЛрк░ркирлНркЯ
ЁЯНе	рклрк┐рк╢ ркХрлЗркХ, рклрлАрк╢ ркХрлЗркХ, ркорк╛ркЫрк▓рлА, рк░рлЗрк╕рлНркЯрлЛрк░ркирлНркЯ, рк╡ркорк│рк╡рк╛рк│рлА рклрлАрк╢ ркХрлЗркХ
ЁЯео	ркдрк╣рлЗрк╡рк╛рк░, ркорлВрки ркХрлЗркХ, ркпрлБркПркмрк┐ркВркЧ, рк╢рк░ркжркЛркдрлБ
ЁЯНб	ркбрлЗркирлНркЧрлЛ, ркорлЛркЪрлА, ркорлЛркЪрлА ркмрлЛрк▓рлНрк╕, рк░рлЗрк╕рлНркЯрлЛрк░ркирлНркЯ, рк▓рк╛ркХркбрлА рккрк░ ркорлЛркЪрлА ркмрлЛрк▓рлНрк╕
ЁЯеЯ	ркПркорлНрккрк╛ркирк╛ркбрк╛, ркЧрлАркпрлЛркЭрк╛, ркЬрк┐ркпрк╛ркУркЭрлА, ркбркорлНрккрк▓рк┐ркВркЧ, ркбркорлНрккрк┐ркВркЧ, рккрк┐рк░рлЛркЧрлА, рккрлЛркЯрк╕рлНркЯрк┐ркХрк░
ЁЯеа	рккрлНрк░рлЙрклрк┐рк╕рлА, рклрлЙрк░рлНркЪрлБрки ркХрлБркХрлА
ЁЯеб	ркСркЗрк╕рлНркЯрк░ рккрлИрк▓, ркЯрлЗркХркЖркЙркЯ ркмрлЙркХрлНрк╕
ЁЯНж	ркЖркЗрк╕ ркХрлНрк░рлАрко, ркХрлНрк░рлАрко, рк░рлЗрк╕рлНркЯрлЛрк░ркирлНркЯ, рк╕рлЛрклрлНркЯ ркЖркЗрк╕ ркХрлНрк░рлАрко, рк╕рлЛрклрлНркЯ рк╕рк░рлНрк╡
ЁЯНз	ркЖркЗрк╕, рк░рлЗрк╕рлНркЯрлЛрк░ркирлНркЯ, рк╢рлЗрк╡рлНркб, рк╢рлЗрк╡рлНркб ркЖркЗрк╕ ркХрлНрк░рлАрко
ЁЯНи	ркЖркЗрк╕, ркЖркЗрк╕ ркХрлНрк░рлАрко, ркХрлНрк░рлАрко, рк░рлЗрк╕рлНркЯрлЛрк░ркирлНркЯ
ЁЯНй	ркбрлЛркиркЯ, ркорлАркарк╛ркИ, рк░рлЗрк╕рлНркЯрлЛрк░ркирлНркЯ
ЁЯНк	ркХрлБркХрлА, рк░рлЗрк╕рлНркЯрлЛрк░ркирлНркЯ
ЁЯОВ	ркЙркЬрк╡ркгрлА, ркХрлЗркХ, ркЬркирлНркоркжрк┐рк╡рк╕, ркЬркирлНркоркжрк┐рк╡рк╕ркирлА ркХрлЗркХ
ЁЯН░	ркХрк╛рккрлЗрк▓рлА ркХрлЗркХ, ркХрлЗркХ, ркирк╛ркирлА ркХрлЗркХ, рк░рлЗрк╕рлНркЯрлЛрк░ркирлНркЯ
ЁЯзБ	ркХрккркХрлЗркХ, ркмрлЗркХрк░рлА, ркорлАркарк╛ркИ
ЁЯез	рккрк╛ркЗ, рккрлЗрк╕рлНркЯрлНрк░рлА, рклрк┐рк▓рк┐ркВркЧ
ЁЯНл	ркЪрлЛркХрк▓рлЗркЯ, ркЪрлЛркХрк▓рлЗркЯ ркмрк╛рк░, ркмрк╛рк░, рк░рлЗрк╕рлНркЯрлЛрк░ркирлНркЯ
ЁЯНм	ркХрлЗркирлНркбрлА, рк░рлЗрк╕рлНркЯрлЛрк░ркирлНркЯ
ЁЯНн	ркХрлЗркирлНркбрлА, рк░рлЗрк╕рлНркЯрлЛрк░ркирлНркЯ, рк▓рлЛрк▓рк┐рккрлЛркк
ЁЯНо	ркХрк╕рлНркЯрк░рлНркб, рккрлБркбрк┐ркВркЧ, рк░рлЗрк╕рлНркЯрлЛрк░ркирлНркЯ
ЁЯНп	ркоркз, ркоркзркирлБркВ рк╡рк╛рк╕ркг, рк░рлЗрк╕рлНркЯрлЛрк░ркирлНркЯ, рк╡рк╛рк╕ркг
ЁЯН╝	ркжрлВркз, рккрлАркгрлБркВ, ркмрлЛркЯрк▓, рк╢рк┐рк╢рлБ ркмрлЛркЯрк▓, рк╢рк┐рк╢рлБркирлА ркмрлЛркЯрк▓
ЁЯеЫ	ркЧрлНрк▓рк╛рк╕, ркжрлВркз, ркжрлВркзркирлЛ ркЧрлНрк▓рк╛рк╕, рккрлАркгрлБркВ
ЁЯН╡	ркЪрк╛, ркЪрк╛ ркорк╛ркЯрлЗркирлЛ ркХркк, ркЪрк╛ркирлЛ ркХркк, ркжрк╛ркВркбрлА рк╡ркЧрк░ркирлЛ ркЪрк╛ркирлЛ ркХркк, рккрлАркгрлБркВ
ЁЯН╢	ркХркк, ркЪрлЛркЦрк╛ркирк╛ркВ ркжрк╛рк░рлБркирлА ркмрлЛркЯрк▓ ркЕркирлЗ ркХркк, ркЪрлЛркЦрк╛ркирлЛ ркжрк╛рк░рлВ, рккрлАркгрлБркВ, ркмрк╛рк░, ркмрлЛркЯрк▓, рк░рлЗрк╕рлНркЯрлЛрк░ркирлНркЯ, рк╕рлЗркХ
ЁЯН╛	ркХрлЙрк░рлНркХ, ркХрлЙрк░рлНркХ ркЦрлБрк▓ркдрлА ркмрк╛ркЯрк▓рлА, ркЦрлБрк▓ркдрлА, ркбрлНрк░рк┐ркВркХ, ркмрк╛ркЯрк▓рлА, ркмрк╛рк░
ЁЯН╖	ркЧрлНрк▓рк╛рк╕, рккрлАркгрлБркВ, ркмрк╛рк░, рк░рлЗрк╕рлНркЯрлЛрк░ркирлНркЯ, рк╡рк╛ркЗрки, рк╡рк╛ркЗрки ркорк╛ркЯрлЗркирлЛ ркЧрлНрк▓рк╛рк╕, рк╡рк╛ркЗркиркирлЛ ркЧрлНрк▓рк╛рк╕
ЁЯН╣	ркЙрк╖рлНркгркХркЯрк┐ркмркВркзрлАркп, ркЙрк╖рлНркгркХркЯрк┐ркмркВркзрлАркп рккрлАркгрлБркВ, рккрлАркгрлБркВ, ркмрк╛рк░, рк░рлЗрк╕рлНркЯрлЛрк░ркирлНркЯ
ЁЯН║	ркмрк╛рк░, ркмрлАркЕрк░, ркмрлАркЕрк░ ркоркЧ, ркоркЧ, рк░рлЗрк╕рлНркЯрлЛрк░ркирлНркЯ
ЁЯН╗	ркЕркбркХрк╛ркдрк╛ркВ ркмрлАркЕрк░ ркоркЧрлНрк╕, ркмрк╛рк░, ркмрлАркЕрк░, ркоркЧ, ркоркЧрлНрк╕, рк░рлЗрк╕рлНркЯрлЛрк░ркирлНркЯ
ЁЯеВ	ркЙркЬрк╡ркгрлА, ркХрлНрк▓рк┐ркВркХ, ркХрлНрк▓рк┐ркирлНркХрлАркВркЧ ркЧрлНрк▓рк╛рк╕, ркЧрлНрк▓рк╛рк╕, рккрлАркгрлБркВ
ЁЯеГ	ркЧрлНрк▓рк╛рк╕, ркЯркорлНркмрлНрк▓рк░, ркЯркорлНркмрлНрк▓рк░ ркЧрлНрк▓рк╛рк╕, ркжрк╛рк░рлВ, рк╡рк┐рк╕рлНркХрлА, рк╢рлЙркЯ
ЁЯед	ркЬрлВрк╕, рк╕рлЛркбрк╛, рк╕рлНркЯрлНрк░рлЙ рк╕рк╛ркерлЗ ркХркк
ЁЯев	ркЪрлЙрккрлНрк╕рлНркЯрк┐ркХрлНрк╕, рк╣рк╛рк╢рлА
ЁЯН┤	ркХрк╛ркВркЯрлЛ, ркЫрк░рлА, ркЫрк░рлА ркЕркирлЗ ркХрк╛ркВркЯрлЛ, рк░рлЗрк╕рлНркЯрлЛрк░ркирлНркЯ
ЁЯеД	ркЪркоркЪрлА, ркЫрк░рлАркХрк╛ркВркЯрк╛
ЁЯФк	ркЪрк╛ркХрлБ, рк░рк╕рлЛркбрк╛ркирлЛ ркЪрк╛ркХрлБ
ЁЯП║	ркХрлБркВркн, ркЬркЧ, ркбрлНрк░рк┐ркВркХ, рккрлАркгрлБркВ, ркмрк░ркгрлА, рк░рк╕рлЛркИ, рк░рк╛рк╢рк┐, рк╣ркерк┐ркпрк╛рк░
ЁЯМН	ркЖрклрлНрк░рк┐ркХрк╛, ркЧрлНрк▓рлЛркм, рккрлГркерлНрк╡рлА, ркпрлБрк░рлЛркк, ркпрлБрк░рлЛркк-ркЖрклрлНрк░рк┐ркХрк╛ ркмркдрк╛рк╡ркдрлА ркЧрлНрк▓рлЛркм, ркпрлБрк░рлЛркк-ркЖрклрлНрк░рк┐ркХрк╛ ркмркдрк╛рк╡ркдрлБркВ ркЧрлНрк▓рлЛркм, ркпрлБрк░рлЛркк-ркЖрклрлНрк░рк┐ркХрк╛ ркмркдрк╛рк╡ркдрлЛ рккрлГркерлНрк╡рлАркирлЛ ркЧрлЛрк│рлЛ
ЁЯМП	ркПрк╢рк┐ркпрк╛, ркПрк╢рк┐ркпрк╛-ркУрк╕рлНркЯрлНрк░рлЗрк▓рк┐ркпрк╛ ркмркдрк╛рк╡ркдрлА ркЧрлНрк▓рлЛркм, ркПрк╢рк┐ркпрк╛-ркУрк╕рлНркЯрлНрк░рлЗрк▓рк┐ркпрк╛ ркмркдрк╛рк╡ркдрлБркВ ркЧрлНрк▓рлЛркм, ркПрк╢рк┐ркпрк╛-ркУрк╕рлНркЯрлНрк░рлЗрк▓рк┐ркпрк╛ ркмркдрк╛рк╡ркдрлЛ рккрлГркерлНрк╡рлАркирлЛ ркЧрлЛрк│рлЛ, ркУрк╕рлНркЯрлНрк░рлЗрк▓рк┐ркпрк╛, ркЧрлНрк▓рлЛркм, рккрлГркерлНрк╡рлА
ЁЯМР	ркЧрлНрк▓рлЛркм, ркпрк╛ркорлНркпрлЛркдрлНркдрк░ рк╡рлГркдрлНркд, ркпрк╛ркорлНркпрлЛркдрлНркдрк░ рк╡рлГркдрлНркд ркмркдрк╛рк╡ркдрлА ркЧрлНрк▓рлЛркм, ркпрк╛ркорлНркпрлЛркдрлНркдрк░ рк╡рлГркдрлНркд ркмркдрк╛рк╡ркдрлБркВ ркЧрлНрк▓рлЛркм, ркпрк╛ркорлНркпрлЛркдрлНркдрк░ рк╡рлГркдрлНркд ркмркдрк╛рк╡ркдрлЛ рккрлГркерлНрк╡рлАркирлЛ ркЧрлЛрк│рлЛ
ЁЯЧ╛	ркЬрк╛рккрк╛рки, ркЬрк╛рккрк╛ркиркирлЛ ркиркХрк╢рлЛ, ркиркХрк╢рлЛ
ЁЯзн	ркУрк░рк┐ркПркирлНркЯрк░рлАркВркЧ, ркХркВрккрк╛рк╕, ркЪрлБркВркмркХрлАркп, ркирлЗрк╡рк┐ркЧрлЗрк╢рки
ЁЯМЛ	ркЬрлНрк╡рк╛рк│рк╛ркорлБркЦрлА, ркЬрлНрк╡рк╛рк│рк╛ркорлБркЦрлА рк╡рк┐рк╕рлНрклрлЛркЯ
ЁЯЧ╗	рккрк░рлНрк╡ркд, ркорк╛. рклрлБркЬрлА, ркорк╛ркЙркирлНркЯ рклрлБркЬрлА
ЁЯз▒	ркИркВркЯ, ркИркВркЯрлЛ, ркЪрлАркХркгрлА ркорк╛ркЯрлА, ркЪрлВркирк╛ркирлЛ ркХрлЛрк▓, ркжрк┐рк╡рк╛рк▓
ЁЯПб	ркИркорк╛рк░ркд, ркЧрлГрк╣, ркШрк░, ркмркЧрлАркЪрк╛рк╡рк╛рк│рлБркВ ркШрк░, ркмрк╛ркЧ
ЁЯПв	ркИркорк╛рк░ркд, ркХрк╛рк░рлНркпрк╛рк▓ркп, ркХрк╛рк░рлНркпрк╛рк▓ркпркирлА ркИркорк╛рк░ркд
ЁЯПг	ркИркорк╛рк░ркд, ркЬрк╛рккрк╛ркирлА, ркЬрк╛рккрк╛ркирлА рккрлЛрк╕рлНркЯ ркСрклрк┐рк╕, рккрлЛрк╕рлНркЯ, рккрлЛрк╕рлНркЯ ркСрклрк┐рк╕
ЁЯПд	ркИркорк╛рк░ркд, ркЬрк╛рккрк╛ркирлА, рккрлЛрк╕рлНркЯ, рккрлЛрк╕рлНркЯ ркСрклрк┐рк╕, ркпрлБрк░рлЛрккрк┐ркпрки рккрлЛрк╕рлНркЯ ркСрклрк┐рк╕
ЁЯПе	ркИркорк╛рк░ркд, рк╣рлЛрк╕рлНрккрк┐ркЯрк▓
ЁЯПж	ркИркорк╛рк░ркд, ркмрлЗркВркХ
ЁЯПи	ркИркорк╛рк░ркд, рк╣рлЛркЯрк▓
ЁЯПй	ркИркорк╛рк░ркд, рккрлНрк░рлЗрко, рккрлНрк░рлЗрко рк╣рлЛркЯрк▓, рк╣рлЛркЯрк▓
ЁЯПк	ркИркорк╛рк░ркд, рк╕рлБрк╡рк┐ркзрк╛, рк╕рлБрк╡рк┐ркзрк╛ рк╕рлНркЯрлЛрк░, рк╕рлНркЯрлЛрк░
ЁЯПл	ркИркорк╛рк░ркд, рк╢рк╛рк│рк╛, рк╢рк╛рк│рк╛ркирлА ркИркорк╛рк░ркд
ЁЯПм	ркбрк┐рккрк╛рк░рлНркЯркорлЗркирлНркЯ, ркбрк┐рккрк╛рк░рлНркЯркорлЗркирлНркЯ рк╕рлНркЯрлЛрк░, рк╕рлНркЯрлЛрк░
ЁЯПп	ркИркорк╛рк░ркд, ркХрк┐рк▓рлНрк▓рлЛ, ркЬрк╛рккрк╛ркирлА ркХрк┐рк▓рлНрк▓рлЛ
ЁЯП░	ркИркорк╛рк░ркд, ркХрк┐рк▓рлНрк▓рлЛ, ркЬрк╛рккрк╛ркирлА ркХрк┐рк▓рлНрк▓рлЛ
ЁЯТТ	ркжрлЗрк╡ркХрлБрк▓рк┐ркХрк╛, рк░рлЛркорк╛ркВрк╕, рк▓ркЧрлНрки, рк▓ркЧрлНрки ркорк╛ркЯрлЗркирлА ркжрлЗрк╡ркХрлБрк▓рк┐ркХрк╛
ЁЯЧ╝	ркЯрк╛рк╡рк░, ркЯрлЛркХрлНркпрлЛ, ркЯрлЛркХрлНркпрлЛ ркЯрк╛рк╡рк░
ЁЯЧ╜	рккрлНрк░ркдрк┐ркорк╛, рк╕рлНркЯрлЗркЪрлНркпрлБ ркСркл рк▓рк┐ркмрк░рлНркЯрлА, рк╕рлНрк╡ркдркВркдрлНрк░ркдрк╛
ЁЯХМ	ркЗрк╕рлНрк▓рк╛рко, ркзрк░рлНрко, ркорк╕рлНркЬрк┐ркж, ркорлБрк╕рлНрк▓рк┐рко
ЁЯХН	ркзрк░рлНрко, ркоркВркжрк┐рк░, ркпрк╣рлВркжрлА рккрлНрк░рк╛рк░рлНркеркирк╛ркЧрлГрк╣
ЁЯХЛ	ркЗрк╕рлНрк▓рк╛рко, ркХрк╛ркмрк╛, ркзрк░рлНрко, ркорлБрк╕рлНрк▓рк┐рко
ЁЯМБ	ркзрлБркорлНркорк╕, ркзрлБркорлНркорк╕рк┐ркпрлБркВ
ЁЯМГ	ркдрк╛рк░рк╛, ркдрк╛рк░рк╛ рк╕рк╛ркерлЗркирлБркВ ркЖркХрк╛рк╢, рк░рк╛ркд, рк░рк╛ркдркирк╛ ркдрк╛рк░рк╛
ЁЯМД	рккрк░рлНрк╡ркд, рккрк░рлНрк╡ркдрлЛ рккрк░ рк╕рлВрк░рлНркпрлЛркжркп, рк╕рк╡рк╛рк░ркирлЛ рк╕рлВрк░рлНркп, рк╕рлВрк░рлНркпрлЛркжркп
ЁЯМЕ	рк╕рк╡рк╛рк░ркирлЛ рк╕рлВрк░рлНркп, рк╕рлВрк░рлНркпрлЛркжркп
ЁЯМЖ	рк▓рлЗркирлНркбрк╕рлНркХрлЗркк, рк╢рк╣рлЗрк░, рк╕ркорлАрк╕рк╛ркВркЬ, рк╕рк╛ркВркЬ, рк╕рк╛ркВркЬркирк╛ рк╕ркоркпрлЗ рк╢рк╣рлЗрк░, рк╕рлВрк░рлНркпрк╛рк╕рлНркд
ЁЯМЗ	ркИркорк╛рк░ркд, ркИркорк╛рк░ркдрлЛ рккрк░ рк╕рлВрк░рлНркпрк╛рк╕рлНркд, рк╕ркорлАрк╕рк╛ркВркЬ, рк╕рлВрк░рлНркпрк╛рк╕рлНркд
ЁЯМЙ	ркирк╛ркЗркЯ ркмрлНрк░рк┐ркЬ, рк░рк╛ркд, рк░рк╛ркдркирк╛ рк╕ркоркпрлЗ ркмрлНрк░рк┐ркЬ, рк░рк╛ркдрлНрк░рлЗ рккрлБрк▓
ЁЯММ	ркЖркХрк╛рк╢ркЧркВркЧрк╛, ркжрлВркзрк┐ркпрлБркВ
ЁЯОа	ркШрлЛркбрк╛ркирлА ркмрлЗркаркХрк╡рк╛рк│рлЛ ркЪркХркбрлЛрк│, ркШрлЛркбрлЛ, ркЪркХркбрлЛрк│, ркоркирлЛрк░ркВркЬрки
ЁЯОб	ркПркорлНркпрлБркЭркорлЗркирлНркЯ рккрк╛рк░рлНркХ, ркЪркЧркбрлЛрк│, рккрлИркбрлБркВ, рклрлЗрк░рлАрк╕, рклрлЗрк░рлАрк╕ рк╡рлНрк╣рлАрк▓
ЁЯОв	ркПркорлНркпрлБркЭркорлЗркирлНркЯ рккрк╛рк░рлНркХ, ркХрлЛрк╕рлНркЯрк░, ркоркирлЛрк░ркВркЬрки, рк░рлЛрк▓рк░, рк░рлЛрк▓рк░ ркХрлЛрк╕рлНркЯрк░
ЁЯТИ	ркерк╛ркВркнрк▓рлЛ, рк╡рк╛рк│ркВркж, рк╡рк╛рк│ркВркжркирлА ркжрлБркХрк╛рки, рк╡рк╛рк│ркВркжркирлЛ ркерк╛ркВркнрк▓рлЛ
ЁЯОк	ркдркВркмрлБ, ркоркирлЛрк░ркВркЬрки, рк╕рк░рлНркХрк╕, рк╕рк░рлНркХрк╕ркирлБркВ ркдркВркмрлБ
ЁЯЪВ	ркПркирлНркЬрк┐рки, ркЯрлНрк░рлЗрки, рк╡рк░рк╛рк│ ркПркирлНркЬрк┐рки, рк╡рк╛рк╣рки
ЁЯЪГ	ркЗрк▓рлЗркХрлНркЯрлНрк░рк┐ркХ, ркЯрлНрк░рк╛рко, ркЯрлНрк░рлЗрки, рк░рлЗрк▓рлНрк╡рлЗ, рк░рлЗрк▓рлНрк╡рлЗ ркХрк╛рк░, рк╡рк╛рк╣рки
ЁЯЪД	ркЯрлНрк░рлЗрки, рк╡рк╛рк╣рки, рк╢рк┐ркВркХркирк╕рлЗрки, рк╣рк╛ркЗ-рк╕рлНрккрлАркб ркЯрлНрк░рлЗрки, рк╣рк╛ркЗ-рк╕рлНрккрлАркб ркЯрлНрк░рлЗрки, рк╢рк┐ркВркХркирк╕рлЗрки, ркЯрлНрк░рлЗрки, рк╡рк╛рк╣рки
ЁЯЪЕ	ркЖркЧрк│ркерлА ркмрлБрк▓рлЗркЯркирк╛ ркЖркХрк╛рк░ркирлА ркЙркЪрлНркЪ-ркЧркдрк┐ркирлА ркЯрлНрк░рлЗрки, ркЯрлНрк░рлЗрки, ркмрлБрк▓рлЗркЯ ркирлЛркЭ, ркмрлБрк▓рлЗркЯ ркирлЛркЭ рк╕рк╛ркерлЗркирлБркВ рк╢рк┐ркВркХркирк╕рлЗрки, рк╡рк╛рк╣рки, рк╢рк┐ркВркХркирк╕рлЗрки, рк╣рк╛ркЗ-рк╕рлНрккрлАркб ркЯрлНрк░рлЗрки
ЁЯЪЖ	ркЯрлНрк░рлЗрки, рк░рлЗрк▓рлНрк╡рлЗ, рк╡рк╛рк╣рки
ЁЯЪИ	рк░рлЗрк▓, рк▓рк╛ркЗркЯ, рк▓рк╛ркЗркЯ рк░рлЗрк▓, рк╡рк╛рк╣рки
ЁЯЪЙ	ркЯрлНрк░рлЗрки, ркЯрлНрк░рлЗрки рк╕рлНркЯрлЗрк╢рки, рк╕рлНркЯрлЗрк╢рки
ЁЯЪК	ркЯрлНрк░рк╛рко, рк╡рк╛рк╣рки
ЁЯЪЭ	ркорлЛркирлЛрк░рлЗрк▓, рк╡рк╛рк╣рки
ЁЯЪЮ	ркХрк╛рк░, рккрк░рлНрк╡ркд, рккрк░рлНрк╡ркдрлЛркирлА ркХрлЕркмрк▓ ркХрк╛рк░, рккрк░рлНрк╡ркдрлЛркирлА рк░рлЗрк▓рлНрк╡рлЗ, рк░рлЗрк▓рлНрк╡рлЗ
ЁЯЪЛ	ркХрк╛рк░, ркЯрлНрк░рк╛рко, ркЯрлНрк░рк╛рко ркХрк╛рк░, рк╡рк╛рк╣рки
ЁЯЪМ	ркмрк╕, рк╡рк╛рк╣рки
ЁЯЪО	ркЯрлНрк░рлЛрк▓рлА, ркЯрлНрк░рлЛрк▓рлАркмрк╕, ркмрк╕, рк╡рк╛рк╣рки
ЁЯЪР	ркмрк╕, ркорк┐ркирк┐ркмрк╕, рк╡рк╛рк╣рки
ЁЯЪТ	ркПркирлНркЬрк┐рки, рклрк╛ркпрк░, рклрк╛ркпрк░ ркПркирлНркЬрк┐рки, рклрк╛ркпрк░ ркЯрлНрк░ркХ, рк╡рк╛рк╣рки
ЁЯЪУ	рккрлЗркЯрлНрк░рлЛрк▓ ркХрк╛рк░, рккрлЛрк▓рлАрк╕, рккрлЛрк▓рлАрк╕ ркХрк╛рк░, рккрлЛрк▓рлАрк╕ркирлА ркХрк╛рк░, рк╡рк╛рк╣рки
ЁЯЪХ	ркЯрлЕркХрлНрк╕рлА, рк╡рк╛рк╣рки
ЁЯЪЦ	ркЖрк╡ркирк╛рк░рлА ркЯрлЕркХрлНрк╕рлА, ркЖрк╡рлА рк░рк╣рлЗрк▓ ркЯрлЕркХрлНрк╕рлА, ркЯрлЕркХрлНрк╕рлА, рк╡рк╛рк╣рки
ЁЯЪЧ	ркСркЯрлЛркорлЛркмрк╛ркЗрк▓, ркХрк╛рк░, рк╡рк╛рк╣рки
ЁЯЪЩ	RV, ркХрк╛рк░, ркоркирлЛрк░ркВркЬрки рк╡рк╛рк╣рки, рк╡рк╛рк╣рки
ЁЯЪЪ	ркЯрлНрк░ркХ, рк╡рк╛рк╣рки, рк╡рк┐ркдрк░ркг ркЯрлНрк░ркХ
ЁЯЪЫ	ркХрк▓рк╛ркдрлНркоркХ ркЦркЯрк╛рк░рлЛ, ркЦркЯрк╛рк░рлЛ, ркЯрлНрк░ркХ, ркЯрлНрк░рлЗрк▓рк░, рк╡рк╛рк╣рки
ЁЯЪЬ	ркЯрлНрк░рлЗркХрлНркЯрк░, рк╡рк╛рк╣рки
ЁЯЫ┤	ркХрк┐ркХ, ркХрк┐ркХ рк╕рлНркХрлВркЯрк░, рк╕рлНркХрлВркЯрк░
ЁЯЫ╣	ркмрлЙрк░рлНркб, рк╕рлНркХрлЕркЯркмрлЛрк░рлНркб
ЁЯЫ╡	ркорлЛркЯрк░, ркорлЛркЯрк░ рк╕рлНркХрлВркЯрк░, рк╕рлНркХрлВркЯрк░
ЁЯЪП	ркмрк╕, ркмрк╕ рк╕рлНркЯрлЛркк, рк╕рлНркЯрлЛркк
ЁЯЪи	рккрлЛрк▓рк┐рк╕ркирлА ркХрк╛рк░ркирлА рк▓рк╛ркЗркЯ, рккрлЛрк▓рлАрк╕ ркХрк╛рк░, рккрлЛрк▓рлАрк╕ ркмрлАркХрки, рккрлЛрк▓рлАрк╕ рк▓рк╛ркЗркЯ, рклрк░ркдрлА рк▓рк╛ркЗркЯ
ЁЯЪе	ркЖркбрлА ркЯрлНрк░рк╛рклрк┐ркХ рк▓рк╛ркЗркЯ, ркЯрлНрк░рк╛рклрк┐ркХ, ркЯрлНрк░рк╛рклрк┐ркХ рк▓рк╛ркЗркЯрлНрк╕, ркЯрлНрк░рк╛рклрк┐ркХ рк╕рк┐ркЧрлНркирк▓рлНрк╕, рк▓рк╛ркЗркЯ
ЁЯЪж	ркКркнрлА ркЯрлНрк░рк╛рклрк┐ркХ рк▓рк╛ркЗркЯ, ркЯрлНрк░рк╛рклрк┐ркХ, ркЯрлНрк░рк╛рклрк┐ркХ рк▓рк╛ркЗркЯрлНрк╕, ркЯрлНрк░рк╛рклрк┐ркХ рк╕рк┐ркЧрлНркирк▓рлНрк╕, рк▓рк╛ркЗркЯ
ЁЯЫС	ркЕрк╖рлНркЯркХрлЛркг, рк░рлЛркХрлЛ, рк░рлЛркХрлЛ рк╕ркВркХрлЗркд, рк╕ркВркХрлЗркд
ЁЯЪз	ркЪрк┐рк╣рлНрки, ркмрк╛ркВркзркХрк╛рко, ркмрк╛ркВркзркХрк╛рко рк╣рлЗркарк│ ркЫрлЗ, ркмрк╛ркВркзркХрк╛ркоркирлБркВ ркЪрк┐рк╣рлНрки
ЁЯЫ╢	ркХрлЕркирлЛркИ, рк╣рлЛркбрлА
ЁЯЪд	рк╡рк╛рк╣рки, рк╕рлНрккрлАркбркмрлЛркЯ, рк╣рлЛркбрлА
ЁЯЪв	ркЬрк╣рк╛ркЬ, рк╡рк╣рк╛ркг, рк╡рк╛рк╣рки
ЁЯЫл	ркПрк░рккрлНрк▓рлЗркиркирлА рк░рк╡рк╛ркиркЧрлА, ркЪрлЗркХ-ркЗрки, рккрлНрк░рк╕рлНркерк╛рки, рк╡рк╛рк╣рки
ЁЯЫм	ркЖрк╡рлА рк░рк╣рлНркпрлБркВ ркЫрлЗ, ркПрк░рккрлНрк▓ркиркирлБркВ ркЖркЧркорки, рк▓рлЗркирлНркбрк┐ркВркЧ, рк╡рк╛рк╣рки
ЁЯТ║	ркЦрлБрк░рк╢рлА, ркмрлЗркаркХ, рк╕рлАркЯ
ЁЯЪБ	рк╡рк╛рк╣рки, рк╣рлЗрк▓рк┐ркХрлЛрккрлНркЯрк░
ЁЯЪЯ	рк░рлЗрк▓рлНрк╡рлЗ, рк╡рк╛рк╣рки, рк╕рк╕рлНрккрлЗркирлНрк╢рки, рк╕рк╕рлНрккрлЗркирлНрк╢рки рк░рлЗрк▓рлНрк╡рлЗ
ЁЯЪа	ркХрк╛рк░, ркХрлЕркмрк▓, рккрк░рлНрк╡ркд, рккрк░рлНрк╡ркдрлЛркирлА ркХрлЕркмрк▓ ркХрк╛рк░, рккрк░рлНрк╡ркдрлЛркирлА ркХрлЕркмрк▓ рк╡рлЗ, рккрк░рлНрк╡ркдрлЛркирлА ркХрлЕркмрк▓рк╡рлЗ
ЁЯЪб	ркХрлЕркмрк▓ ркХрк╛рк░, ркЧркВркбрлЛрк▓рк╛, ркЯрлНрк░рк╛ркорк╡рлЗ, рк░рлЛрккрк╡рлЗ, рк╣рк╡рк╛ркИ, рк╣рк╡рк╛ркИ ркЯрлНрк░рк╛ркорк╡рлЗ
ЁЯЪА	рк░рлЙркХрлЗркЯ, рк╡рк╛рк╣рки
ЁЯЫ╕	UFO, рклрлНрк▓рк╛ркЗркВркЧ рк╕рлЙрк╕рк░
ЁЯз│	рккрлЗркХрк┐ркВркЧ, ркорлБрк╕рк╛рклрк░рлА, рк╕рк╛ркорк╛рки
тП░	ркПрк▓рк╛рк░рлНрко, ркПрк▓рк╛рк░рлНрко ркШркбрк┐ркпрк╛рк│, ркШркбрк┐ркпрк╛рк│, рк╕ркоркп
ЁЯХз	12:30, ркШркбрк┐ркпрк╛рк│, рк╕рк╛ркбрк╛ ркмрк╛рк░
ЁЯХЬ	1:30, ркШркбрк┐ркпрк╛рк│, ркжрлЛркв
ЁЯХЭ	2:30, ркЕркврлА, ркШркбрк┐ркпрк╛рк│
ЁЯХЮ	3:30, ркШркбрк┐ркпрк╛рк│, рк╕рк╛ркбрк╛ ркдрлНрк░ркг
ЁЯХЯ	4:30, ркШркбрк┐ркпрк╛рк│, рк╕рк╛ркбрк╛ ркЪрк╛рк░
ЁЯХа	5:30, ркШркбрк┐ркпрк╛рк│, рк╕рк╛ркбрк╛ рккрк╛ркВркЪ
ЁЯХб	6:30, ркШркбрк┐ркпрк╛рк│, рк╕рк╛ркбрк╛ ркЫ
ЁЯХв	7:30, ркШркбрк┐ркпрк╛рк│, рк╕рк╛ркбрк╛ рк╕рк╛ркд
ЁЯХг	8:30, ркШркбрк┐ркпрк╛рк│, рк╕рк╛ркбрк╛ ркЖрка
ЁЯХд	9:30, ркШркбрк┐ркпрк╛рк│, рк╕рк╛ркбрк╛ ркирк╡
ЁЯХе	10:30, ркШркбрк┐ркпрк╛рк│, рк╕рк╛ркбрк╛ ркжрк╕
ЁЯХж	11:30, ркШркбрк┐ркпрк╛рк│, рк╕рк╛ркбрк╛ ркЕркЧрк┐ркпрк╛рк░
ЁЯМС	ркЕркорк╛рк╕, ркЪркВркжрлНрк░, ркбрк╛рк░рлНркХ, ркирк╡рлЛ, рккрлНрк░ркдрк┐рккркжрк╛ркирлЛ ркЪркВркжрлНрк░
ЁЯМТ	ркЪркВркжрлНрк░, ркмрлАркЬ, ркмрлАркЬркирлЛ ркЪркВркжрлНрк░, рк╡ркзркдрлЛ
ЁЯМУ	ркЪркВркжрлНрк░, ркдрлНрк░рк┐ркорк╛рк╕рлА, рккрлНрк░ркерко ркдрлНрк░рк┐ркорк╛рк╕рлА ркЪркВркжрлНрк░, рккрлНрк░ркерко ркдрлНрк░рк┐ркорк╛рк╕рлАркирлЛ ркЪркВркжрлНрк░
ЁЯМФ	ркЕрк░рлНркз ркЪркВркжрлНрк░, ркЪркВркжрлНрк░, ркмрк╣рк┐рк░рлНркЧрлЛрк│, рк╡ркзркдрлЛ, рк╡ркзркдрлЛ ркЪркВркжрлНрк░
ЁЯМЦ	ркЕрк░рлНркз ркЪркВркжрлНрк░, ркШркЯркдрлЛ, ркШркЯркдрлЛ ркЪркВркжрлНрк░, ркЪркВркжрлНрк░, ркмрк╣рк┐рк░рлНркЧрлЛрк│
ЁЯМЧ	ркЕркВркдрк┐рко ркдрлНрк░рк┐ркорк╛рк╕рлА ркЪркВркжрлНрк░, ркЪркВркжрлНрк░, ркЫрлЗрк▓рлНрк▓рлА ркдрлНрк░рк┐ркорк╛рк╕рлАркирлЛ ркЪркВркжрлНрк░, ркдрлНрк░рк┐ркорк╛рк╕рлА
ЁЯМШ	ркЕрк░рлНркзркЪркВркжрлНрк░рк╛ркХрк╛рк░, ркШркЯркдрлЛ, ркШркЯркдрлЛ ркЕрк░рлНркзркЪркВркжрлНрк░рк╛ркХрк╛рк░ ркЪркВркжрлНрк░, ркЪркВркжрлНрк░, ркмрлАркЬркирлЛ ркЪркВркжрлНрк░
ЁЯМЩ	ркЕрк░рлНркзркЪркВркжрлНрк░рк╛ркХрк╛рк░, ркЪркВркжрлНрк░, ркмрлАркЬркирлЛ ркЪркВркжрлНрк░, ркмрлАркЬркирлЛ ркЪрк╛ркВркж
ЁЯМЪ	ркЪркВркжрлНрк░, ркЪрк╣рлЗрк░рк╛ рк╕рк╛ркерлЗркирлЛ рккрлНрк░ркдрк┐рккркжрк╛ркирлЛ ркЪркВркжрлНрк░, ркЪрк╣рлЗрк░рлЛ, рккрлНрк░ркдрк┐рккркжрк╛ркирк╛ ркЪркВркжрлНрк░ркирлЛ ркЪрк╣рлЗрк░рлЛ, рккрлНрк░ркдрк┐рккркжрк╛ркирлЛ ркЪркВркжрлНрк░
ЁЯМЫ	ркЕрк░рлНркз ркЪркВркжрлНрк░, ркЕрк░рлНркз ркЪркВркжрлНрк░ркирлЛ ркЪрк╣рлЗрк░рлЛ, ркЪркВркжрлНрк░, ркЪрк╣рлЗрк░рк╛ рк╕рк╛ркерлЗркирлЛ ркЕрк░рлНркз ркЪркВркжрлНрк░, ркЪрк╣рлЗрк░рк╛рк╡рк╛рк│рлЛ рк╢рлБркХрлНрк▓ рккркХрлНрк╖ркирлЛ ркЪркВркжрлНрк░, ркЪрк╣рлЗрк░рлЛ
ЁЯМЭ	ркЪркВркжрлНрк░, ркЪрк╣рлЗрк░рк╛рк╡рк╛рк│рлЛ ркЪркВркжрлНрк░, ркЪрк╣рлЗрк░рлЛ, рккрлВркиркоркирк╛ ркЪркВркжрлНрк░ркирлЛ ркЪрк╣рлЗрк░рлЛ, рккрлВркиркоркирк╛ ркЪркВркжрлНрк░рк╡рк╛рк│рлЛ ркЪрк╣рлЗрк░рлЛ, рккрлВркиркоркирлЛ ркЪркВркжрлНрк░, рккрлВрк░рлНркг
ЁЯМЮ	ркЪрк╣рлЗрк░рлЛ, рк╕рлВрк░рлНркп, рк╕рлВрк░рлНркпркирлЛ ркЪрк╣рлЗрк░рлЛ
ЁЯМЯ	ркЪркоркХркдрлЛ, ркЪркоркХркдрлЛ ркдрк╛рк░рлЛ, ркЪркоркХркжрк╛рк░, ркЪркоркХркирк╛рк░, ркЪрк│ркХрк╡рлБркВ, ркдрк╛рк░рлЛ
ЁЯМа	ркЦрк░ркдрлЛ, ркЦрк░ркдрлЛ ркдрк╛рк░рлЛ, ркдрк╛рк░рлЛ
ЁЯМА	ркЪркХрлНрк░рк╡рк╛ркд, ркЯрлНрк╡рк┐рк╕рлНркЯрк░, рккрлНрк░ркЪркВркб ркдрлЛрклрк╛рки, рк╡ркВркЯрлЛрк│рк┐ркпрлЛ, рк╡рк╛рк╡рк╛ркЭрлЛркбрлБ
ЁЯМИ	рк╡рк░рк╕рк╛ркж, рк╕рккрлНркдрк░ркВркЧрлА, рк╣рк╡рк╛ркорк╛рки
ЁЯМВ	ркЫркдрлНрк░рлА, ркмркВркз ркЫркдрлНрк░рлА, рк╡рк░рк╕рк╛ркж, рк╡рк░рк╕рк╛ркжрлА
ЁЯФе	ркЕркЧрлНркирк┐, ркЖркЧ, ркЬрлНркпрлЛркд
ЁЯТз	ркЯрлАрккрлБркВ, ркаркВркбрлЛ рккрк░рк╕рлЗрк╡рлЛ, рккрк░рк╕рлЗрк╡рлЛ, рккрлНрк░рк╕рлНрк╡рлЗркжркпрлБркХрлНркд, рк░ркорлВркЬрлА
ЁЯМК	ркдрк░ркВркЧ, ркжрк░рк┐ркпрк╛ркирлБ ркорлЛркЬрлБркВ, рккрк╛ркгрлАркирлА рк▓рк╣рлЗрк░, рк╕ркорлБркжрлНрк░ркирлА рк▓рк╣рлЗрк░
ЁЯОГ	ркЙркЬрк╡ркгрлА, ркХрлЛрк│рлБркВ, ркЬрлЗркХ, ркЬрлЗркХ-ркУ-рк▓рлЗркирлНркЯрк░рлНрки, рк▓рлЗркирлНркЯрк░рлНрки, рк╣рлЗрк▓рлЛрк╡рк┐рки
ЁЯОД	ркЙркЬрк╡ркгрлА, ркирк╛ркдрк╛рк▓ рк╡рлГркХрлНрк╖, рк╡рлГркХрлНрк╖
ЁЯОЖ	ркЙркЬрк╡ркгрлА, рклркЯрк╛ркХркбрк╛, рклркЯрк╛ркХркбрк╛ рклрлЛркбрк╡рк╛
ЁЯОЗ	ркЖркдрк╢ркмрк╛ркЬрлА, ркЙркЬрк╡ркгрлА, рклркЯрк╛ркХркбрк╛, рклрлВрк▓ркЭрк░, рк╕рлНрккрк╛рк░рлНркХрк▓рк░
ЁЯзи	ркбрк╛ркпркирк╛ркорк╛ркЗркЯ, рклркЯрк╛ркХркбрк╛, рк╡рк┐рк╕рлНрклрлЛркЯркХ
тЬи	ркЪркоркХркдрк╛ ркдрк╛рк░рк╛, ркЪрк│ркХрк╛ркЯ, ркдрк╛рк░рк╛, рк╣рлАрк░рлЛ
ЁЯОИ	ркЙркЬрк╡ркгрлА, рклрлБркЧрлНркЧрлЛ
ЁЯОЙ	ркЙркЬрк╡ркгрлА, рккрк╛рк░рлНркЯрлА, рккрк╛рк░рлНркЯрлА рккрлЛрккрк░, рккрлЛрккрк░
ЁЯОК	ркЙркЬрк╡ркгрлА, ркХрк╛ркЧрк│ркирк╛ркВ ркЯрлБркХркбрк╛, ркХрк╛ркЧрк│ркирлЛ ркжркбрлЛ, ркжркбрлЛ
ЁЯОЛ	ркЙркЬрк╡ркгрлА, ркХрк╛ркЧрк│ рк╕рлНркЯрлНрк░рлАрккрлНрк╕, ркЭрк╛ркб, ркЭрк╛ркб ркЕркирлЗ ркХрк╛ркЧрк│ рк╕рлНркЯрлНрк░рлАрккрлНрк╕, ркЭрк╛ркб ркЕркирлЗ ркХрк╛ркЧрк│ркирлА рккркЯрлНркЯрлАркУ, ркдрк╛рк░рк╛ ркЙркдрлНрк╕рк╡
ЁЯОН	ркЙркЬрк╡ркгрлА, ркЬрк╛рккрк╛ркирлА, ркирлВркдрки рк╡рк░рлНрк╖, рккрк╛ркЗрки, рккрк╛ркЗрки рк╢ркгркЧрк╛рк░
ЁЯОО	ркЙркдрлНрк╕рк╡, ркЬрк╛рккрк╛ркирлА, ркЬрк╛рккрк╛ркирлА ркврлАркВркЧрк▓рлАркУ, ркврлАркВркЧрк▓рлА ркЙркдрлНрк╕рк╡, ркврлАркВркЧрк▓рлАркУ
ЁЯОП	ркЙркЬрк╡ркгрлА, ркХрк╛рк░рлНркк рк╕рлНркЯрлНрк░рлАркорк░, рк╕рлНркЯрлНрк░рлАркорк░
ЁЯОР	ркЪрк╛ркЗрко, рк╡рк┐ркВркб ркЪрк╛ркЗрко
ЁЯОС	ркЙркЬрк╡ркгрлА, ркЪркВркжрлНрк░, ркЪркВркжрлНрк░ ркжрк░рлНрк╢рки рк╕ркорк╛рк░ркВркн, ркжрк░рлНрк╢рки
ЁЯзз	ркирк╛ркгрк╛ркВ, ркнрлЗркЯ, рк▓рк╛ркЗ рк╕рлА, рк▓рк╛рк▓ рккрк░ркмрк┐ркбрлАркпрлБркВ, рк╕ркжрлНтАМркирк╕рлАркм, рк╣рлЙркВркЧркмрлМркУ
ЁЯОА	ркЙркЬрк╡ркгрлА, рк░рк┐ркмрки
ЁЯОБ	ркЙркЬрк╡ркгрлА, ркнрлЗркЯ, рк╡рлАркВркЯрлЗрк▓рлА, рк╡рлАркВркЯрлЗрк▓рлА рк╕рлЛркЧрк╛ркж, рк╕рлЛркЧрк╛ркж
ЁЯОл	ркЯрк┐ркХрк┐ркЯ, ркоркирлЛрк░ркВркЬрки
ЁЯПЕ	ркЦрлЗрк▓-ркХрлВркж ркорк╛ркЯрлЗркирлЛ ркорлЗркбрк▓, ркорлЗркбрк▓
ЁЯеЗ	рккркжркХ, рккрк╣рлЗрк▓рлБркВ, рк╕рлБрк╡рк░рлНркг, рк╕рлБрк╡рк░рлНркг рккркжркХ
ЁЯеИ	рккркжркХ, ркмрлАркЬрлБркВ, рк░ркЬркд, рк░ркЬркд рккркжркХ
ЁЯеЙ	ркХрк╛ркВрк╕рлНркп, ркХрк╛ркВрк╕рлНркп рккркжркХ, ркдрлНрк░рлАркЬрлБ, рккркжркХ
ЁЯеО	ркЕркВркбрк░ркЖрк░рлНрко, ркмрлЙрк▓, рк╕рлЙрклрлНркЯркмрлЙрк▓, рк╣рк╛ркеркорлЛркЬрлБркВ
ЁЯПА	ркЦрлЗрк▓ ркХрлВркж, ркмрк╛рк╕рлНркХрлЗркЯркмрлЛрк▓, ркмрлЛрк▓, рк╣рлВркк
ЁЯПР	ркмрлЛрк▓, рк░ркоркд, рк╡рлЙрк▓рлАркмрлЛрк▓
ЁЯПИ	ркЕркорлЗрк░рк┐ркХрки, ркЕркорлЗрк░рк┐ркХрки рклрлВркЯркмрлЛрк▓, ркЦрлЗрк▓ ркХрлВркж, ркмрлЛрк▓
ЁЯПЙ	ркЦрлЗрк▓ ркХрлВркж, ркмрлЛрк▓, рк░ркЧрлНркмрлА рклрлВркЯркмрлЛрк▓, рк╕рлЙркХрк░
ЁЯО╛	ркЦрлЗрк▓ ркХрлВркж, ркЯрлЗркирк┐рк╕, ркЯрлЗркирк┐рк╕ рк░рлЗркХрлЗркЯ ркЕркирлЗ ркмрлЛрк▓, ркмрлЛрк▓
ЁЯеП	ркЕрк▓рлНркЯрк┐ркорлЗркЯ, ркЙркбркдрлА рк░ркХрк╛ркмрлА
ЁЯО│	ркЧрлЛрк▓ркВркжрк╛ркЬрлА, ркЧрлЛрк▓ркВркжрк╛ркЬрлАркирлЛ ркжркбрлЛ, ркжркбрлЛ, рк░ркоркд
ЁЯПП	ркХрлНрк░рк┐ркХрлЗркЯ, ркмрлЗркЯ, ркмрлЛрк▓, рк░ркоркд
ЁЯПС	рклрлАрк▓рлНркб, рклрлАрк▓рлНркб рк╣рлЙркХрлА, ркмрлЛрк▓, ркорлЗркжрк╛ркирлА, рк╕рлНркЯрк┐ркХ, рк╣рлЙркХрлА
ЁЯПТ	ркЖркЗрк╕, ркЖркЗрк╕ рк╣рлЙркХрлА рк╕рлНркЯрк┐ркХ ркЕркирлЗ рккркХ, рккркХ, рк░ркоркд, рк╕рлНркЯрк┐ркХ, рк╣рлЙркХрлА
ЁЯеН	ркЧрлЙрк▓, ркмрлЙрк▓, рк▓рк╛ркХрлНрк░рлЛрк╕, рк╕рлНркЯрк┐ркХ
ЁЯПУ	ркЯрлЗркмрк▓ ркЯрлЗркирк┐рк╕, рккрк┐ркВркЧ рккрлЛркВркЧ, рккрлЗркбрк▓, ркмрлЗркЯ, ркмрлЛрк▓, рк░ркоркд
ЁЯП╕	ркмрк░рлНркбрлА, ркмрлЗркбркорк┐ркВркЯрки, рк░ркоркд, рк░рлЗркХрлЗркЯ, рк╢ркЯрк▓ркХрлЙркХ
ЁЯеК	ркЧрлНрк▓рк╡, ркмрлЙркХрлНрк╕рк┐ркВркЧ, ркмрлЙркХрлНрк╕рк┐ркВркЧ ркЧрлНрк▓рк╡, рк╕рлНрккрлЙрк░рлНркЯ
ЁЯеЛ	ркХрк░рк╛ркЯрлЗ, ркЬрлБркбрлЛ, ркорк╛рк░рлНрк╢рк▓ ркЖркЯрк░рлНрк╕, ркорк╛рк░рлНрк╢рк▓ ркЖркЯрк░рлНрк╕ ркпрлВркирк┐рклрлЙрк░рлНрко, ркпрлВркирк┐рклрлЙрк░рлНрко, рк╕рлНрккрлЙрк░рлНркЯ
ЁЯеЕ	ркЧрлЛрк▓, ркЧрлЛрк▓ ркирлЗркЯ, ркирлЗркЯ, рк╕рлНрккрлЙрк░рлНркЯ
ЁЯОг	ркЖркиркВркжрккрлНрк░ркорлЛркж, ркХрк╛ркВркЯрлЛ, ркоркирлЛрк░ркВркЬрки, ркорк╛ркЫрк▓рлА, ркорк╛ркЫрк▓рлА рккркХркбрк╡рк╛ркирлЛ ркХрк╛ркВркЯрлЛ, ркорк╛ркЫрк▓рлА рккркХркбрк╡рк╛ркирлЛ ркХрк╛ркВркЯрлЛ ркЕркирлЗ ркорк╛ркЫрк▓рлА, ркорк╛ркЫрк▓рлА рккркХркбрк╡рлА
ЁЯО╜	ркЦрлЗрк▓ ркХрлВркж, ркЦрлЗрк╕, ркЦрлЗрк╕ рк╕рк╛ркерлЗркирлЛ рк░ркирк┐ркВркЧ рк╢рк░рлНркЯ, ркжрлЛркб, рк░ркирк┐ркВркЧ рк╢рк░рлНркЯ, рк╢рк░рлНркЯ
ЁЯО┐	ркЦрлЗрк▓ ркХрлВркж, ркмрлВркЯ, рк╕рлНркХрлА, рк╕рлНркХрлА ркЕркирлЗ ркмрлВркЯ
ЁЯЫ╖	рк╕рлНрк▓рлЗркЗ, рк╕рлНрк▓рлЗркЬ, рк╕рлНрк▓рлЗркб
ЁЯеМ	ркХрк░рлНрк▓рк┐ркВркЧ рк╕рлНркЯрлЛрки, ркЧрлЗрко, рк░рлЛркВркХ
ЁЯОп	ркмрк│ркжркирлА ркЖркВркЦ, рк░ркоркд, рк▓ркХрлНрк╖рлНркп, рк▓ркХрлНрк╖рлНркп рккрк░ ркЬ, рк╕рлАркзрлА ркЬ рк╣рк┐ркЯ, рк╣рк┐ркЯ
ЁЯО▒	ркЖрка ркмрлЛрк▓, ркмрк┐рк▓рк┐ркпрк░рлНркб, рк░ркоркд
ЁЯФо	ркжркбрлЛ, ркнрк╛ркЧрлНркп, ркнрк╛ркЧрлНркп ркХркерки, рк╕рлНрклркЯрк┐ркХ, рк╕рлНрклркЯрк┐ркХркирлЛ ркжркбрлЛ
ЁЯз┐	ркЦрк░рк╛ркм ркиркЭрк░, ркдрк╛рк╡рлАркЬ, ркжрлЛрк░рк╛ркзрк╛ркЧрк╛, ркиркЭрк░рлАркпрлБркВ, ркоркгркХрлЛ, ркорк╛ркжрк│рк┐ркпрлБркВ
ЁЯО░	рк░ркоркд, рк╕рлНрк▓рлЛркЯ, рк╕рлНрк▓рлЛркЯ ркорк╢рлАрки
ЁЯО▓	рккрк╛рк╕рк╛, рккрк╛рк╕рк╛ркирлА рк░ркоркд, рккрк╛рк╕рлЛ, рк░ркоркд, рк░ркоркдркирлЛ рккрк╛рк╕рлЛ
ЁЯзй	ркЗркирлНркЯрк░рк▓рлЙркХрк┐ркВркЧ, ркХркбрлА, ркЬрлАркЧрлНрк╕рлЙ, ркЯрлБркХркбрлЛ, рккркЭрк▓
ЁЯз╕	ркЯрлЗркбрлА ркмрк┐ркЕрк░, ркнрк░рлЗрк▓рлБркВ, рк░ркоркХркбрлБркВ, рк╕рлБркВрк╡рк╛рк│рлБркВ, рк╣рк╛рке рк░ркоркХркбрлБркВ
ЁЯГП	ркЧркВркЬрлАрклрк╛ркирлБркВ рккркдрлНркдрлБркВ, ркЧркВркЬрлАрклрлЛ, ркЬрлЛркХрк░, ркЬрлЛркХрк░ркирлБркВ рккркдрлНркдрлБркВ, рккркдрлНркдрк╛ркВ
ЁЯО┤	рккркдрлНркдрк╛ркирлА рк░ркоркд, рккркдрлНркдрлБркВ, рклрлВрк▓, рклрлВрк▓рк╡рк╛рк│рлБркВ рккркдрлНркдрлБркВ, рк░ркоркд, рк╣ркирк╛рклрлВркбрк╛
ЁЯОи	ркЖрк░рлНркЯрк┐рк╕рлНркЯ, ркЖрк░рлНркЯрк┐рк╕рлНркЯ рккрлЗрк▓рлЗркЯ, ркХрк│рк╛, рккрлЗркЗркирлНркЯ рккрлЗрк▓рлЗркЯ, рккрлЗркИркирлНркЯ, рккрлЗрк▓рлЗркЯ
ЁЯз╡	ркХрлЛркХркбрлА, ркжрлЛрк░рлА рккрк░рлЛрк╡рк╡рлА, ркжрлЛрк░рлЛ, рк╕рлАрк╡ркг, рк╕рлЛркп
ЁЯз╢	ркКркиркирлЛ ркжркбрлЛ, ркЧрлВркВркерк╡рлБркВ, ркнрк░ркдркЧрлВркВркеркг, рк╕рлВркдрк░
ЁЯФЗ	ркХрлГрккрк╛ ркХрк░рлА рк╢рк╛ркВркд рк░рк╣рлЛ, ркмрлЛрк▓рк╢рлЛ ркирк╣рлАркВ, рк░ркж ркХрк░рлЗрк▓рк╛ ркЪрк┐рк╣рлНрки рк╕рк╛ркерлЗркирлБркВ рк╕рлНрккрлАркХрк░, рк╢рк╛ркВркд, рк╕рлНрккрлАркХрк░ ркмркВркз
ЁЯФЙ	ркоркзрлНркпрко, рк╕рлНрккрлАркХрк░ ркЪрк╛рк▓рлБ, рк╕рлНрккрлАркХрк░ ркоркзрлНркпрко рк╡рлЙрк▓рлНркпрлВрко, рк╕рлНрккрлАркХрк░ ркорк╛ркзрлНркпрко рк╡рлЛрк▓рлНркпрлБрко
ЁЯФК	ркКркВркЪрлЛ, рк╡ркзрлБ ркЕрк╡рк╛ркЬркорк╛ркВ рк╕рлНрккрлАркХрк░, рк╕рлНрккрлАркХрк░ ркКркЪрлЛ ркЕрк╡рк╛ркЬ
ЁЯУв	ркКркВркЪрлЛ, ркЬрк╛рк╣рлЗрк░ рк╕ркВркмрлЛркзрки, рк▓рк╛ркЙркбрк╕рлНрккрлАркХрк░
ЁЯУг	ркЪрлАркЕрк░рк┐ркВркЧ, ркорлЗркЧрк╛рклрлЛрки
ЁЯУп	рккрлЛрк╕рлНркЯрк▓, рккрлЛрк╕рлНркЯрк▓ рк╣рлЛрк░рлНрки, рк╣рлЛрк░рлНрки
ЁЯФФ	ркШркВркЯ, ркжрлЗрк╡рк╛рк▓ркп
ЁЯФХ	ркЕрк╡рк╛ркЬ ркирк╣рлАркВ, ркЕрк╡рк╛ркЬ ркмркВркз рк╕рк╛ркерлЗркирлБркВ ркШркВркЯркирлБркВ ркЪрк┐рк╣рлНрки, ркШркВркЯ, ркШркВркЯ ркирк╣рлАркВ, рк░ркж ркХрк░рлЗрк▓рк╛ ркЪрк┐рк╣рлНрки рк╕рк╛ркерлЗркирлЛ ркШркВркЯ
ЁЯО╝	рк▓ркЦрк╛ркг, рк╕ркВркЧрлАркд, рк╕ркВркЧрлАркд ркорк╛ркЯрлЗркирлА рк▓ркЦрк╛ркг
ЁЯО╡	ркирлЛркЯ, рк╕ркВркЧрлАркд, рк╕ркВркЧрлАркдркирлА ркирлЛркЯ
ЁЯО╢	ркирлЛркЯ, ркирлЛркЯрлНрк╕, рк╕ркВркЧрлАркд, рк╕ркВркЧрлАркдркирлА ркирлЛркЯрлНрк╕
ЁЯОд	ркХрк╛рк░рк╛ркУркХ, ркоркирлЛрк░ркВркЬрки, ркорк╛ркЗркХ, ркорк╛ркЗркХрлНрк░рлЛрклрлЛрки
ЁЯО╖	рк╡рк╛ркжрлНркп, рк╕ркВркЧрлАркд, рк╕рлЗркХрлНрк╕, рк╕рлЗркХрлНрк╕рлЛрклрлЛрки
ЁЯО╕	ркЧрк┐ркЯрк╛рк░, рк╡рк╛ркжрлНркп, рк╕ркВркЧрлАркд
ЁЯО╣	ркХрлА ркмрлЛрк░рлНркб, рккрк┐ркЖркирлЛ, ркорлНркпрлБркЭрк┐ркХрк▓ ркХрлАркмрлЛрк░рлНркб, рк╡рк╛ркжрлНркп, рк╕ркВркЧрлАркд, рк╕ркВркЧрлАркд ркХрлА ркмрлЛрк░рлНркб
ЁЯО║	ркдрлБрк░рк╛ркИ, рк╡рк╛ркжрлНркп, рк╕ркВркЧрлАркд
ЁЯО╗	рк╡рк╛ркжрлНркп, рк╡рк╛ркпрлЛрк▓рк┐рки, рк╕ркВркЧрлАркд
ЁЯеБ	ркбрлНрк░рко, ркбрлНрк░ркорк╕рлНркЯрк┐ркХ, рк╕ркВркЧрлАркд
ЁЯУ▒	рклрлЛрки, ркорлЛркмрк╛ркЗрк▓ рклрлЛрки, рк╕рлЗрк▓ рклрлЛрки
ЁЯУ▓	ркПркХ ркХрлЙрк▓ ркХрк░рлЛ, ркдрлАрк░ рк╕рк╛ркерлЗркирлЛ ркорлЛркмрк╛ркЗрк▓ рклрлЛрки, ркдрлАрк░ рк╕рк╛ркерлЗркирлЛ рк╕рлЗрк▓ рклрлЛрки, рклрлЛрки, ркорлЛркмрк╛ркЗрк▓ рклрлЛрки
ЁЯУЮ	ркЯрлЗрк▓рк┐рклрлЛрки, ркЯрлЗрк▓рк┐рклрлЛркиркирлБркВ рк░рлАрк╕рк┐рк╡рк░, рклрлЛрки, рклрлЛркиркирлБркВ рк░рлАрк╕рк┐рк╡рк░, рк╕ркВркЪрк╛рк░
ЁЯУа	рклрлЕркХрлНрк╕, рклрлЕркХрлНрк╕ ркорк╢рлАрки, рк╕ркВркЪрк╛рк░
ЁЯФЛ	ркмрлЕркЯрк░рлА
ЁЯФМ	ркЗрк▓рлЗркХрлНркЯрлНрк░рк┐ркХ, ркЗрк▓рлЗркХрлНркЯрлНрк░рк┐ркХ рккрлНрк▓ркЧ
ЁЯТ╜	MD, ркбрк┐рк╕рлНркХ, ркорк┐ркирк┐ ркбрк┐рк╕рлНркХ
ЁЯТ╛	ркбрк┐рк╕рлНркХ, рклрлНрк▓рлЛрккрлА, рклрлНрк▓рлЛрккрлА ркбрк┐рк╕рлНркХ
ЁЯУА	DVD, ркбрк┐рк╕рлНркХ, ркбрлАрк╡рлАркбрлА
ЁЯзо	ркЧркгркдрк░рлА, ркоркгркХрк╛ ркШрлЛркбрлА
ЁЯОе	ркоркирлЛрк░ркВркЬрки, ркорлВрк╡рлА, ркорлВрк╡рлА ркХрлЕркорлЗрк░рк╛, ркорлВрк╡рлАркирлЛ ркХрлЕркорлЗрк░рлЛ, рк╕рк┐ркирлЗркорк╛
ЁЯУ╕	ркХркорлЗрк░рлЛ, рклрлНрк▓рлЗрк╢, рклрлНрк▓рлЗрк╢ рк╕рк╛ркерлЗркирлЛ ркХрлЕркорлЗрк░рлЛ, рк╡рк┐ркбрк┐ркУ
ЁЯУ╝	ркЯрлЗркк, рк╡рк┐ркбрк┐ркУ, рк╡рк┐ркбрк┐ркУркХрлЗрк╕рлЗркЯ
ЁЯФН	ркХрк╛ркЪ, ркбрк╛ркмрлА ркдрк░рклркирлЛ, ркбрк╛ркмрлА ркдрк░рклркирлЛ ркмрлГрк╣ркжркжрк░рлНрк╢ркХ ркХрк╛ркЪ, ркмрлГрк╣ркжркжрк░рлНрк╢ркХ ркХрк╛ркЪ, рк╢рлЛркзрлЛ
ЁЯФО	ркХрк╛ркЪ, ркЬркоркгрлА ркдрк░рклркирлЛ, ркЬркоркгрлА ркдрк░рклркирлЛ ркмрлГрк╣ркжркжрк░рлНрк╢ркХ ркХрк╛ркЪ, ркмрлГрк╣ркжркжрк░рлНрк╢ркХ ркХрк╛ркЪ, рк╢рлЛркзрлЛ
ЁЯТб	ркХрлЛркорк┐ркХ, ркЧрлЛрк│рлЛ, рк▓рк╛ркЗркЯркирлЛ ркмрк▓рлНркм, рк╡рк┐ркЪрк╛рк░ ркЖрк╡рлНркпрлЛ, рк╡рлАркЬ, рк╡рлАркЬрк│рлА, рк╡рлАркЬрк│рлАркирлЛ ркЧрлЛрк│рлЛ
ЁЯФж	ркЗрк▓рлЗркХрлНркЯрлНрк░рк┐ркХ, ркЯрлЛрк░рлНркЪ, рккрлНрк░ркХрк╛рк╢, рклрлНрк▓рлЗрк╢рк▓рк╛ркЗркЯ
ЁЯПо	ркЗркЭрк╛ркХрлНркпрк╛, рклрк╛ркирк╕, ркмрк╛рк░, рк░рлЗрк╕рлНркЯрлЛрк░ркирлНркЯ, рк▓рк╛рк▓, рк▓рк╛рк▓ рклрк╛ркирк╕
ЁЯУФ	ркХрк╡рк░, ркирлЛркЯркмрлБркХ, рк╕рлБрк╢рлЛркнркирк╡рк╛рк│рлА ркирлЛркЯркмрлБркХ, рк╕рлБрк╢рлЛркнрк┐ркд ркХрк╡рк░рк╡рк╛рк│рлА ркирлЛркЯркмрлБркХ, рк╕рлБрк╢рлЛркнрк┐ркд ркирлЛркЯркмрлБркХ
ЁЯУХ	рккрлБрк╕рлНркдркХ, ркмркВркз рккрлБрк╕рлНркдркХ
ЁЯУЦ	ркЦрлБрк▓рлНрк▓рлБркВ рккрлБрк╕рлНркдркХ, рккрлБрк╕рлНркдркХ
ЁЯУЧ	рккрлБрк╕рлНркдркХ, рк▓рлАрк▓рлБркВ рккрлБрк╕рлНркдркХ
ЁЯУШ	рккрлБрк╕рлНркдркХ, рк╡рк╛ркжрк│рлА рккрлБрк╕рлНркдркХ
ЁЯУЩ	ркирк╛рк░ркВркЧрлА рккрлБрк╕рлНркдркХ, рккрлБрк╕рлНркдркХ
ЁЯУУ	ркирлЛркЯркмрлБркХ
ЁЯУТ	ркЦрк╛ркдрк╛рк╡рк╣рлА, ркирлЛркЯркмрлБркХ
ЁЯУГ	ркжрк╕рлНркдрк╛рк╡рлЗркЬ, рккрлГрк╖рлНрка, рк╡рк│рлЗрк▓рлБркВ рккрлГрк╖рлНрка
ЁЯУЬ	рккрлЗрккрк░ рк╕рлНркХрлНрк░рлЛрк▓, рк╕рлНркХрлНрк░рлЛрк▓
ЁЯУД	ркЪркдрлНркдрлБ, ркЪркдрлНркдрлБ рккрлГрк╖рлНрка, ркжрк╕рлНркдрк╛рк╡рлЗркЬ, рккрлГрк╖рлНрка
ЁЯУ░	ркХрк╛ркЧрк│, рк╕ркорк╛ркЪрк╛рк░, рк╕ркорк╛ркЪрк╛рк░рккркдрлНрк░, рк╕ркорк╛ркЪрк╛рк░рккркдрлНрк░, ркЫрк╛рккрлБркВ
ЁЯЧЮ	рк╡рк╛рк│рлЗрк▓рлБркВ ркЫрк╛рккрлБркВ, рк╕ркорк╛ркЪрк╛рк░рккркдрлНрк░
ЁЯУС	ркЯрлЗркмрлНрк╕, ркмрлБркХркорк╛рк░рлНркХ, ркмрлБркХркорк╛рк░рлНркХрлНрк╕ ркЯрлЗркмрлНрк╕, ркорк╛рк░рлНркХрк░
ЁЯФЦ	ркмрлБркХркорк╛рк░рлНркХ, ркорк╛рк░рлНркХ
ЁЯТ┤	ркирлЛркЯ, ркмрк┐рк▓, ркмрлЗркВркХркирлЛркЯ, ркпрлЗрки ркирлЛркЯ, ркпрлЗрки ркирлЛркЯ. ркмрлЗркВркХ ркирлЛркЯ, ркпрлЗрки. рккрлИрк╕рк╛
ЁЯТ╡	ркбрлЙрк▓рк░, ркбрлЙрк▓рк░ ркирлЛркЯ, ркирлЛркЯ, рккрлИрк╕рк╛, ркмрк┐рк▓, ркмрлЗркВркХркирлЛркЯ
ЁЯТ╢	ркирлЛркЯ, рккрлИрк╕рк╛, ркмрк┐рк▓, ркмрлЗркВркХркирлЛркЯ, ркпрлБрк░рлЛ, ркпрлБрк░рлЛ ркирлЛркЯ
ЁЯТ╖	рккрк╛ркЙркирлНркб, рккрк╛ркЙркирлНркб ркирлЛркЯ, рккрлИрк╕рк╛, ркмрлЗркВркХркирлЛркЯ
ЁЯТ╕	ркКркбркдрк╛ рккрлИрк╕рк╛, ркКркбркдрлА ркмрлЗркВркХркирлЛркЯ, ркирлЛркЯ, рккркВркЦ рк╕рк╛ркерлЗркирк╛ркВ рккрлИрк╕рк╛, рккрлИрк╕рк╛, ркмрлЗркВркХ
ЁЯз╛	ркПркХрк╛ркЙркирлНркЯрк┐ркВркЧ, ркирк╛ркорлБркВ, рккрлБрк░рк╛рк╡рлЛ, рк░рк╕рлАркж, рк╕рк╛ркмрк┐ркдрлА
ЁЯТ╣	ркЖрк▓рлЗркЦ, ркЙрккрк░ркирлА ркдрк░ркл, ркКркВркЪрлЗ ркЬркдрлЛ ркЖрк▓рлЗркЦ, ркКркаркдрлБркВ ркмркЬрк╛рк░, ркмркЬрк╛рк░, ркпрлЗрки рк╕рк╛ркерлЗ ркЙрккрк░ ркЬркдрлЛ ркЪрк╛рк░рлНркЯ
ЁЯТ▒	рккрлИрк╕рк╛, ркорлБркжрлНрк░рк╛, ркорлБркжрлНрк░рк╛ рк╡рк┐ркирк┐ркоркп, рк╡рк┐ркирк┐ркоркп
ЁЯТ▓	ркШрк╛ркЯрлБркВ ркбрлЙрк▓рк░ ркЪрк┐рк╣рлНрки, ркШрк╛ркЯрлБркВ ркбрлЙрк▓рк░ркирлБркВ ркЪрк┐рк╣рлНрки, ркбрлЙрк▓рк░, ркбрлЙрк▓рк░ ркЪрк┐рк╣рлНрки, рккрлИрк╕рк╛
ЁЯУз	ркЗркорлЗркЗрк▓, рккркдрлНрк░, ркорлЗркЗрк▓, рк╕ркВркЪрк╛рк░
ЁЯУи	ркЖрк╡ркирк╛рк░рлА, ркЖрк╡ркирк╛рк░рлА ркорлЗркЗрк▓, ркЗркорлЗркЗрк▓, рккркдрлНрк░, рккрк░ркмрлАркбрк┐ркпрлБркВ, рккрлНрк░рк╛рккрлНркд ркорлЗркЗрк▓, ркорлЗркЗрк▓, рк╕ркВркЪрк╛рк░
ЁЯУй	ркЗркорлЗркЗрк▓, рккркдрлНрк░, рккрк░ркмрлАркбрк┐ркпрлБркВ, ркмрк╣рк╛рк░ ркЬркдрлА, ркмрк╣рк╛рк░ ркЬркдрлА ркорлЗркЗрк▓, ркорлЗркЗрк▓, ркорлЛркХрк▓рлЗрк▓ ркорлЗркЗрк▓, рк╕ркВркЪрк╛рк░
ЁЯУо	рккрлЛрк╕рлНркЯркмрлЙркХрлНрк╕, ркорлЗркЗрк▓, ркорлЗркЗрк▓ркмрлЙркХрлНрк╕
ЁЯУЭ	ркорлЗркорлЛ, ркорлЗркорлЛ рккрлБрк╕рлНркдркХ, рк╕ркВркЪрк╛рк░
ЁЯТ╝	ркмрлНрк░рлАрклркХрлЗрк╕
ЁЯУБ	рклрк╛ркЗрк▓, рклрк╛ркЗрк▓ рклрлЛрк▓рлНркбрк░
ЁЯУВ	ркЦрлБрк▓рлНрк▓рлБркВ, ркЦрлБрк▓рлНрк▓рлБркВ рклрк╛ркЗрк▓ рклрлЛрк▓рлНркбрк░, рклрк╛ркЗрк▓, рклрлЛрк▓рлНркбрк░
ЁЯУЕ	ркХрлЕрк▓рлЗркирлНркбрк░, ркХрлЗрк▓рлЗркирлНркбрк░
ЁЯУЖ	ркХрлЗрк▓рлЗркирлНркбрк░, ркдрк╛рк░рлАркЦрк┐ркпрлБркВ
ЁЯУЗ	ркЗркирлНркбрлЗркХрлНрк╕, ркХрк╛рк░рлНркб ркЕркирлБркХрлНрк░рко, рк░рлЛрк▓рлЛркбрлЗркХрлНрк╕
ЁЯУИ	ркЖрк▓рлЗркЦ, ркЙркВркЪрлЗ ркЬркдрлЛ ркЪрк╛рк░рлНркЯ, ркЙркВркЪрлЗркирк╛ рк╡рк▓ркгркирлЛ ркЪрк╛рк░рлНркЯ, ркЙркВркЪрлЗркирлБркВ рк╡рк▓ркг, ркЙрккрк░ркирлА ркдрк░ркл, ркЪрк╛рк░рлНркЯ
ЁЯУЙ	ркЖрк▓рлЗркЦ, ркЙркВркЪрлЗркирк╛ рк╡рк▓ркгркирлЛ ркЪрк╛рк░рлНркЯ, ркЪрк╛рк░рлНркЯ, ркирлАркЪрлЗ ркЬркдрлЛ ркЪрк╛рк░рлНркЯ, ркирлАркЪрлЗркирлА ркдрк░ркл, ркирлАркЪрлЗркирлБркВ рк╡рк▓ркг
ЁЯУК	ркЪрк╛рк░рлНркЯ, ркмрк╛рк░ ркЪрк╛рк░рлНркЯ, рк╕рлНркдркВркн ркЖрк▓рлЗркЦ
ЁЯУМ	рккрк┐рки, рккрлБрк╢рккрк┐рки
ЁЯУН	ркЧрлЛрк│рк╛ркХрк╛рк░ рккрлБрк╢рккрк┐рки, рккрк┐рки, рккрлБрк╢рккрк┐рки
ЁЯУО	ркХрлНрк▓рк┐ркк, рккрлЗрккрк░ркХрлНрк▓рк┐ркк
ЁЯУП	ркЖркВркХркгрлА, рк╕рлАркзрлА ркЖркВркХркгрлА
ЁЯУР	ркЖркВркХркгрлА, ркХрк╛ркЯркЦрлВркгрк┐ркпрлБркВ, ркдрлНрк░рк┐ркХрлЛркг
ЁЯФП	ркЗркВркХ рккрлЗрки, ркЗркВркХ рккрлЗрки рк╕рк╛ркерлЗ рк▓рлЙркХ, ркЧрлЛрккркирлАркпркдрк╛, рккрлЗрки рк╕рк╛ркерлЗ рк▓рлЙркХ, рк▓рлЙркХ ркХрк░рлЛ
ЁЯФР	ркЪрк╛рк╡рлА рк╕рк╛ркерлЗ ркдрк╛рк│рлБркВ, ркЪрк╛рк╡рлА рк╕рк╛ркерлЗ ркмркВркз ркдрк╛рк│рлБркВ, ркмркВркз ркдрк╛рк│рлБркВ, рк╕рлБрк░ркХрлНрк╖рк┐ркд
ЁЯФС	ркХрлА, ркЪрк╛рк╡рлА, рккрк╛рк╕рк╡рк░рлНркб
ЁЯФи	рк╕рк╛ркзрки, рк╣ркерлЛркбрлА
ЁЯФл	ркЧрки, рккрк┐рк╕рлНркдрлЛрк▓, рк░рлАрк╡рлЛрк▓рлНрк╡рк░
ЁЯП╣	ркдрлАрк░ ркЕркирлЗ ркХркорк╛рки, ркдрлАрк░ркВркжрк╛ркЬ, рк░рк╛рк╢рк┐, рк╕рк╛ркзрки, рк╣ркерк┐ркпрк╛рк░
ЁЯФз	рккрк╛ркирлБркВ, рк░рлЗркВркЪ, рк╕рк╛ркзрки
ЁЯФй	ркиркЯ, ркиркЯ ркЕркирлЗ ркмрлЛрк▓рлНркЯ, ркмрлЛрк▓рлНркЯ, рк╕рк╛ркзрки
ЁЯФЧ	ркмрлЗ рк░рк┐ркВркЧрлНрк╕, рк▓рк┐ркВркХ, рк▓рк┐ркВркХркирлБркВ ркЪрк┐рк╣рлНрки, рк▓рк┐ркВркХрлНрк╕
ЁЯз░	ркЯрлВрк▓ркмрлЛркХрлНрк╕, рккркЯрк╛рк░рлЛ, ркорк┐ркХрлЗркирк┐ркХ, рк╕рк╛ркзрки
ЁЯз▓	ркЖркХрк░рлНрк╖ркг, ркШрлЛркбрк╛ркирлА ркирк╛рк│, ркЪрлБркВркмркХрлАркп, рк▓рлЛрк╣ркЪрлБркВркмркХ
ЁЯзк	ркЯрлЗрк╕рлНркЯ ркЯрлНркпрлВркм, рккрлНрк░ркпрлЛркЧ, рк░рк╕рк╛ркпркгрк╢рк╛рк╕рлНркдрлНрк░, рк░рк╕рк╛ркпркгрк╢рк╛рк╕рлНркдрлНрк░рлА, рк▓рлЗркм, рк╡рк┐ркЬрлНркЮрк╛рки
ЁЯзл	ркЬрлАрк╡рк╡рк┐ркЬрлНркЮрк╛рки, ркЬрлАрк╡рк╡рк┐ркЬрлНркЮрк╛ркирлА, рккрлЗркЯрлНрк░рлА ркбрк┐рк╢, ркмрлЗркХрлНркЯрлЗрк░рк┐ркпрк╛, рк▓рлЗркм, рк╕ркВрк╡рк░рлНркзрки
ЁЯзм	ркЙркдрлНркХрлНрк░рк╛ркВркдрк┐, ркЬркирлАрки, ркЬрк┐ркирлЗркЯрк┐ркХрлНрк╕, ркЬрлАрк╡рки, ркЬрлАрк╡рк╡рк┐ркЬрлНркЮрк╛ркирлА, ркбрлАркПркиркП
ЁЯФм	ркЯрлВрк▓, ркорк╛ркЗркХрлНрк░рлЛрк╕рлНркХрлЛркк
ЁЯФн	ркЯрлВрк▓, ркЯрлЗрк▓рк┐рк╕рлНркХрлЛркк
ЁЯУб	ркПркирлНркЯрлЗркирк╛, ркбрк┐рк╢, рк╕ркВркЪрк╛рк░, рк╕рлЗркЯрлЗрк▓рк╛ркЗркЯ, рк╕рлЗркЯрлЗрк▓рк╛ркЗркЯ ркПркирлНркЯрлЗркирк╛
ЁЯТЙ	ркбрлЛркХрлНркЯрк░, ркжрк╡рк╛, рк╢рлЛркЯ, рк╕рлАрк░рк┐ркВркЬ, рк╕рлЛркп
ЁЯТК	ркЧрлЛрк│рлА, ркЧрлЛрк│рлА, ркЯрк┐ркХркбрлА, ркбрлЛркХрлНркЯрк░, ркжрк╡рк╛
ЁЯЪк	ркжрк░рк╡рк╛ркЬрлЛ
ЁЯЪ╜	ркЯрлЙркЗрк▓рлЗркЯ
ЁЯЪ┐	рк╢рк╛рк╡рк░, рк╢рлЙрк╡рк░
ЁЯЫБ	ркирк╛рк╣рк╡рлБркВ, ркмрк╛рке, ркмрк╛рке ркЯркм
ЁЯз┤	ркорлЛркЗрк╕рлНркЪрк░рк╛ркЗркЭрк░, рк▓рлЛрк╢рки, рк▓рлЛрк╢ркиркирлА ркмрлЛркЯрк▓, рк╢рлЗркорлНрккрлВ, рк╕ркирк╕рлНркХрлНрк░рлАрки
ЁЯз╖	ркбрк╛ркпрккрк░, рккркВркХ рк░рлЙркХ, рк╕рлЗрклрлНркЯрлА рккрк┐рки
ЁЯз╣	ркХркЪрк░рк╛ркЬрк╛рк│рк╛, рк▓рк╛ркВркмрк╛ рк╣рк╛ркерк╛рк╡рк╛рк│рлБркВ ркЭрк╛ркбрлБ, рк╕рклрк╛ркИ, рк╕рк╛рклрк╕рклрк╛ркИ
ЁЯз║	ркЦрлЗркдрлА, рккрк┐ркХркирлАркХ, ркмрк╛рк╕рлНркХрлЗркЯ, рк▓рлЛркирлНркбрлНрк░рлА
ЁЯз╗	ркЯрлЛркЗрк▓рлЗркЯ рккрлЗрккрк░, рккрлЗрккрк░ ркЯрлБрк╡рк╛рк▓, рккрлЗрккрк░ркирлЛ рк░рлЛрк▓
ЁЯз╝	рк╕рклрк╛ркИ, рк╕рк╛ркмрлБ, рк╕рк╛ркмрлБркирк╛ рклрлАркг, рк╕рк╛ркмрлБркирлА ркЧрлЛркЯрлА, рк╕рк╛ркмрлБркирлБркВ рккрк╛ркдрлНрк░, рк╕рлНркирк╛рки
ЁЯз╜	ркЫрк┐ркжрлНрк░рк╛рк│рлБ, рк╢рлЛрк╖рк╡рлБркВ, рк╕рклрк╛ркИ, рк╕рлНрккркВркЬ
ЁЯзп	ркЕркЧрлНркирк┐рк╢рк╛ркоркХ, ркЕркЧрлНркирк┐рк╢рк╛ркорки, ркЖркЧ, ркУрк▓рк╡рк╡рлБркВ
ЁЯЫТ	ркХрк╛рк░рлНркЯ, ркЯрлНрк░рлЙрк▓рлА, рк╢рлЙрккрк┐ркВркЧ, рк╢рлЙрккрк┐ркВркЧ ркХрк╛рк░рлНркЯ
ЁЯЪм	ркЪрк┐рк╣рлНрки, ркзрлВркорлНрк░рккрк╛рки, ркзрлВркорлНрк░рккрк╛ркиркирлА ркЕркирлБркоркдрк┐, ркзрлВркорлНрк░рккрк╛ркиркирлБркВ ркЪрк┐рк╣рлНрки
ЁЯЧ┐	рккрлНрк░ркдрк┐ркорк╛, ркорлЛркпрк╛ркИ, ркорлЛркпрк╛ркИркирлА рккрлНрк░ркдрк┐ркорк╛
ЁЯПз	ркПркЯрлАркПрко, ркСркЯрлЛркорлЗркЯрлЗркб, ркЯрлЗрк▓рк░
ЁЯЪо	ркХркЪрк░рк╛ рккрлЗркЯрлА, ркХркЪрк░рк╛ркирлЗ ркдрлЗркирк╛ рк╕рлНркерк╛ркирлЗ ркирк╛ркВркЦрлЛ, ркХркЪрк░рк╛рккрлЗркЯрлАркирлБркВ ркЪрк┐рк╣рлНрки, ркХркЪрк░рлЛ ркХркЪрк░рк╛рккрлЗркЯрлАркорк╛ркВ ркирк╛ркВркЦрлЛркирлБркВ ркЪрк┐рк╣рлНрки, ркЪрк┐рк╣рлНрки
ЁЯЪ░	рккрлАрк╡рк╛ ркорк╛ркЯрлЗркирлБркВ рккрк╛ркгрлА, рккрлАрк╡рк╛ркирк╛ркВ рккрк╛ркгрлАркирлБркВ ркЪрк┐рк╣рлНрки, рккрлАрк╡рк╛ркирлБркВ рккрк╛ркгрлА
ЁЯЪ╗	wc, рк░рлЗрк╕рлНркЯрк░рлВрко, рк░рлЗрк╕рлНркЯрк░рлВрко ркЪрк┐рк╣рлНрки, рк╢рлМркЪрк╛рк▓ркп
ЁЯЪ╛	WC, рк░рлЗрк╕рлНркЯрк░рлВрко, рк╡рлЙркЯрк░ ркХрлНрк▓рлЛркЭрлЗркЯ, рк╢рлМркЪрк╛рк▓ркп
ЁЯЫВ	ркХркирлНркЯрлНрк░рлЛрк▓, рккрк╛рк╕рккрлЛрк░рлНркЯ, рккрк╛рк╕рккрлЛрк░рлНркЯ ркХркирлНркЯрлНрк░рлЛрк▓
ЁЯЫГ	ркХрк╕рлНркЯркорлНрк╕
ЁЯЫД	ркмрлЕркЧрлЗркЬ, ркмрлЕркЧрлЗркЬ ркжрк╛рк╡рлЛ, ркмрлЕркЧрлЗркЬркирлЛ ркжрк╛рк╡рлЛ
ЁЯЫЕ	ркмрлЕркЧрлЗркЬ, ркмрлЕркЧрлЗркЬ рк╕рлЗрк╡рк╛, рк╕рк╛ркорк╛рки, рк╕рк╛ркорк╛рки ркорлВркХрлЛ
ЁЯЪ╕	ркХрлНрк░рлЛрк╕рк┐ркВркЧ, ркЪрк┐рк╣рлНрки, ркмрк╛рк│ркХрлЛ, ркмрк╛рк│ркХрлЛ ркорк╛ркЯрлЗркирлБркВ ркХрлНрк░рлЛрк╕рк┐ркВркЧ, ркмрк╛рк│ркХрлЛ ркорк╛ркЯрлЗркирлБркВ ркХрлНрк░рлЛрк╕рк┐ркВркЧркирлБркВ ркЪрк┐рк╣рлНрки
ЁЯЪл	ркЪрк┐рк╣рлНрки, ркирк┐рк╖рк┐ркжрлНркз, ркирк┐рк╖рлЗркз, рккрлНрк░ркдрк┐ркмркВркзрк┐ркд, рккрлНрк░рк╡рлЗрк╢ ркирк┐рк╖рлЗркз, рккрлНрк░рк╡рлЗрк╢ ркирк┐рк╖рлЗркз ркЪрк┐рк╣рлНрки
ЁЯЪ│	ркмрк╛ркЗркХ, ркмрк╛ркЗркХ ркирк╣рлАркВ, рк╡рк╛рк╣рки, рк╕рк╛ркЗркХрк▓ ркирк╣рлАркВ, рк╕рк╛ркЗркХрк▓ркирлЗ ркоркВркЬрлВрк░рлА ркиркерлА
ЁЯЪп	ркХркЪрк░рлЛ ркХрк░рк╢рлЛ ркирк╣рлАркВ, ркХркЪрк░рлЛ рклрлЗркВркХрк╡рлЛ ркирк╣рлАркВ, ркХркЪрк░рлЛ рклрлЗркВркХрк╢рлЛ ркирк╣рлАркВркирлБркВ ркЪрк┐рк╣рлНрки, ркЪрк┐рк╣рлНрки
ЁЯЪ▒	рккрк╛ркгрлА, рккрлАрк╡рк╛ ркпрлЛркЧрлНркп рккрк╛ркгрлА ркиркерлА, рккрлАрк╡рк╛ркирлБркВ рккрк╛ркгрлА ркирк╣рлАркВ, рккрлЗркп ркирк╣рлАркВ
ЁЯЪ╖	ркЪрк┐рк╣рлНрки, рккркжркпрк╛ркдрлНрк░рлА, рккркжркпрк╛ркдрлНрк░рлАркУ ркирк╣рлАркВ, рккркжркпрк╛ркдрлНрк░рлАркУркирлЗ ркоркВркЬрлВрк░рлА ркиркерлА, рк░рк╛рк╣ркжрк╛рк░рлА
ЁЯУ╡	ркХрлЙрк▓рлНрк╕ ркирк╣рлАркВ, ркХрлЛркИ ркорлЛркмрк╛ркЗрк▓ рклрлЛрки ркирк╣рлАркВ, рклрлЛрки, ркорлЛркмрк╛ркЗрк▓, рк╕рлЗрк▓ рклрлЛрки ркирк╣рлАркВ
ЁЯФЮ	18, 18 ркерлА ркирлАркЪрлЗркирк╛, 18 ркерлА ркирлАркЪрлЗркирк╛ рккрлНрк░ркдрк┐ркмркВркзрк┐ркд, 18 ркирлА ркирлАркЪрлЗркирлБркВ ркХрлЛркИ ркирк╣рлАркВ, ркЕркврк╛рк░ рк╡рк░рлНрк╖ркерлА ркирлАркЪрлЗркирк╛ рккрлНрк░ркдрк┐ркмркВркзрк┐ркд
ЁЯФГ	ркКркнрк╛ ркжркХрлНрк╖рк┐ркгрк╛рк╡рк░рлНркдрлА ркдрлАрк░, ркдрлАрк░, рклрк░рлАркерлА рк▓рлЛркб ркХрк░рлЛ, рклрк░рлАркерлА рк▓рлЛркб ркХрк░рлЛркирлБркВ ркЪрк┐рк╣рлНрки
ЁЯФД	ркдрлАрк░, рк╡рк╛ркорк╛рк╡рк░рлНркдрлА, рк╡рк╛ркорк╛рк╡рк░рлНркдрлА ркдрлАрк░ ркмркЯрки
ЁЯФЩ	ркбрк╛ркмрк╛ ркдрлАрк░ рк╕рк╛ркерлЗ рккрк╛ркЫрк│, ркбрк╛ркмрлБркВ ркдрлАрк░, ркдрлАрк░, рккрк╛ркЫрк│, рккрк╛ркЫрк│ ркдрлАрк░
ЁЯФЪ	ркбрк╛ркмрк╛ ркдрлАрк░ рк╕рк╛ркерлЗ рк╕ркорк╛рккрлНркдрк┐, ркбрк╛ркмрлБркВ ркдрлАрк░, ркдрлАрк░, рк╕ркорк╛рккрлНркдрк┐, рк╕ркорк╛рккрлНркдрк┐ ркдрлАрк░
ЁЯФЫ	ркЙркжрлНркЧрк╛рк░рк╡рк╛ркЪркХ, ркЙркжрлНркЧрк╛рк░рк╡рк╛ркЪркХ ркЪрк┐рк╣рлНрки, ркЙркжрлНркЧрк╛рк░рк╡рк╛ркЪркХ ркЪрк┐рк╣рлНрки ркЕркирлЗ ркдрлАрк░ рк╕рк╛ркерлЗ ркЪрк╛рк▓рлБ, ркЪрк╛рк▓рлБ ркдрлАрк░, ркЪрк╛рк▓рлБ! ркдрлАрк░, ркдрлАрк░
ЁЯФЬ	ркЬркоркгрк╛ркВ ркдрлАрк░ рк╕рк╛ркерлЗ ркЬрк▓рлНркжрлА, ркЬрк▓рлНркжрлА, ркЬрк▓рлНркжрлАркирлБркВ ркЪрк┐рк╣рлНрки, ркЬрк▓рлНркжрлАркирлБркВ ркдрлАрк░, ркдрлАрк░
ЁЯФЭ	ркЙрккрк░, ркЙрккрк░ ркдрлАрк░, ркЙрккрк░ркирк╛ркВ ркдрлАрк░ рк╕рк╛ркерлЗ ркЯрлЛркЪ, ркЯрлЛркЪ, ркЯрлЛркЪркирлБркВ ркЪрк┐рк╣рлНрки
ЁЯЫР	ркЖрк░рк╛ркзркирк╛ рк╕рлНркерк│, ркзрк░рлНрко, рккрлНрк░рк╛рк░рлНркеркирк╛
ЁЯХО	ркХрлЗркирлНркбрк▓рк╕рлНркЯрк┐ркХ, ркзрк░рлНрко, ркорлЗркирлЛрк░рк╛рк╣
ЁЯФп	ркЫ-рккрлЛркЗркВркЯрк╡рк╛рк│рлЛ, ркЫ-рккрлЛркЗркВркЯрк╡рк╛рк│рлЛ ркдрк╛рк░рлЛ, ркдрк╛рк░рлЛ, ркнрк╛ркЧрлНркп, ркнрк╛ркЧрлНркп ркХркерки
тЫО	ркдрлЗрк░ркорлА рк░рк╛рк╢рк┐ (ркСрклрк┐ркХрк╕), рк░рк╛рк╢рк┐ркЪркХрлНрк░
ЁЯФА	ркХрлНрк░рлЛрк╕ ркХрк░рлЗрк▓ ркЬркоркгрк╛ркВ ркдрлАрк░, ркХрлНрк░рлЛрк╕ ркХрк░рлЗрк▓рк╛ ркдрлАрк░, ркЯрлНрк░рлЗркХрлНрк╕ рк╢рклрк▓ ркХрк░рлЛ ркмркЯрки, ркдрлАрк░
ЁЯФБ	ркдрлАрк░, ркжркХрлНрк╖рк┐ркгрк╛рк╡рк░рлНркдрлА, рккрлБркирк░рк╛рк╡рк░рлНркдрки ркХрк░рлЛ ркмркЯрки
ЁЯФВ	ркПркХрк▓ рккрлБркирк░рк╛рк╡рк░рлНркдрки ркХрк░рлЛ ркмркЯрки, ркдрлАрк░, ркжркХрлНрк╖рк┐ркгрк╛рк╡рк░рлНркдрлА, ркиркВркмрк░ 1, ркиркВркмрк░ 1 рк╕рк╛ркерлЗркирк╛ ркжркХрлНрк╖рк┐ркгрк╛рк╡рк░рлНркдрлА ркдрлАрк░
тЦ╢	ркЪрк▓рк╛рк╡рлЛ, ркЪрк▓рк╛рк╡рлЛ ркмркЯрки, ркЬркоркгрлБркВ, ркдрлАрк░, ркдрлНрк░рк┐ркХрлЛркг
тПй	ркЬркоркгрлБркВ, ркбркмрк▓ ркЬркоркгрк╛ркВ ркдрлАрк░, ркдрлАрк░, рклрк╛рк╕рлНркЯ рклрлЛрк░рк╡рк░рлНркб ркХрк░рлЛ, рклрк╛рк╕рлНркЯ рклрлЛрк░рк╡рк░рлНркб ркХрк░рлЛ ркмркЯрки
тПн	ркЖркЧрк▓рлБркВ ркжрлГрк╢рлНркп, ркЖркЧрк▓рлЛ ркЯрлНрк░рлЗркХ, ркЖркЧрк▓рлЛ ркЯрлНрк░рлЗркХ ркмркЯрки, ркдрлНрк░рк┐ркХрлЛркг
тПп	ркЪрк▓рк╛рк╡рлЛ ркЕркерк╡рк╛ ркерлЛркнрк╛рк╡рлЛ ркмркЯрки, ркЬркоркгрлБркВ, ркдрлАрк░, ркдрлНрк░рк┐ркХрлЛркг
тЧА	ркбрк╛ркмрлБркВ, ркдрлАрк░, ркдрлНрк░рк┐ркХрлЛркг, рккрк▓ркЯрк╛рк╡рлЛ, рк░рк┐рк╡рк░рлНрк╕ ркХрк░рлЛ ркмркЯрки
тПк	ркбркмрк▓ ркбрк╛ркмрк╛ ркдрлАрк░, ркбрк╛ркмрлБркВ, ркдрлАрк░, рклрк╛рк╕рлНркЯ рк░рк┐рк╡рк░рлНрк╕ ркХрк░рлЛ ркмркЯрки, рк░рк┐рк╡рк╛ркЗркирлНркб ркХрк░рлЛ
тПо	ркЫрлЗрк▓рлНрк▓рлЛ ркЯрлНрк░рлЗркХ ркмркЯрки, ркдрлАрк░, ркдрлНрк░рк┐ркХрлЛркг, рккрк╣рлЗрк▓рк╛ркирлЛ ркЯрлНрк░рлЗркХ, рккрк╛ркЫрк▓рлБркВ ркжрлГрк╢рлНркп
ЁЯФ╝	ркЙрккрк░ ркдрлНрк░рк┐ркХрлЛркг, ркЙрккрк░ ркдрлНрк░рк┐ркХрлЛркг ркмркЯрки, ркЙрккрк░ ркмркЯрки, ркдрлНрк░рк┐ркХрлЛркг, ркмркЯрки
тПл	ркЙрккрк░, ркЙрккрк░ркирлБркВ ркдрлАрк░, ркбркмрк▓ ркЙрккрк▓рк╛ ркдрлАрк░, ркдрлАрк░, ркмрлЗ ркЙрккрк░ ркдрлАрк░ рк╕рк╛ркерлЗркирлБркВ ркмркЯрки
ЁЯФ╜	ркдрлНрк░рк┐ркХрлЛркг, ркирлАркЪрлЗ ркдрлНрк░рк┐ркХрлЛркг, ркирлАркЪрлЗ ркдрлНрк░рк┐ркХрлЛркг ркмркЯрки, ркирлАркЪрлЗ ркмркЯрки, ркмркЯрки
тПм	ркбркмрк▓ ркирлАркЪрк▓рк╛ ркдрлАрк░, ркдрлАрк░, ркирлАркЪрлЗ, ркирлАркЪрлЗркирлБркВ ркдрлАрк░, ркмрлЗ ркирлАркЪрлЗ ркдрлАрк░ рк╕рк╛ркерлЗркирлБркВ ркмркЯрки
ЁЯОж	ркорлВрк╡рлА, ркорлВрк╡рлА ркЪрк┐рк╣рлНрки, рк╕рк┐ркирлЗркорк╛
ЁЯФЕ	ркУркЫрлА, ркУркЫрлА ркЪркоркХркирлБркВ ркЪрк┐рк╣рлНрки, ркУркЫрлА ркЪркоркХркирлБркВ ркмркЯрки, ркЪркоркХ, ркоркВркж
ЁЯФЖ	ркЪркоркХ, ркдрлЗркЬрк╕рлНрк╡рлА, рк╡ркзрлБ ркЪркоркХ, рк╡ркзрлБ ркЪркоркХркирлБркВ ркЪрк┐рк╣рлНрки, рк╡ркзрлБ ркЪркоркХркирлБркВ ркмркЯрки
ЁЯУ╢	ркПркирлНркЯрлЗркирк╛, ркПркирлНркЯрлЗркирк╛ ркмрк╛рк░рлНрк╕, рклрлЛрки, ркорлЛркмрк╛ркЗрк▓, ркорлЛркмрк╛ркЗрк▓ рк╕рк┐ркЧрлНркирк▓рлНрк╕, рк╕рк┐ркЧрлНркирк▓
ЁЯУ│	рклрлЛрки, ркорлЛркб, ркорлЛркмрк╛ркЗрк▓, рк╡рк╛ркЗркмрлНрк░рлЗрк╢рки ркорлЛркб, рк╕рлЗрк▓ рклрлЛрки
ЁЯУ┤	рклрлЛрки, ркмркВркз, ркорлЛркмрк╛ркЗрк▓, ркорлЛркмрк╛ркЗрк▓ рклрлЛрки ркмркВркз, рк╕рлЗрк▓ рклрлЛрки, рк╕рлЗрк▓ рклрлЛрки ркмркВркз
тЪЬ	рклрлНрк▓рлЗркЙрк░-ркжрлЗ-рк▓рк┐рк╕
ЁЯФ▒	ркПркВркХрк░, ркдрлНрк░рк┐рк╢рлВрк│, ркдрлНрк░рк┐рк╢рлВрк│ркирлБркВ ркЪрк┐рк╣рлНрки, рк╕ркВркЬрлНркЮрк╛
ЁЯУЫ	ркирк╛рко, ркирк╛ркоркирлЛ ркмрлЗркЬ, ркмрлЗркЬ
ЁЯФ░	ркЬрк╛рккрк╛ркирлАркЭ, рккрлНрк░рк╛рк░ркВркнркХрк░рлНркдрк╛, рккрлНрк░рк╛рк░ркВркнркХрк░рлНркдрк╛ ркорк╛ркЯрлЗ ркЬрк╛рккрк╛ркирлА рккрлНрк░ркдрлАркХ, рк▓рлАрк▓рлБркВ ркЕркирлЗ рккрлАрк│рлБркВ, рк▓рлАрк▓рлБркВ ркЕркирлЗ рккрлАрк│рлБркВ рккрк╛ркВркжркбрлБ
тЬЕ	ркЪрлЗркХ, ркЪрлЗркХ ркорк╛рк░рлНркХ, рк╕рклрлЗркж ркЪрлЗркХ ркорк╛рк░рлНркХркирлБркВ ркЪрк┐рк╣рлНрки, рк╣рлЗрк╡рлА ркЪрлЗркХ ркорк╛рк░рлНркХ
тЭМ	ркХрлНрк░рлЛрк╕ркирлБркВ ркЪрк┐рк╣рлНрки, ркЪрлЛркХркбрлАркирлБркВ ркЪрк┐рк╣рлНрки, тАЬXтАЭ
тЭО	ркХрлНрк░рлЛрк╕ркирлБркВ ркЪрк┐рк╣рлНрки, ркЪрлЛркХркбрлАркирлБркВ ркмркЯрки, ркЪрлЛрк░рк╕ркорк╛ркВ тАЬXтАЭ
тЮХ	ркШрк╛ркЯрлБркВ рк╡ркдрлНркдрк╛ркирлБркВ ркЪрк┐рк╣рлНрки, ркЪрк┐рк╣рлНрки, ркнрк╛рк░рлЗ рк╡ркдрлНркдрк╛ркирлБркВ ркЪрк┐рк╣рлНрки, рк╡ркдрлНркдрк╛, рк╡ркдрлНркдрк╛ркирлБркВ ркЪрк┐рк╣рлНрки
тЮЦ	ркШрк╛ркЯрлБркВ ркмрк╛ркжркмрк╛ркХрлАркирлБркВ ркЪрк┐рк╣рлНрки, ркЪрк┐рк╣рлНрки, ркмрк╛ркжркмрк╛ркХрлА, ркмрк╛ркжркмрк╛ркХрлАркирлБркВ ркЪрк┐рк╣рлНрки, ркнрк╛рк░рлЗ ркмрк╛ркжркмрк╛ркХрлАркирлБркВ ркЪрк┐рк╣рлНрки
тЮЧ	ркШрк╛ркЯрлБркВ ркнрк╛ркЧрк╛ркХрк╛рк░ркирлБркВ ркЪрк┐рк╣рлНрки, ркЪрк┐рк╣рлНрки, ркнрк╛ркЧрк╛ркХрк╛рк░, ркнрк╛ркЧрк╛ркХрк╛рк░ркирлБркВ ркЪрк┐рк╣рлНрки, ркнрк╛рк░рлЗ ркнрк╛ркЧрк╛ркХрк╛рк░ркирлБркВ ркЪрк┐рк╣рлНрки
тЮ░	рк▓рлВркк, рк╡рк│рк╛ркВркХ, рк╡рк╛ркВркХркбрк┐ркпрлБ рк▓рлВркк
тЮ┐	ркЬрк╛рккрк╛рки, ркбркмрк▓ рк╡рк╛ркВркХркбрк┐ркпрлБркВ рк▓рлВркк, рклрлНрк░рлА ркбрк╛ркпрк▓, рк╡рк╛ркВркХркбрк┐ркпрлБ рк▓рлВркк
тЭФ	рккрлНрк░рк╢рлНрки, рккрлНрк░рк╢рлНркирк╛рк░рлНрке ркЪрк┐рк╣рлНрки, рк╕рклрлЗркж рккрлНрк░рк╢рлНркирк╛рк░рлНрке ркЪрк┐рк╣рлНрки
тЭХ	ркЙркжрлНркЧрк╛рк░рк╡рк╛ркЪркХ, ркЙркжрлНркЧрк╛рк░рк╡рк╛ркЪркХ ркЪрк┐рк╣рлНрки, рк╕рклрлЗркж ркЙркжрлНркЧрк╛рк░ ркЪрк┐рк╣рлНрки
ЁЯТп	100, 100 рккрлЛркЗркирлНркЯрлНрк╕, рккрлВрк░рлНркг рк╕рлНркХрлЛрк░, рк╕рлЛ рккрлЛркЗркирлНркЯрлНрк╕, рк╕рлНркХрлЛрк░
ЁЯФа	ркЕрккрк░ркХрлЗрк╕, ркЕрккрк░ркХрлЗрк╕ ркЕркХрлНрк╖рк░рлЛ, ркЕрккрк░ркХрлЗрк╕ рк▓рлЗркЯрк┐рки ркЗркирккрлБркЯ ркХрк░рлЛ, рк▓рлЗркЯрк┐рки
ЁЯФб	рк▓рлЗркЯрк┐рки, рк▓рлЛркЕрк░ркХрлЗрк╕, рк▓рлЛркЕрк░ркХрлЗрк╕ ркЕркХрлНрк╖рк░рлЛ, рк▓рлЛркЕрк░ркХрлЗрк╕ рк▓рлЗркЯрк┐рки ркЗркирккрлБркЯ ркХрк░рлЛ
ЁЯФв	ркиркВркмрк░рлНрк╕, ркиркВркмрк░рлНрк╕ ркЗркирккрлБркЯ ркХрк░рлЛ
ЁЯФг	рккрлНрк░ркдрлАркХрлЛ, рккрлНрк░ркдрлАркХрлЛ ркЗркирккрлБркЯ ркХрк░рлЛ
ЁЯФд	ABC, ркЕркВркЧрлНрк░рлЗркЬрлА, рк▓рлЗркЯрк┐рки, рк▓рлЗркЯрк┐рки ркорлВрк│рк╛ркХрлНрк╖рк░, рк▓рлЗркЯрк┐рки ркорлВрк│рк╛ркХрлНрк╖рк░ ркЗркирккрлБркЯ ркХрк░рлЛ
ЁЯЖО	AB, рккрлНрк░ркХрк╛рк░ AB, рк▓рлЛрк╣рлА, рк▓рлЛрк╣рлАркирлЛ рккрлНрк░ркХрк╛рк░, рк▓рлЛрк╣рлАркирлЛ рккрлНрк░ркХрк╛рк░ AB
ЁЯЖС	CL, CL ркирлБркВ ркЪрк┐рк╣рлНрки, рк╕рк╛ркл ркХрк░рлЛ
ЁЯЖТ	ркХрлВрк▓, ркХрлВрк▓ркирлБркВ ркЪрк┐рк╣рлНрки, ркаркВркбрк╛ркирлБркВ ркЪрк┐рк╣рлНрки
ЁЯЖУ	ркЪрк┐рк╣рлНрки, ркорклркд, ркорклркдркирлБркВ ркЪрк┐рк╣рлНрки, рк╢рлБрк▓рлНркХ рк░рк╣рк┐ркд
ЁЯЖФ	ID, ID ркирлБркВ ркЪрк┐рк╣рлНрки, ркУрк│ркЦ, ркУрк│ркЦркирлБркВ ркЪрк┐рк╣рлНрки, ркЪрк┐рк╣рлНрки
ЁЯЖХ	ркЪрк┐рк╣рлНрки, ркЪрлЛрк░рк╕ркорк╛ркВ ркирк╡рк╛ркирлБркВ ркЪрк┐рк╣рлНрки, ркирк╡рк╛ркирлБркВ ркЪрк┐рк╣рлНрки, ркирк╡рлБркВ
ЁЯЖЦ	NG, ркЪрк┐рк╣рлНрки, ркЪрлЛрк░рк╕ркорк╛ркВ ркарлАркХ ркирк╣рлАркВркирлБркВ ркЪрк┐рк╣рлНрки
ЁЯЖЧ	ркСркХрлЗ, ркСркХрлЗркирлБркВ ркЪрк┐рк╣рлНрки
ЁЯЖШ	SOS, SOS ркирлБркВ ркЪрк┐рк╣рлНрки, ркЪрк┐рк╣рлНрки, ркоркжркж, ркоркжркжркирлБркВ ркЪрк┐рк╣рлНрки
ЁЯЖЩ	UP! ркмркЯрки, ркЙрккрк░ркирлБркВ ркЪрк┐рк╣рлНрки, ркЪрк┐рк╣рлНрки
ЁЯЖЪ	ркЪрк┐рк╣рлНрки, рк╡рк┐., рк╡рк┐. ркирлБркВ ркЪрк┐рк╣рлНрки, рк╡рк┐рк░рлБркжрлНркз
ЁЯИБ	ркЪрлЛрк░рк╕ркорк╛ркВ ркЕрк╣рлАркВ ркорк╛ркЯрлЗркирлБркВ ркЬрк╛рккрк╛ркирлА ркЪрк┐рк╣рлНрки, ркЬрк╛рккрк╛ркирлА рк╢ркмрлНркж
ЁЯИ╖	ркЪрлЛрк░рк╕ркорк╛ркВ ркЪркВркжрлНрк░ ркорк╛ркЯрлЗ ркЬрк╛рккрк╛ркирлА ркЪрк┐рк╣рлНрки, ркЬрк╛рккрк╛ркирлА рк╢ркмрлНркж
ЁЯИ╢	ркЪрлЛрк░рк╕ркорк╛ркВ ркЕрк╕рлНркдрк┐ркдрлНрк╡ ркорк╛ркЯрлЗ ркЬрк╛рккрк╛ркирлА ркЪрк┐рк╣рлНрки, ркЬрк╛рккрк╛ркирлА рк╢ркмрлНркж
ЁЯИп	ркЪрлЛрк░рк╕ркорк╛ркВ ркЖркВркЧрк│рлА ркорк╛ркЯрлЗ ркЬрк╛рккрк╛ркирлА рк╢ркмрлНркж, ркЬрк╛рккрк╛ркирлА рк╢ркмрлНркж
ЁЯЙР	ркЧрлЛрк│ркорк╛ркВ рк▓рк╛ркн ркорк╛ркЯрлЗ ркЬрк╛рккрк╛ркирлА рк╢ркмрлНркж, ркЬрк╛рккрк╛ркирлА рк╢ркмрлНркж
ЁЯИ╣	ркЪрлЛрк░рк╕ркорк╛ркВ рк╡рк┐ркнрк╛ркЬрки ркорк╛ркЯрлЗ ркЬрк╛рккрк╛ркирлА рк╢ркмрлНркж, ркЬрк╛рккрк╛ркирлА рк╢ркмрлНркж
ЁЯИЪ	ркЪрлЛрк░рк╕ркорк╛ркВ ркирк┐рк╖рлЗркз ркорк╛ркЯрлЗ ркЬрк╛рккрк╛ркирлА рк╢ркмрлНркж, ркЬрк╛рккрк╛ркирлА "ркирк┐ркГрк╢рлБрк▓рлНркХ" ркмркЯрки, ркЬрк╛рккрк╛ркирлА рк╢ркмрлНркж
ЁЯИ▓	ркЪрлЛрк░рк╕ркорк╛ркВ ркирк┐рк╖рк┐ркжрлНркз ркорк╛ркЯрлЗ ркЬрк╛рккрк╛ркирлА рк╢ркмрлНркж, ркЪрлЛрк░рк╕ркорк╛ркВ ркирк┐рк╖рлЗркз ркорк╛ркЯрлЗ ркЬрк╛рккрк╛ркирлА рк╢ркмрлНркж, ркЬрк╛рккрк╛ркирлА "ркирк┐рк╖рлЗркз" ркмркЯрки, ркЬрк╛рккрк╛ркирлА рк╢ркмрлНркж
ЁЯЙС	ркЧрлЛрк│ркорк╛ркВ рк╕рлНрк╡рлАркХрлГркдрк┐ ркорк╛ркЯрлЗ ркЪрлАркирлА рк╢ркмрлНркж, ркЪрлАркирлА рк╢ркмрлНркж
ЁЯИ╕	ркЪрлАркирлА рк╢ркмрлНркж, ркЪрлЛрк░рк╕ркорк╛ркВ рк▓рк╛ркЧрлБ ркХрк░рлЛ ркорк╛ркЯрлЗ ркЪрлАркирлА рк╢ркмрлНркж
ЁЯИ┤	ркЪрлАркирлА рк╢ркмрлНркж, ркЪрлЛрк░рк╕ркорк╛ркВ ркПркХрк╕рк╛ркерлЗ ркорк╛ркЯрлЗ ркЪрлАркирлА рк╢ркмрлНркж
ЁЯИ│	ркЪрлАркирлА рк╢ркмрлНркж, ркЪрлЛрк░рк╕ркорк╛ркВ ркЦрк╛рк▓рлА ркорк╛ркЯрлЗ ркЪрлАркирлА рк╢ркмрлНркж
ЁЯИ║	ркЧрлЛрк│ркорк╛ркВ рк╕ркВркЪрк╛рк▓рки ркорк╛ркЯрлЗ ркЪрлАркирлА рк╢ркмрлНркж, ркЪрлАркирлА рк╢ркмрлНркж
ЁЯИ╡	ркЧрлЛрк│ркорк╛ркВ рк╕ркВрккрлВрк░рлНркгркдрк╛ ркорк╛ркЯрлЗ ркЪрлАркирлА рк╢ркмрлНркж, ркЪрлАркирлА рк╢ркмрлНркж
ЁЯФ┤	ркорлЛркЯрлБркВ рк▓рк╛рк▓ рк╡рк░рлНркдрлБрк│, ркорлЛркЯрлБркВ рк╡рк░рлНркдрлБрк│, рк▓рк╛рк▓, рк▓рк╛рк▓ ркЧрлЛрк│, рк╡рк░рлНркдрлБрк│
ЁЯФ╡	ркорлЛркЯрлБркВ рк╡рк░рлНркдрлБрк│, ркорлЛркЯрлБркВ рк╡рк╛ркжрк│рлА рк╡рк░рлНркдрлБрк│, рк╡рк░рлНркдрлБрк│, рк╡рк╛ркжрк│рлА, рк╡рк╛ркжрк│рлА ркЧрлЛрк│
ЁЯФ╢	ркирк╛рк░ркВркЧрлА, ркорлЛркЯрлЛ ркирк╛рк░ркВркЧрлА рк╣рлАрк░рлЛ, ркорлЛркЯрлЛ рк╣рлАрк░рлЛ, рк╣рлАрк░рлЛ
ЁЯФ╖	ркорлЛркЯрлЛ рк╡рк╛ркжрк│рлА рк╣рлАрк░рлЛ, ркорлЛркЯрлЛ рк╣рлАрк░рлЛ, рк╡рк╛ркжрк│рлА, рк╣рлАрк░рлЛ
ЁЯФ╕	ркирк╛ркирлЛ ркирк╛рк░ркВркЧрлА рк╣рлАрк░рлЛ, ркирк╛ркирлЛ рк╣рлАрк░рлЛ, ркирк╛рк░ркВркЧрлА, рк╣рлАрк░рлЛ
ЁЯФ╣	ркирк╛ркирлЛ рк╡рк╛ркжрк│рлА рк╣рлАрк░рлЛ, ркирк╛ркирлЛ рк╣рлАрк░рлЛ, рк╡рк╛ркжрк│рлА, рк╣рлАрк░рлЛ
ЁЯФ║	ркЙрккрк░ ркдрлНрк░рк┐ркХрлЛркг, ркЙрккрк░ рк▓рк╛рк▓ ркдрлНрк░рк┐ркХрлЛркг, ркдрлНрк░рк┐ркХрлЛркг
ЁЯФ╗	ркдрлНрк░рк┐ркХрлЛркг, ркирлАркЪрлЗ ркдрлНрк░рк┐ркХрлЛркг, ркирлАркЪрлЛ рк▓рк╛рк▓ ркдрлНрк░рк┐ркХрлЛркг
ЁЯТа	ркбрк╛ркпркоркВркб, ркбрк╛ркпркоркВркб ркЖркХрк╛рк░, рккрлБрк╖рлНркк, рккрлБрк╖рлНрккркирлА рккрк╛ркВркЦркбрлА, рк▓рк╛ркЧркгрлА, рк╕рлБркВркжрк░
ЁЯФШ	ркмркЯрки, рк░рлЗркбрк┐ркУ, рк░рлЗркбрк┐ркУ ркмркЯрки
ЁЯФ▓	ркХрк╛рк│рлЛ ркЪрлЛрк░рк╕ ркмркЯрки, ркЪрлЛрк░рк╕, ркмркЯрки
ЁЯФ│	ркЪрлЛрк░рк╕, ркмркЯрки, рк╕рклрлЗркж ркЪрлЛрк░рк╕ ркмркЯрки
ЁЯПБ	ркЦрлЗрк▓ ркХрлВркж, ркЪрлЛркХркбрлАрк╡рк╛рк│рлЛ, ркЪрлЛркХркбрлАрк╡рк╛рк│рлЛ ркзрлНрк╡ркЬ, ркзрлНрк╡ркЬ, рк╣рк░рлАрклрк╛ркИ
ЁЯЪй	ркдрлНрк░рк┐ркХрлЛркг ркзрлНрк╡ркЬ, ркдрлНрк░рк┐ркХрлЛркг рк╕рлНркерк╛рки ркзрлНрк╡ркЬ, ркдрлНрк░рк┐ркХрлЛркгрк╛ркХрк╛рк░ ркзрлНрк╡ркЬ, ркзрлНрк╡ркЬ, рк╕рлНркерк╛рки
ЁЯОМ	ркЙркЬрк╡ркгрлА, ркЪрлЛркХркбрлАрк╡рк╛рк│рк╛ ркзрлНрк╡ркЬ, ркЪрлЛркХркбрлАрк╡рк╛рк│рлЛ, ркЬрк╛рккрк╛ркиркирлЛ ркЪрлЛркХркбрлАрк╡рк╛рк│рлЛ ркзрлНрк╡ркЬ, ркзрлНрк╡ркЬ
ЁЯП┤	рк▓рк╣рлЗрк░ркдрлЛ ркХрк╛рк│рлЛ ркЭркВркбрлЛ, рк▓рк╣рлЗрк░рк╡рлБркВ
ЁЯП│тАНЁЯМИ	ркЭркВркбрлЛ, рк╕рккрлНркдрк░ркВркЧрлА, рк╕рккрлНркдрк░ркВркЧрлА ркЭркВркбрлЛ
ЁЯП┤тАНтШа	ркЦркЬрк╛ркирлЛ, ркЪрк╛ркВркЪрк┐ркпрлЛ, ркЬрлЛрк▓рлА рк░рлЛркЬрк░, рккрк╛ркЗрк░рлЗркЯ ркзрлНрк╡ркЬ, рк▓рлВркВркЯ
┬йя╕П	ркХрлЙрккрк┐рк░рк╛ркЗркЯ, ркХрлЙрккрк┐рк░рк╛ркЗркЯркирлБркВ ркЪрк┐рк╣рлНрки
┬оя╕П	ркирлЛркВркзрк╛ркпрлЗрк▓, ркирлЛркВркзрк╛ркпрлЗрк▓ркирлБркВ ркЪрк┐рк╣рлНрки
тА╝я╕П	ркЪрк┐рк╣рлНрки, ркмрлЗ ркЙркжрлНркЧрк╛рк░ ркЪрк┐рк╣рлНрки, рк╡рк┐рк░рк╛ркоркЪрк┐рк╣рлНрки
тБЙя╕П	ркЙркжрлНркЧрк╛рк░ рккрлНрк░рк╢рлНркирк╛рк░рлНрке ркЪрк┐рк╣рлНрки, рккрлНрк░рк╢рлНрки, рк╡рк┐рк░рк╛ркоркЪрк┐рк╣рлНрки
тДвя╕П	ркЪрк┐рк╣рлНрки, ркЯрлНрк░рлЗркб ркорк╛рк░рлНркХ, ркЯрлНрк░рлЗркб ркорк╛рк░рлНркХркирлБркВ ркЪрк┐рк╣рлНрки
тД╣я╕П	ркЖркЗ, ркорк╛рк╣рк┐ркдрлА, ркорк╛рк╣рк┐ркдрлАркирлЛ рк╕рлНрк░рлЛркд
тЖФя╕П	ркбрк╛ркмрлБркВ-ркЬркоркгрлБркВ ркдрлАрк░, ркдрлАрк░
тЖХя╕П	ркЙрккрк░-ркирлАркЪрлЗ ркдрлАрк░, ркдрлАрк░
тЖЦя╕П	ркЙрккрк░-ркбрк╛ркмрлБркВ ркдрлАрк░, рккрлВрк░рлНрк╡рккрк╢рлНркЪрк┐рко
тЖЧя╕П	ркЙркдрлНркдрк░рккрлВрк░рлНрк╡, ркЙрккрк░-ркЬркоркгрлБркВ ркдрлАрк░, ркдрлАрк░, ркжрк┐рк╢рк╛
тЖШя╕П	ркдрлАрк░, ркжркХрлНрк╖рк┐ркгрккрлВрк░рлНрк╡, ркжрк┐рк╢рк╛, ркирлАркЪрлЗ-ркЬркоркгрлБркВ ркдрлАрк░
тЖЩя╕П	ркдрлАрк░, ркжркХрлНрк╖рк┐ркгрккрк╢рлНркЪрк┐рко, ркирлАркЪрлЗ-ркбрк╛ркмрлБркВ ркдрлАрк░
тЖйя╕П	ркбрк╛ркмрлЗ рк╡рк│ркдрлБркВ ркЬркоркгрлБркВ ркдрлАрк░, ркдрлАрк░
тЖкя╕П	ркЬркоркгрлЗ рк╡рк│ркдрлБркВ ркбрк╛ркмрлБркВ ркдрлАрк░, ркдрлАрк░
тМЪя╕П	ркХрк╛ркВркбрк╛ ркШркбрк┐ркпрк╛рк│, ркШркбрк┐ркпрк╛рк│, рк╕ркоркп
тМЫя╕П	рк░рлЗркдркШркбрлА, рк░рлЗркдрлА, рк╕ркоркп
тМия╕П	ркХркорлНрккрлНркпрлБркЯрк░, ркХрлАркмрлЛрк░рлНркб
тППя╕П	ркХрк╛ркврлА ркирк╛ркВркЦрлЛ, ркХрк╛ркврлА ркирк╛ркВркЦрлЛ ркмркЯрки
тП▒я╕П	ркШркбрк┐ркпрк╛рк│, рк╕ркоркп, рк╕рлНркЯрлЛрккрк╡рлЙркЪ
тП▓я╕П	ркШркбрк┐ркпрк╛рк│, ркЯрк╛ркЗркорк░, ркЯрк╛ркЗркорк░ ркШркбрк┐ркпрк╛рк│, рк╕ркоркп
тП│я╕П	ркЕрк╡рк░ркЧрлНрк▓рк╛рк╕, ркЯрк╛ркЗркорк░, рк░рлЗркдркШркбрлА, рк╡рк╣рлЗркдрлА рк░рлЗркдрлА рк╕рк╛ркерлЗркирлА рк░рлЗркдркШркбрлА, рк╕рлЗркирлНркб ркЯрк╛ркЗркорк░
тП╕я╕П	ркКркнрлА, ркерлЛркнрк╛рк╡рлЛ, ркерлЛркнрк╛рк╡рлЛ ркмркЯрки, рккркЯрлНркЯрлА
тП╣я╕П	ркЪрлЛрк░рк╕, рк░рлЛркХрлЛ, рк░рлЛркХрлЛ ркмркЯрки
тП║я╕П	ркЧрлЛрк│, рк░рлЗркХрлЛрк░рлНркб ркХрк░рлЛ, рк░рлЗркХрлЛрк░рлНркб ркХрк░рлЛ ркмркЯрки
тУВя╕П	ркПрко, ркЧрлЛрк│, ркЧрлЛрк│ркорк╛ркВ ркЕркХрлНрк╖рк░ ркПрко
тЦкя╕П	ркХрк╛рк│рлЛ ркирк╛ркирлЛ ркЪрлЛрк░рк╕, ркЪрлЛрк░рк╕, ркнрлМркорк┐ркдрк┐ркХ
тЦля╕П	ркЪрлЛрк░рк╕, ркнрлМркорк┐ркдрк┐ркХ, рк╕рклрлЗркж ркирк╛ркирлЛ ркЪрлЛрк░рк╕
тЧ╗я╕П	ркЪрлЛрк░рк╕, ркнрлМркорк┐ркдрк┐ркХ, рк╕рклрлЗркж ркоркзрлНркпрко ркЪрлЛрк░рк╕
тЧ╝я╕П	ркХрк╛рк│рлЛ ркоркзрлНркпрко ркЪрлЛрк░рк╕, ркЪрлЛрк░рк╕, ркнрлМркорк┐ркдрк┐ркХ
тЧ╜я╕П	ркЪрлЛрк░рк╕, ркнрлМркорк┐ркдрк┐ркХ, рк╕рклрлЗркж ркоркзрлНркпрко-ркирк╛ркирлЛ ркЪрлЛрк░рк╕
тЧ╛я╕П	ркХрк╛рк│рлЛ ркоркзрлНркпрко-ркирк╛ркирлЛ ркЪрлЛрк░рк╕, ркЪрлЛрк░рк╕, ркнрлМркорк┐ркдрк┐ркХ
тШАя╕П	ркЕрк╡ркХрк╛рк╢, ркХрк┐рк░ркгрлЛ, рк╕рлВрк░рлНркп, рк╕рлВрк░рлНркпрккрлНрк░ркХрк╛рк╢, рк╣рк╡рк╛ркорк╛рки
тШБя╕П	рк╡рк╛ркжрк│, рк╣рк╡рк╛ркорк╛рки
тШВя╕П	ркЫркдрлНрк░рлА, рк╡рк░рк╕рк╛ркж, рк╣рк╡рк╛ркорк╛рки
тШГя╕П	ркмрк░ркл, рк╣рк╡рк╛ркорк╛рки, рк╣рк┐рко, рк╣рк┐ркоркорк╛ркирк╡
тШДя╕П	ркЕрк╡ркХрк╛рк╢, ркзрлВркоркХрлЗркдрлБ, рккрлВркВркЫркбрк┐ркпрлЛ ркдрк╛рк░рлЛ, рк╕рлНрккрлЗрк╕
тШОя╕П	ркЯрлЗрк▓рк┐рклрлЛрки, рклрлЛрки
тШСя╕П	ркЪрлЗркХ, ркЪрлЗркХ рк╕рк╛ркерлЗ ркоркд рккркдрлНрк░ркирлБркВ ркЪрк┐рк╣рлНрки, рккрлЗркЯрк╛, ркмрлЛркХрлНрк╕, ркоркд
тШФя╕П	ркЫркдрлНрк░рлА, рк╡рк░рк╕рк╛ркж, рк╡рк░рк╕рк╛ркжркирк╛ ркЯрк┐рккрк╛ рк╕рк╛ркерлЗ ркЫркдрлНрк░рлА, рк╣рк╡рк╛ркорк╛рки
тШХя╕П	ркЙркХрк│ркдрлБркВ, ркХрлЙрклрлА, ркЧрк░рко, ркЧрк░рко рккрлАркгрлБркВ, ркЪрк╛, рккрлЗркп
тШШя╕П	ркЫрлЛркб, ркдрлНрк░ркг рккрк░рлНркг, ркдрлНрк░рк┐ркжрк▓ рккрк╛ркВркжркбрк╛рк╡рк╛рк│рлЛ ркПркХ ркЫрлЛркб
тШЭя╕П	ркЖркВркЧрк│рлА, ркЙрккрк░, ркЙрккрк░ ркЪрлАркВркзркдрлА ркдрк░рлНркЬркирлА, ркЪрлАркВркзркдрлА, рккрлНрк░ркерко ркЖркВркЧрк│рлА, рк╢рк░рлАрк░, рк╣рк╛рке
тШая╕П	ркЦрлЛрккрк░рлА ркЕркирлЗ рк╣рк╛ркбркХрк╛ркВркирлА ркЪрлЛркХркбрлА, ркЪрк╣рлЗрк░рлЛ, ркжрлИркдрлНркп, ркорлБркЦ, ркорлГркдрлНркпрлБ, рк░рк╛ркХрлНрк╖рк╕, рк╢рк░рлАрк░
тШвя╕П	рк░рлЗркбрк┐ркУркНркХрлНркЯрк┐рк╡, рк╕ркВркХрлЗркд
тШгя╕П	ркмрк╛ркпрлЛрк╣рлЗркЭрк╛рк░рлНркб, рк╕ркВркХрлЗркд
тШжя╕П	ркСрк░рлНркерлЛркбрлЛркХрлНрк╕ ркХрлНрк░рлЛрк╕, ркХрлНрк░рлЛрк╕, ркзрк░рлНрко
тШкя╕П	ркЗрк╕рлНрк▓рк╛рко, ркЪрк╛ркВркж ркЕркирлЗ ркдрк╛рк░рлЛ, ркзрк░рлНрко, ркорлБрк╕рлНрк▓рк┐рко
тШоя╕П	рк╢рк╛ркВркдрк┐, рк╢рк╛ркВркдрк┐ркирлБркВ рккрлНрк░ркдрлАркХ
тШпя╕П	ркдрк╛ркУ, ркзрк░рлНрко, ркпрк╛ркВркЧ, ркпрк┐рки, ркпрк┐рки ркпрк╛ркВркЧ
тШ╕я╕П	ркЪркХрлНрк░, ркзрк░рлНрко, ркзрк░рлНрко ркЪркХрлНрк░, ркмрлМркжрлНркз
тШ╣я╕П	ркЧркоркЧрлАрки, ркЧркоркЧрлАрки ркЪрк╣рлЗрк░рлЛ, ркЪрк╣рлЗрк░рлЛ, ркорлБркЦ
тШ║я╕П	ркЪрк╣рлЗрк░рлЛ, ркмрк┐рки-ркнрк░рлЗрк▓рлЛ рк╕рлНркорк╛ркЗрк▓рлА ркЪрк╣рлЗрк░рлЛ, ркорлБркЦ, рк╕рлНркорк╛ркЗрк▓рлА, рк╣рк╕ркдрлЛ ркЪрк╣рлЗрк░рлЛ
тЩАя╕П	ркорк╣рк┐рк▓рк╛, рк╕рлНркдрлНрк░рлА, рк╕рлНркдрлНрк░рлА ркЪрк┐рк╣рлНрки
тЩВя╕П	рккрлБрк░рлБрк╖, рккрлБрк░рлБрк╖ ркЪрк┐рк╣рлНрки
тЩИя╕П	ркорлЗрк╖, рк░рк╛рк╢рк┐ркЪркХрлНрк░
тЩЙя╕П	рк░рк╛рк╢рк┐ркЪркХрлНрк░, рк╡рлГрк╖ркн
тЩКя╕П	ркорк┐ркерлБрки, рк░рк╛рк╢рк┐ркЪркХрлНрк░
тЩЛя╕П	ркХрк░рлНркХ, рк░рк╛рк╢рк┐ркЪркХрлНрк░
тЩМя╕П	рк░рк╛рк╢рк┐ркЪркХрлНрк░, рк╕рк┐ркВрк╣
тЩНя╕П	ркХркирлНркпрк╛, рк░рк╛рк╢рк┐ркЪркХрлНрк░
тЩОя╕П	ркдрлБрк▓рк╛, рк░рк╛рк╢рк┐ркЪркХрлНрк░
тЩПя╕П	рк░рк╛рк╢рк┐ркЪркХрлНрк░, рк╡рлГрк╢рлНркЪрк┐ркХ, рк╕рлНркХрлЛрк░рлНрккрк┐ркЕрк╕
тЩРя╕П	ркзркирлБ, рк░рк╛рк╢рк┐ркЪркХрлНрк░
тЩСя╕П	ркоркХрк░, рк░рк╛рк╢рк┐ркЪркХрлНрк░
тЩТя╕П	ркХрлБркВркн, рк░рк╛рк╢рк┐ркЪркХрлНрк░
тЩУя╕П	ркорлАрки, рк░рк╛рк╢рк┐ркЪркХрлНрк░
тЩЯя╕П	ркЪрлЗрк╕, ркЪрлЗрк╕ркирлБркВ рккрлНркпрк╛ркжрлБ, ркбрлНркпрлВркк, рккрлНрк░рк╛ркпрлЛркЬрлНркп
тЩая╕П	ркХрк╛рк░рлНркб, ркХрк╛рк│рлА, ркХрк╛рк│рлАркирлБркВ рккркдрлНркдрлБркВ, рккркдрлНркдрлБркВ, рк░ркоркд
тЩгя╕П	ркХрк╛рк░рлНркб, рклрлБрк▓рлЗрк╡рк░, рклрлБрк▓рлЗрк╡рк░ркирлБркВ рккркдрлНркдрлБркВ, рк░ркоркд
тЩея╕П	ркХрк╛рк░рлНркб, рккркдрлНркдрлБркВ, рк░ркоркд, рк▓рк╛рк▓, рк▓рк╛рк▓ркирлБркВ рккркдрлНркдрлБркВ
тЩжя╕П	ркХрк╛рк░рлНркб, ркЪрлЛркХркЯ, ркЪрлЛркХркЯркирлБркВ рккркдрлНркдрлБркВ, рккркдрлНркдрлБркВ, рк░ркоркд
тЩия╕П	ркЙркХрк│ркдрк╛ркВ, ркЧрк░рко, ркЧрк░рко рккрк╛ркгрлАркирк╛ ркЭрк░рк╛, ркЭрк░рк╛, рк╡рк░рк╛рк│ ркирлАркХрк│ркдрк╛ркВ
тЩ╗я╕П	ркЪрк┐рк╣рлНрки, ркиркХрлНркХрк░ рк╕рк╛рк░рлНрк╡ркдрлНрк░рк┐ркХ рк░рк┐рк╕рк╛ркпркХрлНрк▓рк┐ркВркЧркирлБркВ рккрлНрк░ркдрлАркХ, рк░рк┐рк╕рк╛ркпркХрлНрк▓рк┐ркВркЧ, рк░рк┐рк╕рк╛ркпркХрлНрк▓рк┐ркВркЧркирлБркВ рккрлНрк░ркдрлАркХ, рк╕рк╛рк░рлНрк╡ркдрлНрк░рк┐ркХ
тЩ╛я╕П	ркЕркорк░, ркЕрк╕рлАрко, ркХрк╛ркпрко, рк╕рк╛рк░рлНрк╡ркдрлНрк░рк┐ркХ
тЩ┐я╕П	ркЕтАНрлЕркХрлНрк╕рлЗрк╕, ркЪрк┐рк╣рлНрки, рк╡рлНрк╣рлАрк▓ркЪрлЗрк░, рк╡рлНрк╣рлАрк▓ркЪрлЗрк░ркирлБркВ рккрлНрк░ркдрлАркХ
тЪТя╕П	ркдрк┐ркХрко, рк╕рк╛ркзрки, рк╣ркерлЛркбрлА, рк╣ркерлЛркбрлА ркЕркирлЗ ркдрк┐ркХрко
тЪУя╕П	ркПркВркХрк░, ркЪрк┐рк╣рлНрки
тЪФя╕П	ркХрлНрк░рлЛрк╕ ркмркирк╛рк╡ркдрлА ркдрк▓рк╡рк╛рк░рлЛ, рк╣ркерк┐ркпрк╛рк░
тЪХя╕П	ркжрк╡рк╛, ркорлЗркбрк┐ркХрк▓ рк╕рк┐ркорлНркмрк▓, рк╕рлНркЯрк╛ркл
тЪЦя╕П	ркдрк░рк╛ркЬрлБ, ркдрлБрк▓рк╛, ркирлНркпрк╛ркп, ркорк╛ркк, рк░рк╛рк╢рк┐, рк╡ркЬрки
тЪЧя╕П	ркЕрк▓рлЗркорлНркмрк┐ркХ, рк╡рк░рк╛рк│ ркарк╛рк░рлАркирлЗ рккрлНрк░рк╡рк╛рк╣рлА рк╢рлБркжрлНркз ркХрк░рк╡рк╛ркирлБркВ рк╕рк╛ркзрки
тЪЩя╕П	ркЧрк┐ркпрк░, рк╕рк╛ркзрки
тЪЫя╕П	ркЕркгрлБ, ркЕркгрлБркирлБркВ рккрлНрк░ркдрлАркХ
тЪая╕П	ркЪрк┐рк╣рлНрки, ркЪрлЗркдрк╡ркгрлА, ркЪрлЗркдрк╡ркгрлАркирлБркВ ркЪрк┐рк╣рлНрки
тЪбя╕П	ркЪрк┐рк╣рлНрки, ркнркп, рк╡рлЙрк▓рлНркЯрлЗркЬ, рк╣рк╛ркЗ рк╡рлЙрк▓рлНркЯрлЗркЬ, рк╣рк╛ркЗ рк╡рлЙрк▓рлНркЯрлЗркЬ ркЬрлЛркЦрко, рк╣рк╛ркЗ рк╡рлЙрк▓рлНркЯрлЗркЬркирлБркВ ркЪрк┐рк╣рлНрки
тЪкя╕П	ркЧрлЛрк│, ркнрлМркорк┐ркдрк┐ркХ, рк╕рклрлЗркж ркЧрлЛрк│
тЪля╕П	ркХрк╛рк│рлБркВ ркЧрлЛрк│, ркЧрлЛрк│, ркнрлМркорк┐ркдрк┐ркХ
тЪ░я╕П	ркХрлЙрклрк┐рки, ркорлГркдрлНркпрлБ
тЪ▒я╕П	ркЕркВркдрк┐ркоркпрк╛ркдрлНрк░рк╛, ркЕрк╕рлНркерк┐ ркХрк│рк╢
тЪ╜я╕П	ркмрлЙрк▓, рк╕рлЙркХрк░, рк╕рлЙркХрк░ ркмрлЙрк▓
тЪ╛я╕П	ркмрлЗркЭркмрлЛрк▓, ркмрлЗрк╕ркмрлЙрк▓
тЫДя╕П	ркмрк░ркл рк╡ркЧрк░ркирлЛ рк╣рк┐ркоркорк╛ркирк╡, рк╣рк┐рко, рк╣рк┐рко рк╡рк┐ркирк╛ркирлЛ рк╣рк┐ркоркорк╛ркирк╡, рк╣рк┐ркоркорк╛ркирк╡
тЫЕя╕П	рк╡рк╛ркжрк│, рк╡рк╛ркжрк│ рккрк╛ркЫрк│ркирлЛ рк╕рлВрк░рлНркп, рк╡рк╛ркжрк│рлЛ рк╕рк╛ркерлЗ рк╕рлВрк░рлНркп, рк╕рлВрк░рлНркп
тЫИя╕П	ркорлЗркШркЧрк░рлНркЬркирк╛, рк╡рк░рк╕рк╛ркж, рк╡рк╛ркжрк│, рк╡рлАркЬрк│рлАркирк╛ ркЪркоркХрк╛рк░рк╛ ркЕркирлЗ рк╡рк░рк╕рк╛ркж рк╕рк╛ркерлЗркирлБркВ рк╡рк╛ркжрк│, рк╡рлАркЬрк│рлАркирлЛ ркХркбрк╛ркХрлЛ, рк╣рк╡рк╛ркорк╛рки
тЫПя╕П	ркЦркирки, ркдрлАркХрко, рк╕рк╛ркзрки
тЫСя╕П	ркХрлНрк░рлЛрк╕, ркЪрк╣рлЗрк░рлЛ, ркЯрлЛрккрлА, ркоркжркж, ркорлБркЦ, рк╕рклрлЗркж ркХрлНрк░рлЛрк╕ рк╕рк╛ркерлЗркирлА рк╣рлЗрк▓рлНркорлЗркЯ, рк╕рк╣рк╛ркп, рк╣рлЗрк▓рлНркорлЗркЯ
тЫУя╕П	рк╕рк╛ркВркХрк│
тЫФя╕П	ркЪрк┐рк╣рлНрки, ркирк╣рлАркВ, ркирк┐рк╖рлЗркз, рккрлНрк░рк╡рлЗрк╢ ркирк┐рк╖рлЗркз, рккрлНрк░рк╡рлЗрк╢ ркирк┐рк╖рлЗркзркирлБркВ ркЪрк┐рк╣рлНрки
тЫйя╕П	ркЬрк╛рккрк╛ркирлА ркзрк░рлНркорк╕рлНркерк│, ркзрк░рлНрко, рк╢рк┐ркВркЯрлЛ рк╢рлНрк░рк╛ркЗрки
тЫкя╕П	ркЪрк░рлНркЪ, ркнрк╡рки
тЫ░я╕П	рккрк░рлНрк╡ркд, рккрк╣рк╛ркб
тЫ▒я╕П	ркЫркдрлНрк░рлА, ркзрк░ркдрлА рккрк░ ркЫркдрлНрк░рлА, рк╕рлВрк░рлНркп, рк╣рк╡рк╛ркорк╛рки
тЫ▓я╕П	рклрлБрк╡рк╛рк░рлЛ
тЫ│я╕П	ркЦрк╛ркбрк╛ркорк╛ркВ ркзрлНрк╡ркЬ, ркЦрк╛ркбрлЛ, ркЧрлЛрк▓рлНркл, ркЧрлЛрк▓рлНркл ркзрлНрк╡ркЬ
тЫ┤я╕П	ркирк╛рк╡ркбрлА, рклрлЗрк░рлА, ркмрлЛркЯ, рк╣рлЛркбрлА
тЫ╡я╕П	ркпрк╛ркЪ, рк░рк┐рк╕рлЙрк░рлНркЯ, рк╕ркврк╡рк╛рк│рлА рк╣рлЛркбрлА, рк╕ркорлБркжрлНрк░рлА рк░рк┐рк╕рлЙрк░рлНркЯ, рк╣рлЛркбрлА
тЫ╖я╕П	ркмрк░ркл, рк╕рлНркХрлА, рк╕рлНркХрлА ркЦрлЗрк▓рк╛ркбрлА
тЫ╕я╕П	ркЖркЗрк╕ рк╕рлНркХрлЗркЯ, ркмрк░ркл рккрк░ рк╕рлНркХрлЗркЯрк┐ркВркЧ, рк╕рлНркХрлЗркЯ
тЫ╣я╕П	ркжркбрлЛ, ркмрлЛрк▓, ркмрлЛрк▓ рк╕рк╛ркерлЗркирлА рк╡рлНркпркХрлНркдрк┐
тЫ║я╕П	ркХрлЗркорлНрккрк┐ркВркЧ, ркдркВркмрлБ
тЫ╜я╕П	ркЧрлЗрк╕, рклрлНркпрлБркЕрк▓, рклрлНркпрлБркЕрк▓ рккркорлНркк, рк╕рлНркЯрлЗрк╢рки
тЬВя╕П	ркХрк╛ркдрк░, рк╕рк╛ркзрки
тЬИя╕П	ркПрк░рккрлНрк▓рлЗрки, рк╡рк┐ркорк╛рки, рк╣рк╡рк╛ркИ рк╡рк╛рк╣рки
тЬЙя╕П	ркЗркорлЗркЗрк▓, рккрк░ркмрлАркбрк┐ркпрлБркВ
тЬМя╕П	ркХрк╛ркдрк░, рк╡рк┐ркЬркп, рк╡рк┐ркЬркпркирлБркВ ркЪрк┐рк╣рлНрки, рк╡рк┐ркЬркпрлА рк╣рк╛рке
тЬНя╕П	рк▓ркЦркдрлЛ, рк▓ркЦрк╡рлБркВ, рк▓ркЦрк╛ркг, рк▓ркЦрлА рк░рк╣рлЗрк▓рлЛ рк╣рк╛рке, рк╢рк░рлАрк░, рк╣рк╛рке
тЬПя╕П	рккрлЕркирлНрк╕рк┐рк▓
тЬТя╕П	ркирк┐ркм, рккрлЕрки, ркмрлНрк▓рлЗркХ ркирк┐ркм
тЬФя╕П	ркШрк╛ркЯрлБркВ ркЪрлЗркХ ркорк╛рк░рлНркХркирлБркВ ркЪрк┐рк╣рлНрки, ркЪрк┐рк╣рлНрки, ркЪрлЗркХ
тЬЦя╕П	ркЧрлБркгрк╛ркХрк╛рк░, ркШрк╛ркЯрлБркВ ркЧрлБркгрк╛ркХрк╛рк░ x ркирлБркВ ркЪрк┐рк╣рлНрки, рк░ркж ркХрк░рлЛ
тЬЭя╕П	ркХрлНрк░рлЛрк╕, ркЦрлНрк░рк┐рк╕рлНркдрлА, ркзрк░рлНрко, рк▓рлЗркЯрк┐рки ркХрлНрк░рлЛрк╕
тЬбя╕П	ркбрлЗрк╡рк┐ркб, ркбрлЗрк╡рк┐ркбркирлЛ ркдрк╛рк░рлЛ, ркдрк╛рк░рлЛ, ркзрк░рлНрко, ркпрк╣рлЛркжрлА
тЬ│я╕П	ркЖрка ркХрк┐ркирк╛рк░рлАрк╡рк╛рк│рлБркВ ркдрк╛рк░рк╛ркирлБркВ ркЪрк┐рк╣рлНрки, ркдрк╛рк░рлЛ
тЬ┤я╕П	ркЖрка ркХрк┐ркирк╛рк░рлАрк╡рк╛рк│рлЛ ркдрк╛рк░рлЛ, ркдрк╛рк░рлЛ
тЭДя╕П	ркаркВркбрлБркВ, ркмрк░ркл, рк╡рк░рк╕ркдрк╛ ркмрк░рклркирлЛ рккрк╛ркдрк│рлЛ ркЯрлБркХркбрлЛ, рк╢рлАркд, рк╕рлНркирлЛ рклрлНрк▓рлЕркХ, рк╣рк┐рко
тЭЗя╕П	ркЪркоркХ, рк╕рлНрккрк╛рк░рлНркХрк▓
тЭУя╕П	рккрлНрк░рк╢рлНрки, рккрлНрк░рк╢рлНркирк╛рк░рлНрке ркЪрк┐рк╣рлНрки
тЭЧя╕П	ркЙркжрлНркЧрк╛рк░ ркЪрк┐рк╣рлНрки, рк╡рк┐рк░рк╛ркоркЪрк┐рк╣рлНрки
тЭгя╕П	ркЙркжрлНркЧрк╛рк░рк╡рк╛ркЪркХ, ркЙркжрлНркЧрк╛рк░рк╡рк╛ркЪркХ ркЪрк┐рк╣рлНрки рк╕рк╛ркерлЗркирлБркВ рк╣рлГркжркп, ркЪрк┐рк╣рлНрки, рк╡рк┐рк░рк╛ркоркЪрк┐рк╣рлНрки, рк╣рлГркжркп
тЭдя╕П	рк▓рк╛рк▓, рк▓рк╛рк▓ рк╣рлГркжркп, рк╣рлГркжркп
тЮбя╕П	ркЬркоркгрлБркВ ркдрлАрк░, ркдрлАрк░, ркжрк┐рк╢рк╛, рккрлВрк░рлНрк╡
тд┤я╕П	ркЙрккрк░ рк╡рк│ркдрлБркВ ркЬркоркгрлБркВ ркдрлАрк░, ркдрлАрк░
тд╡я╕П	ркдрлАрк░, ркирлАркЪрлЗ рк╡рк│ркдрлБркВ ркЬркоркгрлБркВ ркдрлАрк░
тмЕя╕П	ркбрк╛ркмрлБркВ ркдрлАрк░, ркжрк┐рк╢рк╛, рккрк╢рлНркЪрк┐рко
тмЖя╕П	ркЙркдрлНркдрк░, ркЙрккрк░ ркдрлАрк░, ркдрлАрк░, ркжрк┐рк╢рк╛
тмЗя╕П	ркдрлАрк░, ркжркХрлНрк╖рк┐ркг, ркжрк┐рк╢рк╛, ркирлАркЪрлЗ, ркирлАркЪрлЗ ркдрлАрк░
тмЫя╕П	ркХрк╛рк│рлЛ ркорлЛркЯрлЛ ркЪрлЛрк░рк╕, ркЪрлЛрк░рк╕, ркнрлМркорк┐ркдрк┐ркХ
тмЬя╕П	ркЪрлЛрк░рк╕, ркнрлМркорк┐ркдрк┐ркХ, рк╕рклрлЗркж ркорлЛркЯрлЛ ркЪрлЛрк░рк╕
тнРя╕П	ркдрк╛рк░рлЛ, ркоркзрлНркпрко рк╕рклрлЗркж ркдрк╛рк░рлЛ, рк╕рлНркЯрк╛рк░
тнХя╕П	o, ркЧрлЛрк│
уА░я╕П	ркбрлЗрк╢, рк▓рк╣рлЗрк░рк╛ркдрлБркВ, рк▓рк╣рлЗрк░рк╛ркдрлЛ ркбрлЗрк╢, рк▓рк╛ркВркмрлБркВ ркзрлНрк╡ркирк┐ ркЪрк┐рк╣рлНрки
уА╜я╕П	ркЪрк┐рк╣рлНрки, ркЬрк╛рккрк╛ркирлА ркЪрк┐рк╣рлНрки, ркнрк╛ркЧ
уКЧя╕П	ркЖркЗркбрк┐ркпрлЛркЧрлНрк░рк╛ркл, ркЧрлЛрк│ркорк╛ркВ ркЕркнрк┐ркиркВркжрки ркЖрккркдрлЛ ркЖркЗркбрк┐ркпрлЛркЧрлНрк░рк╛ркл, ркЪрлАркирлАтАШ ркЕркнрк┐ркиркВркжрки
уКЩя╕П	ркЖркЗркбрк┐ркпрлЛркЧрлНрк░рк╛ркл, ркЧрлБрккрлНркд, ркЧрлЛрк│ркорк╛ркВ ркЧрлБрккрлНркд ркЖркЗркбрк┐ркпрлЛркЧрлНрк░рк╛ркл, ркЪрлАркирлА
ЁЯАДя╕П	ркЯрк╛ркЗрк▓, ркбрлНрк░рлЗркЧрки, ркорк╛рк╣ркЬрлЛркВркЧ, ркорк╛рк╣ркЬрлЛркВркЧ рк▓рк╛рк▓ ркбрлНрк░рлЗркЧрки, рк▓рк╛рк▓ ркбрлНрк░рлЗркЧрки
ЁЯЕ░я╕П	A, рккрлНрк░ркХрк╛рк░ A, рк▓рлЛрк╣рлА, рк▓рлЛрк╣рлАркирлЛ рккрлНрк░ркХрк╛рк░, рк▓рлЛрк╣рлАркирлЛ рккрлНрк░ркХрк╛рк░ A
ЁЯЕ▒я╕П	B, рккрлНрк░ркХрк╛рк░ B, рк▓рлЛрк╣рлА, рк▓рлЛрк╣рлАркирлЛ рккрлНрк░ркХрк╛рк░, рк▓рлЛрк╣рлАркирлЛ рккрлНрк░ркХрк╛рк░ B
ЁЯЕ╛я╕П	O, рккрлНрк░ркХрк╛рк░ O, рк▓рлЛрк╣рлА, рк▓рлЛрк╣рлАркирлЛ рккрлНрк░ркХрк╛рк░, рк▓рлЛрк╣рлАркирлЛ рккрлНрк░ркХрк╛рк░ O
ЁЯЕ┐я╕П	рккрк╛рк░рлНркХрк┐ркВркЧ, рккрк╛рк░рлНркХрк┐ркВркЧ рк╕рлНркерк│
ЁЯИВя╕П	ркЪрлЛрк░рк╕ркорк╛ркВ ркЕрк╣рлАркВ рк╣рлЗркдрлБ ркЬрк╛рккрк╛ркирлА ркЪрк┐рк╣рлНрки, ркЬрк╛рккрк╛ркирлА рк╢ркмрлНркж
ЁЯМОя╕П	ркЕркорлЗрк░рк┐ркХрк╛, ркЕркорлЗрк░рк┐ркХрк╛ ркмркдрк╛рк╡ркдрлБркВ ркЧрлНрк▓рлЛркм, ркЕркорлЗрк░рк┐ркХрк╛ ркмркдрк╛рк╡ркдрлЛ рккрлГркерлНрк╡рлАркирлЛ ркЧрлЛрк│рлЛ, ркЕркорлЗрк░рк┐ркХрк╛ркЭ ркмркдрк╛рк╡ркдрлА ркЧрлНрк▓рлЛркм, ркЧрлНрк▓рлЛркм, рккрлГркерлНрк╡рлА
ЁЯМХя╕П	ркЪркВркжрлНрк░, ркдрлЗркЬрк╕рлНрк╡рлА, рккрлВрк░рлНркг, рккрлВрк░рлНркг ркЪркВркжрлНрк░
ЁЯМЬя╕П	ркЕрк░рлНркз ркЪркВркжрлНрк░, ркЪркВркжрлНрк░, ркЪрк╣рлЗрк░рк╛ рк╕рк╛ркерлЗркирлЛ ркЕрк░рлНркз ркЪркВркжрлНрк░, ркЪрк╣рлЗрк░рк╛рк╡рк╛рк│рлЛ ркХрлГрк╖рлНркг рккркХрлНрк╖ркирлЛ ркЪркВркжрлНрк░, ркЪрк╣рлЗрк░рлЛ
ЁЯМбя╕П	ркерк░рлНркорлЛркорлАркЯрк░, рк╣рк╡рк╛ркорк╛рки
ЁЯМдя╕П	ркирк╛ркирк╛ рк╡рк╛ркжрк│рк╛ркирлА рккрк╛ркЫрк│ рк╕рлВрк░рлНркп, рк╕рлВрк░рлНркп, рк╣рк╡рк╛ркорк╛рки
ЁЯМея╕П	ркорлЛркЯрк╛ рк╡рк╛ркжрк│рк╛ркВркирлА рккрк╛ркЫрк│ рк╕рлВрк░рлНркп, рк╕рлВрк░рлНркп, рк╣рк╡рк╛ркорк╛рки
ЁЯМжя╕П	рк╡рк░рк╕рк╛ркж, рк╡рк░рк╕рк╛ркж рк╕рк╛ркерлЗркирк╛ рк╡рк╛ркжрк│рк╛ркирлА рккрк╛ркЫрк│ рк╕рлВрк░рлНркп, рк╕рлВрк░рлНркп, рк╣рк╡рк╛ркорк╛рки
ЁЯМзя╕П	рк╡рк░рк╕рк╛ркж, рк╡рк░рк╕рк╛ркж рк╕рк╛ркерлЗркирлЛ рк╡рк╛ркжрк│рлБркВ, рк╡рк░рлНрк╖рк╛, рк╣рк╡рк╛ркорк╛рки
ЁЯМия╕П	ркаркВркбрлБркВ, ркмрк░ркл рк╕рк╛ркерлЗркирлБркВ рк╡рк╛ркжрк│рлБркВ, рк╢рлАркд, рк╣рк╡рк╛ркорк╛рки, рк╣рк┐ркорк╡рк░рлНрк╖рк╛
ЁЯМйя╕П	ркЪркоркХрк╛рк░рк╛ рк╕рк╛ркерлЗркирлБркВ рк╡рк╛ркжрк│рлБркВ, рк╡рлАркЬрк│рлАркирлЛ ркЪркоркХрк╛рк░рлЛ, рк╣рк╡рк╛ркорк╛рки
ЁЯМкя╕П	ркЪркХрлНрк░рк╡рк╛ркд, ркдрлЛрклрк╛рки, рк╡рк╛ркжрк│, рк╡рк╛рк╡ркВркЯрлЛрк│, рк╣рк╡рк╛ркорк╛рки
ЁЯМля╕П	ркзрлБркорлНркорлНрк╕, рк╡рк╛ркжрк│, рк╣рк╡рк╛ркорк╛рки
ЁЯМмя╕П	ркЪрк╣рлЗрк░рлЛ, рккрк╡ркиркирлЛ ркЪрк╣рлЗрк░рлЛ, рк╡рк╛ркжрк│, рк╡рк╛ркпрлБ, рк╣рк╡рк╛
ЁЯМ╢я╕П	ркЫрлЛркб, ркдрлАркЦрлБркВ, ркорк░ркЪрлБркВ, рк▓рк╛рк▓ ркорк░ркЪрлБркВ
ЁЯН╕я╕П	ркХрлЛркХркЯрлЗркЗрк▓, ркХрлЛркХркЯрлЗркЗрк▓ ркЧрлНрк▓рк╛рк╕, ркмрк╛рк░, рк░рлЗрк╕рлНркЯрлЛрк░ркирлНркЯ
ЁЯН╜я╕П	ркХрк╛ркВркЯрлЛ, ркЫрк░рлА, ркерк╛рк│рлА, рккрлНрк▓рлЗркЯ, рккрлНрк▓рлЗркЯ рк╕рк╛ркерлЗ ркЫрк░рлА ркЕркирлЗ ркХрк╛ркВркЯрлЛ, рк░рк╕рлЛркИ
ЁЯОУя╕П	ркЙркЬрк╡ркгрлА, ркЯрлЛрккрлА, рк╕рлНркирк╛ркдркХ, рк╕рлНркирк╛ркдркХ ркЯрлЛрккрлА
ЁЯОЦя╕П	ркЙркЬрк╡ркгрлА, ркорк┐рк▓рк┐ркЯрлНрк░рлА, ркорлЗркбрк▓, рк╕рлЗркирк╛ркирлЛ ркорлЗркбрк▓
ЁЯОЧя╕П	ркЙркЬрк╡ркгрлА, рк░рк┐ркмрки, рк░рк┐ркорк╛ркЗркирлНркбрк░, рк░рк┐ркорк╛ркЗркирлНркбрк░ рк░рк┐ркмрки
ЁЯОЩя╕П	ркорк╛ркЗркХ, ркорк╛ркЗркХрлНрк░рлЛрклрлЛрки, ркорлНркпрлБркЭрк┐ркХ, рк╕ркВркЧрлАркд, рк╕рлНркЯрлВркбрк┐ркпрлЛ, рк╕рлНркЯрлВркбрк┐ркпрлЛ ркорк╛ркЗркХрлНрк░рлЛрклрлЛрки
ЁЯОЪя╕П	ркорлНркпрлБркЭрк┐ркХ, рк▓рлЗрк╡рк▓ рк╕рлНрк▓рк╛ркЗркбрк░, рк╕ркВркЧрлАркд, рк╕рлНрк▓рк╛ркЗркбрк░
ЁЯОЫя╕П	ркХркирлНркЯрлНрк░рлЛрк▓, ркХркирлНркЯрлНрк░рлЛрк▓ ркирлЛркмрлНрк╕, ркирлЛркмрлНрк╕, ркорлНркпрлБркЭрк┐ркХ, рк╕ркВркЧрлАркд
ЁЯОЮя╕П	рклрк┐рк▓рлНрко, рклрк┐рк▓рлНрко рклрлНрк░рлЗркорлНрк╕, рклрлНрк░рлЗркорлНрк╕, ркорлВрк╡рлА, рк╕рк┐ркирлЗркорк╛
ЁЯОЯя╕П	ркЯрк┐ркХрк┐ркЯ, рккрлНрк░рк╡рлЗрк╢, рккрлНрк░рк╡рлЗрк╢ ркЯрк┐ркХрк┐ркЯ
ЁЯОзя╕П	ркоркирлЛрк░ркВркЬрки, рк╣рлЗркбрклрлЛрки
ЁЯОмя╕П	ркХрлНрк▓рлЗрккрк░, ркХрлНрк▓рлЗрккрк░ ркмрлЛрк░рлНркб, ркХрлНрк▓рлЗрккрк░ркмрлЛрк░рлНркб, ркоркирлЛрк░ркВркЬрки, ркорлВрк╡рлА
ЁЯОня╕П	ркХрк│рк╛, ркЪрк╣рлЗрк░рк╛ркирлБркВ ркорк╣рлЛрк░рлБркВ, ркоркирлЛрк░ркВркЬрки, рк▓рк▓рк┐ркд
ЁЯОоя╕П	ркЧрлЗрко, ркирк┐ркпркВркдрлНрк░ркХ, рк╡рк┐ркбрк┐ркУ ркЧрлЗрко
ЁЯПВя╕П	ркЦрлЗрк▓ ркХрлВркж, рк╕рлНркирлЛркмрлЛрк░рлНркб, рк╕рлНркирлЛркмрлЛрк░рлНркбрк░, рк╕рлНркирлЛркмрлЛрк░рлНркбрк┐ркВркЧ
ЁЯПДя╕П	ркЦрлЗрк▓ ркХрлВркж, рк╕рк░рлНрклрк░, рк╕рк░рлНрклрк┐ркВркЧ
ЁЯПЖя╕П	ркИркирк╛рко, ркЯрлНрк░рлЛрклрлА
ЁЯПКя╕П	ркЦрлЗрк▓ ркХрлВркж, ркдрк░ркг, ркдрк░рк╡рлБркВ, рк╕рлНрк╡рк┐ркорк░ (ркдрк░рк╡рлИркпрлЛ)
ЁЯПЛя╕П	рк▓рк┐рклрлНркЯрк░, рк╡ркЬрки, рк╡рлЗркЯ рк▓рк┐рклрлНркЯрк░
ЁЯПМя╕П	ркЧрлЛрк▓рлНркл рк░ркоркирк╛рк░ ркЦрлЗрк▓рк╛ркбрлА, ркЧрлЛрк▓рлНрклрк░, ркмрлЛрк▓
ЁЯПНя╕П	ркорлЛркЯрк░рк╕рк╛ркпркХрк▓, рк░рлЗрк╕рк┐ркВркЧ
ЁЯПОя╕П	ркХрк╛рк░, рк░рлЗрк╕рк┐ркВркЧ, рк░рлЗрк╕рк┐ркВркЧ ркХрк╛рк░
ЁЯПФя╕П	рккрк╣рк╛ркб, ркмрк░ркл, ркмрк░рклркирк╛ рк╢рк┐ркЦрк░рк╡рк╛рк│рлЛ рккрк░рлНрк╡ркд, рк╣рк┐рко
ЁЯПХя╕П	ркХрлЗркорлНрккрк┐ркВркЧ, ркдркВркмрлБ рк▓ркЧрк╛рк╡рк╡рлЛ
ЁЯПЦя╕П	ркЫркдрлНрк░рлА, ркЫркдрлНрк░рлА рк╕рк╛ркерлЗркирлЛ рк╕ркорлБркжрлНрк░ркдркЯ
ЁЯПЧя╕П	ркИркорк╛рк░ркд, ркирк┐рк░рлНркорк╛ркг, ркмрк┐рк▓рлНркбрк┐ркВркЧ, ркмрк┐рк▓рлНркбрк┐ркВркЧркирлБркВ ркмрк╛ркВркзркХрк╛рко
ЁЯПШя╕П	ркИркорк╛рк░ркд, ркШрк░, ркШрк░ркирлА ркИркорк╛рк░ркдрлЛ, ркмрк┐рк▓рлНркбрк┐ркВркЧ
ЁЯПЩя╕П	рк╢рк╣рлЗрк░, рк╢рк╣рлЗрк░рлА ркИркорк╛рк░ркдрлЛ
ЁЯПЪя╕П	ркШрк░, рк╡рлЗрк░рк╛рки, рк╡рлЗрк░рк╛рки ркШрк░ркирлА ркмрк┐рк▓рлНркбрк┐ркВркЧ
ЁЯПЫя╕П	ркИркорк╛рк░ркд, ркХрлНрк▓рк╛рк╕рк┐ркХрк▓ ркмрк┐рк▓рлНркбрк┐ркВркЧ, ркЬрлВркирлА
ЁЯПЬя╕П	рк░ркг, рк░ркгрккрлНрк░ркжрлЗрк╢
ЁЯПЭя╕П	ркЖркЗрк▓рлЗркирлНркб, ркжрлНрк╡рк┐ркк, рк░ркгркорк╛ркВ ркжрлНрк╡рк┐ркк
ЁЯПЮя╕П	рккрк╛рк░рлНркХ, ркмркЧрлАркЪрлЛ, рк░рк╛рк╖рлНркЯрлНрк░рлАркп ркЙркжрлНркпрк╛рки
ЁЯПЯя╕П	рк╕рлНркЯрлЗркбрк┐ркпрко
ЁЯПая╕П	ркИркорк╛рк░ркд, ркЧрлГрк╣, ркШрк░, ркШрк░ркирлА ркИркорк╛рк░ркд, ркмрк┐рк▓рлНркбрк┐ркВркЧ
ЁЯПня╕П	ркИркорк╛рк░ркд, рклрлЗркХрлНркЯрк░рлА
ЁЯП│я╕П	рк▓рк╣рлЗрк░ркдрлЛ рк╕рклрлЗркж ркЭркВркбрлЛ, рк▓рк╣рлЗрк░рк╡рлБркВ
ЁЯП╡я╕П	ркЫрлЛркб, рклрлАркдркирлБркВ ркЧрлБрк▓рк╛ркм
ЁЯП╖я╕П	рк▓рлЗркмрк▓
ЁЯРИя╕П	рккрлНрк░рк╛ркгрлА, ркмрк┐рк▓рк╛ркбрлА
ЁЯРХя╕П	ркЧрк▓рлВркбрк┐ркпрлБркВ, рккрлНрк░рк╛ркгрлА, рк╢рлНрк╡рк╛рки
ЁЯРЯя╕П	рккрлНрк░рк╛ркгрлА, ркорк╛ркЫрк▓рлА
ЁЯРжя╕П	рккркХрлНрк╖рлА, рккрлНрк░рк╛ркгрлА
ЁЯР┐я╕П	ркЦрк┐рк╕ркХрлЛрк▓рлА, ркЪрк┐рккркоркВркХ
ЁЯСБя╕П	ркЖркВркЦ, рк╢рк░рлАрк░
ЁЯСВя╕П	ркХрк╛рки, рк╢рк░рлАрк░
ЁЯСЖя╕П	ркЖркВркЧрк│рлА, ркЙрккрк░ ркЖркВркЧрк│рлА, ркЙрккрк░ркирлА ркмрк╛ркЬрлБ ркЪрлАркВркзрк╛ркпрлЗрк▓рлА ркЖркВркЧрк│рлА, рккрк╣рлЗрк▓рлА ркЖркВркЧрк│рлА, рк╣рк╛ркеркирлА рккрк╛ркЫрк▓рлА ркмрк╛ркЬрлБркПркерлА ркЙрккрк░ ркЪрлАркВркзркдрлА ркдрк░рлНркЬркирлА, рк╣рк╛ркеркирлЛ рккрк╛ркЫрк▓рлЛ ркнрк╛ркЧ
ЁЯСЗя╕П	ркЖркВркЧрк│рлА, ркирлАркЪрлА ркЖркВркЧрк│рлА, ркирлАркЪрлЗркирлА ркмрк╛ркЬрлБ ркЪрлАркВркзрк╛ркпрлЗрк▓рлА ркЖркВркЧрк│рлА, рккрк╣рлЗрк▓рлА ркЖркВркЧрк│рлА, рк╣рк╛ркеркирлА рккрк╛ркЫрк▓рлА ркмрк╛ркЬрлБркПркерлА ркирлАркЪрлЗ ркЪрлАркВркзркдрлА ркдрк░рлНркЬркирлА, рк╣рк╛ркеркирлЛ рккрк╛ркЫрк▓рлЛ ркнрк╛ркЧ
ЁЯСИя╕П	ркЖркВркЧрк│рлА, ркбрк╛ркмрлА ркЖркВркЧрк│рлА, ркбрк╛ркмрлА ркмрк╛ркЬрлБ ркЪрлАркВркзркдрлА ркЖркВркЧрк│рлА, рккрк╣рлЗрк▓рлА ркЖркВркЧрк│рлА, рк╣рк╛ркеркирлЛ рккрк╛ркЫрк▓рлЛ ркнрк╛ркЧ
ЁЯСЙя╕П	ркЖркВркЧрк│рлА, ркЬркоркгрлА ркЖркВркЧрк│рлА, ркЬркоркгрлА ркмрк╛ркЬрлБ ркЪрлАркВркзркдрлА ркЖркВркЧрк│рлА, рккрк╣рлЗрк▓рлА ркЖркВркЧрк│рлА, рк╣рк╛ркеркирлЛ рккрк╛ркЫрк▓рлЛ ркнрк╛ркЧ
ЁЯСНя╕П	ркЕркВркЧрлБркарлЛ, ркЙркВркЪрлЛ, ркЪрк┐рк╣рлНрки, ркеркорлНркмрлНрк╕ ркЕркк, рк╣рк╛рке
ЁЯСОя╕П	ркЕркВркЧрлБркарлЛ, ркЪрк┐рк╣рлНрки, ркирлАркЪрлЛ, ркирлАркЪрлЛ ркЕркВркЧрлВркарлЛ, рк╣рк╛рке
ЁЯСУя╕П	ркЖркВркЦркирк╛ркВ ркЪрк╢рлНркорк╛, ркХрккркбрк╛ркВ, ркЪрк╢рлНркорк╛
ЁЯСкя╕П	ркХрлБркЯрлБркВркм, рккрк┐ркдрк╛, ркмрк╛рк│ркХ, ркорк╛ркдрк╛, рк▓рлЛркХрлЛ
ЁЯС╜я╕П	UFO, ркЪрк╣рлЗрк░рлЛ, рккрк░ркЧрлНрк░рк╣рк╡рк╛рк╕рлА, рккрк░рлА ркХркерк╛, рккрлГркерлНрк╡рлА ркмрк╣рк╛рк░ркирк╛ркВ
ЁЯТгя╕П	ркмрлЛркорлНркм, рк░ркорлВркЬрлА, рк▓рк╛ркЧркгрлА
ЁЯТ░я╕П	ркбрлЙрк▓рк░ ркмрлЕркЧ, рккрлИрк╕рк╛, рккрлИрк╕рк╛ркирлА ркерлЗрк▓рлА, ркмрлЕркЧ
ЁЯТ│я╕П	ркХрк╛рк░рлНркб, ркХрлНрк░рлЗркбрк┐ркЯ, ркХрлНрк░рлЗркбрк┐ркЯ ркХрк╛рк░рлНркб
ЁЯТ╗я╕П	PC, ркХркорлНрккрлНркпрлБркЯрк░, рккрк░рлНрк╕ркирк▓ ркХркорлНрккрлНркпрлБркЯрк░, рк▓рлЗрккркЯрлЛркк ркХркорлНрккрлНркпрлБркЯрк░, рк╡рлНркпркХрлНркдрк┐ркЧркд
ЁЯТ┐я╕П	CD, DVD, ркСрккрлНркЯрк┐ркХрк▓ ркбрк┐рк╕рлНркХ, ркбрк┐рк╕рлНркХ, ркмрлНрк▓рлБ-рк░рлЗ
ЁЯУЛя╕П	ркХрлНрк▓рк┐рккркмрлЙрк░рлНркб
ЁЯУЪя╕П	рккрлБрк╕рлНркдркХ, рккрлБрк╕рлНркдркХрлЛ
ЁЯУЯя╕П	рккрлЗркЬрк░, рк╕ркВркЪрк╛рк░
ЁЯУдя╕П	ркЖркЙркЯркмрлЛркХрлНрк╕, ркЖркЙркЯркмрлЛркХрлНрк╕ ркЯрлНрк░рлЗ, ркЯрлНрк░рлЗ, ркмрлЛркХрлНрк╕, ркорлЗркЗрк▓, ркорлЛркХрк▓рлЗрк▓, рк╕ркВркЪрк╛рк░
ЁЯУея╕П	ркЗркиркмрлЛркХрлНрк╕, ркЗркиркмрлЛркХрлНрк╕ ркЯрлНрк░рлЗ, ркЯрлНрк░рлЗ, рккрлНрк░рк╛рккрлНркд, ркмрлЛркХрлНрк╕, ркорлЗркЗрк▓, рк╕ркВркЪрк╛рк░
ЁЯУжя╕П	рккрк╛рк░рлНрк╕рк▓, рккрлЕркХрлЗркЬ, ркмрлЛркХрлНрк╕
ЁЯУкя╕П	ркзрлНрк╡ркЬ, ркиркорк╛рк╡рлЗрк▓ ркзрлНрк╡ркЬрк╡рк╛рк│рлБркВ ркорлЗркЗрк▓ркмрлЛркХрлНрк╕, ркмркВркз, ркорлЗркЗрк▓, ркорлЗркЗрк▓ркмрлЛркХрлНрк╕
ЁЯУля╕П	ркзрлНрк╡ркЬ, рклрк░ркХрк╛рк╡рлЗрк▓рк╛ ркзрлНрк╡ркЬрк╡рк╛рк│рлБркВ ркорлЗркЗрк▓ркмрлЛркХрлНрк╕, ркмркВркз, ркорлЗркЗрк▓, ркорлЗркЗрк▓ркмрлЛркХрлНрк╕
ЁЯУмя╕П	ркЦрлБрк▓рлНрк▓рлБркВ, ркзрлНрк╡ркЬ, рклрк░ркХрк╛рк╡рлЗрк▓рк╛ ркзрлНрк╡ркЬрк╡рк╛рк│рлБркВ ркЦрлБрк▓рлНрк▓рлБркВ ркорлЗркЗрк▓ркмрлЛркХрлНрк╕, ркорлЗркЗрк▓, ркорлЗркЗрк▓ркмрлЛркХрлНрк╕
ЁЯУня╕П	ркЦрлБрк▓рлНрк▓рлБркВ, ркзрлНрк╡ркЬ, ркиркорк╛рк╡рлЗрк▓ ркзрлНрк╡ркЬрк╡рк╛рк│рлБркВ ркЦрлБрк▓рлНрк▓рлБркВ ркорлЗркЗрк▓ркмрлЛркХрлНрк╕, ркорлЗркЗрк▓, ркорлЗркЗрк▓ркмрлЛркХрлНрк╕
ЁЯУ╖я╕П	ркХрлЕркорлЗрк░рк╛, рк╡рк┐ркбрк┐ркУ
ЁЯУ╣я╕П	ркХрлЕркорлЗрк░рлЛ, рк╡рк┐ркбрк┐ркУ, рк╡рк┐ркбрк┐ркУ ркХрлЕрко, рк╡рк┐ркбрк┐ркУ ркХрлЕркорлЗрк░рлЛ
ЁЯУ║я╕П	ркЯрлАрк╡рлА, ркЯрлЗрк▓рк┐рк╡рк┐ркЭрки
ЁЯУ╗я╕П	рк░рлЗркбрк┐ркУ, рк╡рк┐ркбрк┐ркУ
ЁЯУ╜я╕П	рккрлНрк░рлЛркЬрлЗркХрлНркЯрк░, рклрк┐рк▓рлНрко рккрлНрк░рлЛркЬрлЗркХрлНркЯрк░, ркорлВрк╡рлА, рк╡рк┐ркбрк┐ркУ, рк╕рк┐ркирлЗркорк╛
ЁЯФИя╕П	ркирк░рко, рк╕рлНрккрлАркХрк░, рк╕рлНрккрлАркХрк░ ркирлАркЪрлБркВ рк╡рлЙрк▓рлНркпрлВрко, рк╕рлНрккрлАркХрк░ рк▓рлЛ рк╡рлЛрк▓рлНркпрлБрко
ЁЯФТя╕П	ркдрк╛рк│рлБркВ, ркмркВркз ркдрк╛рк│рлБркВ
ЁЯФУя╕П	ркЦрлБрк▓рлНрк▓рлБркВ ркдрк╛рк│рлБркВ, ркдрк╛рк│рлБркВ
ЁЯХЙя╕П	ркзрк░рлНрко, рк╣рк┐ркирлНркжрлБ, рлР
ЁЯХКя╕П	ркХркмрлВркдрк░, рккркХрлНрк╖рлА, рк╢рк╛ркВркдрк┐
ЁЯХРя╕П	1 рк╡рк╛ркЧрлНркпрлЗ, 1:00, ркПркХ, ркПркХ рк╡рк╛ркЧрлНркпрлЗ, ркШркбрк┐ркпрк╛рк│
ЁЯХСя╕П	2 рк╡рк╛ркЧрлНркпрлЗ, 2:00, ркШркбрк┐ркпрк╛рк│, ркмрлЗ, ркмрлЗ рк╡рк╛ркЧрлНркпрлЗ
ЁЯХТя╕П	3 рк╡рк╛ркЧрлНркпрлЗ, 3:00, ркШркбрк┐ркпрк╛рк│, ркдрлНрк░ркг, ркдрлНрк░ркг рк╡рк╛ркЧрлНркпрлЗ
ЁЯХУя╕П	4 рк╡рк╛ркЧрлНркпрлЗ, 4:00, ркШркбрк┐ркпрк╛рк│, ркЪрк╛рк░, ркЪрк╛рк░ рк╡рк╛ркЧрлНркпрлЗ
ЁЯХФя╕П	5 рк╡рк╛ркЧрлНркпрлЗ, 5:00, ркШркбрк┐ркпрк╛рк│, рккрк╛ркВркЪ, рккрк╛ркВркЪ рк╡рк╛ркЧрлНркпрлЗ
ЁЯХХя╕П	6 рк╡рк╛ркЧрлНркпрлЗ, 6:00, ркШркбрк┐ркпрк╛рк│, ркЫ, ркЫ рк╡рк╛ркЧрлНркпрлЗ
ЁЯХЦя╕П	7 рк╡рк╛ркЧрлНркпрлЗ, 7:00, ркШркбрк┐ркпрк╛рк│, рк╕рк╛ркд, рк╕рк╛ркд рк╡рк╛ркЧрлНркпрлЗ
ЁЯХЧя╕П	8 рк╡рк╛ркЧрлНркпрлЗ, 8:00, ркЖрка, ркЖрка рк╡рк╛ркЧрлНркпрлЗ, ркШркбрк┐ркпрк╛рк│
ЁЯХШя╕П	9 рк╡рк╛ркЧрлНркпрлЗ, 9:00, ркШркбрк┐ркпрк╛рк│, ркирк╡, ркирк╡ рк╡рк╛ркЧрлНркпрлЗ
ЁЯХЩя╕П	10 рк╡рк╛ркЧрлНркпрлЗ, 10:00, ркШркбрк┐ркпрк╛рк│, ркжрк╕, ркжрк╕ рк╡рк╛ркЧрлНркпрлЗ
ЁЯХЪя╕П	11 рк╡рк╛ркЧрлНркпрлЗ, 11:00, ркЕркЧрк┐ркпрк╛рк░, ркЕркЧрк┐ркпрк╛рк░ рк╡рк╛ркЧрлНркпрлЗ, ркШркбрк┐ркпрк╛рк│
ЁЯХЫя╕П	12 рк╡рк╛ркЧрлНркпрлЗ, 12:00, ркШркбрк┐ркпрк╛рк│, ркмрк╛рк░, ркмрк╛рк░ рк╡рк╛ркЧрлНркпрлЗ
ЁЯХпя╕П	ркорлАркгркмркдрлНркдрлА, рк▓рк╛ркЗркЯ
ЁЯХ░я╕П	ркШркбрк┐ркпрк╛рк│, ркорлЗркВркЯрк▓рккрлАрк╕ ркШркбрк┐ркпрк╛рк│, рк╕ркоркп
ЁЯХ│я╕П	ркХрк╛ркгрлБркВ, ркЫрк┐ркжрлНрк░
ЁЯХ┤я╕П	рккрлБрк░рлБрк╖, ркмрк┐ркЭркирлЗрк╕, рк╡рлЗрккрк╛рк░, рк╡рлНркпрк╡рк╕рк╛ркп, рк╕рлВркЯ, рк╕рлВркЯрк╡рк╛рк│рлЛ рк╡рлНркпркХрлНркдрк┐
ЁЯХ╡я╕П	ркЧрлБрккрлНркдркЪрк░, ркЫрлВрккрлА рккрлЛрк▓рлАрк╕ркирлЛ ркорк╛ркгрк╕, ркЬрк╛рк╕рлВрк╕, ркбрк┐ркЯрлЗркХрлНркЯрк┐рк╡
ЁЯХ╢я╕П	ркЖркВркЦ, ркЪрк╢рлНркорк╛ркВ, рк╕ркиркЧрлНрк▓рк╛рк╕рлЗрк╕
ЁЯХ╖я╕П	ркХрк░рлЛрк│рк┐ркпрлЛ, ркЬркВркдрлБ
ЁЯХ╕я╕П	ркХрк░рлЛрк│рк┐ркпрк╛ркирлБркВ ркЬрк╛рк│рлБркВ, ркХрк░рлЛрк│рк┐ркпрлЛ, ркЬрк╛рк│рлБркВ
ЁЯХ╣я╕П	ркЬрлЛркпрк╕рлНркЯрк┐ркХ, рк░ркоркд, рк╡рк┐ркбрк┐ркУ ркЧрлЗрко
ЁЯЦЗя╕П	рккрлЗрккрк░ркХрлНрк▓рк┐ркк, рк▓рк┐ркВркХ ркХрк░рлЗрк▓ рккрлЗрккрк░ркХрлНрк▓рк┐рккрлНрк╕
ЁЯЦКя╕П	рккрлЕрки, ркмрлЛрк▓рккрлЙркЗркирлНркЯ
ЁЯЦЛя╕П	рккрлЕрки, рклрк╛ркЙркирлНркЯрки, рклрк╛ркЙркирлНркЯрки рккрлЕрки
ЁЯЦМя╕П	ркЪрк┐ркдрлНрк░ркХрк│рк╛, рккрлЗркЗркирлНркЯркмрлНрк░рк╢
ЁЯЦНя╕П	ркХрлНрк░рлЗркпрлЛрки, рк░ркВркЧрлАрки ркЪрк╛ркХ
ЁЯЦРя╕П	ркЖркВркЧрк│рлА, рклрлЗрк▓рк╛рк╡рлЗрк▓рлА ркЖркВркЧрк│рлА рк╡рк╛рк│рлЛ ркЙркарк╛рк╡рлЗрк▓рлЛ рк╣рк╛рке, рклрлЗрк▓рк╛рк╡рлЗрк▓рлБркВ, рк╢рк░рлАрк░, рк╣рк╛рке
ЁЯЦея╕П	ркХркорлНрккрлНркпрлБркЯрк░, ркбрлЗрк╕рлНркХркЯрлЙркк, ркбрлЗрк╕рлНркХркЯрлЙркк ркХркорлНрккрлНркпрлБркЯрк░
ЁЯЦия╕П	ркХркорлНрккрлНркпрлБркЯрк░, рккрлНрк░рк┐ркирлНркЯрк░
ЁЯЦ▒я╕П	3, ркХркорлНрккрлНркпрлБркЯрк░, ркХркорлНрккрлНркпрлБркЯрк░ ркорк╛ркЙрк╕, ркдрлНрк░ркг, ркмркЯрки, ркорк╛ркЙрк╕
ЁЯЦ▓я╕П	ркХркорлНрккрлНркпрлБркЯрк░, ркЯрлНрк░рлЗркХркмрлЛрк▓
ЁЯЦ╝я╕П	ркХрк▓рк╛, ркХрк▓рк╛ркХрлГркдрк┐, ркЪрк┐ркдрлНрк░, ркЪрк┐ркдрлНрк░ рк╕рк╛ркерлЗркирлА рклрлНрк░рлЗрко, рклрлНрк░рлЗрко, рк╕ркВркЧрлНрк░рк╣рк╛рк▓ркп
ЁЯЧВя╕П	ркЗркирлНркбрлЗркХрлНрк╕, ркХрк╛рк░рлНркб, ркХрк╛рк░рлНркб ркЗркирлНркбрлЗркХрлНрк╕ ркбрк┐рк╡рк╛ркЗркбрк░рлНрк╕, ркбрк┐рк╡рк╛ркЗркбрк░рлНрк╕
ЁЯЧГя╕П	ркХрк╛рк░рлНркб рклрк╛ркЗрк▓ ркмрлЙркХрлНрк╕, рклрк╛ркЗрк▓
ЁЯЧДя╕П	ркХрлЕркмрк┐ркирлЗркЯ, рклрк╛ркЗрк▓, рклрк╛ркЗрк▓ ркХрлЕркмрк┐ркирлЗркЯ
ЁЯЧСя╕П	ркХркЪрк░рк╛рккрлЗркЯрлА
ЁЯЧТя╕П	ркирлЛркЯ, рккрлЗркб, рк╕рлНрккрк╛ркЗрк░рк▓, рк╕рлНрккрк╛ркЗрк░рк▓ ркирлЛркЯрккрлЗркб
ЁЯЧУя╕П	ркХрлЕрк▓рлЗркирлНркбрк░, рккрлЗркб, рк╕рлНрккрк╛ркЗрк░рк▓, рк╕рлНрккрк╛ркЗрк░рк▓ ркХрлЕрк▓рлЗркирлНркбрк░
ЁЯЧЬя╕П	ркХркорлНрккрлНрк░рлЗрк╢рки, ркХрлНрк▓рлЗркорлНркк, рк╕рк╛ркзрки
ЁЯЧЭя╕П	ркХрк│, ркЬрлВркирлА ркЪрк╛рк╡рлА, ркдрк╛рк│рлБркВ
ЁЯЧбя╕П	ркХркЯрк╛рк░, ркЪрк╛ркХрлБ, рк╣ркерк┐ркпрк╛рк░
ЁЯЧгя╕П	рккрк╛рк░рлНрк╢рлНрк╡ ркЪрк┐ркдрлНрк░, ркмрлЛрк▓ркдрлЛ ркЪрк╣рлЗрк░рлЛ, ркмрлЛрк▓рк╡рлБркВ, ркмрлЛрк▓рлЛ, ркорк╛ркерлБркВ, ркорлБркЦ
ЁЯЧия╕П	ркбрк╛ркмрлБркВ рк╕рлНрккрлАркЪ ркмркмрк▓, рк╡рк╛ркгрлА, рк╕ркВрк╡рк╛ркж, рк╕рлНрккрлАркЪ
ЁЯЧпя╕П	ркХрлНрк░рлЛркз, ркЬркоркгрлА ркдрк░рклркирлБркВ ркЧрлБрк╕рлНрк╕рк╛ркирлБркВ ркмркмрк▓, рккрк░рккрлЛркЯрлЛ, рккрк╛ркЧрк▓, рклрлБркЧрлНркЧрлЛ, ркмркмрк▓
ЁЯЧ│я╕П	ркмрлЙркХрлНрк╕, ркоркдркжрк╛рки, ркоркдркжрк╛рки рк╕рк╛ркерлЗ ркоркдркжрк╛рки ркмрлЙркХрлНрк╕
ЁЯЧ║я╕П	ркиркХрк╢рлЛ, рк╡рк┐рк╢рлНрк╡, рк╡рк┐рк╢рлНрк╡ркирлЛ ркиркХрк╢рлЛ
ЁЯШРя╕П	ркХрлЛркИ ркЯрк┐рккрлНрккркгрлА ркирк╣рлАркВ, ркЪрк╣рлЗрк░рлЛ, ркдркЯрк╕рлНрке, ркдркЯрк╕рлНрке ркЪрк╣рлЗрк░рлЛ, ркнрк╛рк╡рк╢рлВркирлНркп
ЁЯЪЗя╕П	ркорлЗркЯрлНрк░рлЛ, рк╡рк╛рк╣рки, рк╕ркмрк╡рлЗ
ЁЯЪНя╕П	ркЖрк╡ркирк╛рк░рлА, ркЖрк╡рлА рк░рк╣рлЗрк▓ ркмрк╕, ркмрк╕, рк╡рк╛рк╣рки
ЁЯЪСя╕П	ркПркорлНркмрлНркпрлБрк▓ркирлНрк╕, рк╡рк╛рк╣рки
ЁЯЪФя╕П	ркЖрк╡ркирк╛рк░рлА рккрлЛрк▓рлАрк╕ ркХрк╛рк░, ркЖрк╡рлА рк░рк╣рлЗрк▓ рккрлЛрк▓рлАрк╕ ркХрк╛рк░, рккрлЛрк▓рлАрк╕, рккрлЛрк▓рлАрк╕ ркХрк╛рк░, рк╡рк╛рк╣рки
ЁЯЪШя╕П	ркЖрк╡ркирк╛рк░, ркЖрк╡ркирк╛рк░рлА ркХрк╛рк░, ркЖрк╡рлА рк░рк╣рлЗрк▓ ркСркЯрлЛркорлЛркмрк╛ркЗрк▓, ркСркЯрлЛркорлЛркмрк╛ркЗрк▓, ркХрк╛рк░, рк╡рк╛рк╣рки
ЁЯЪня╕П	ркЪрк┐рк╣рлНрки, ркзрлВркорлНрк░рккрк╛рки ркирк┐рк╖рлЗркз, ркзрлВркорлНрк░рккрк╛рки ркирк┐рк╖рлЗркзркирлБркВ ркЪрк┐рк╣рлНрки
ЁЯЪ▓я╕П	ркмрк╛ркЗркХ, ркмрк╛ркЗрк╕рк┐ркХрк▓, рк╡рк╛рк╣рки, рк╕рк╛ркЗркХрк▓
ЁЯЪ╣я╕П	ркЪрк┐рк╣рлНрки, рккрлБрк░рлБрк╖рлЛркирлБркВ ркЪрк┐рк╣рлНрки, рккрлБрк░рлБрк╖рлЛркирлБркВ ркЪрк┐рк╣рлНрки, рккрлБрк░рлБрк╖рлЛркирлЛ ркЦркВркб, рккрлБрк░рлБрк╖рлЛркирлБркВ рккрлНрк░ркдрлАркХ, рккрлБрк░рлБрк╖рлЛркирлЛ ркЦркВркб
ЁЯЪ║я╕П	ркЪрк┐рк╣рлНрки, ркорк╣рк┐рк▓рк╛ркУркирлБркВ ркЪрк┐рк╣рлНрки, ркорк╣рк┐рк▓рк╛ркУркирлБркВ ркЪрк┐рк╣рлНрки, ркорк╣рк┐рк▓рк╛ркУркирлЛ ркЦркВркб, ркорк╣рк┐рк▓рк╛ркУркирлБркВ рккрлНрк░ркдрлАркХ, ркорк╣рк┐рк▓рк╛ркУркирлЛ ркЦркВркб
ЁЯЪ╝я╕П	ркЕркВркжрк░ ркмрк╛рк│ркХ ркЫрлЗ, ркмрк╛рк│ркХ, ркмрк╛рк│ркХркирк╛ рк╡рк╕рлНркдрлНрк░ ркмркжрк▓рк╡рк╛ркирлБркВ рк╕рлНркерк╛рки, ркмрк╛рк│ркХркирлБркВ ркЪрк┐рк╣рлНрки
ЁЯЫЛя╕П	ркХрк╛ркЙркЪ, ркХрк╛ркЙркЪ ркЕркирлЗ рк▓рлЗркорлНркк, рк▓рлЗркорлНркк, рк╕рлЛрклрлЛ, рк╣рлЛркЯрк▓
ЁЯЫНя╕П	ркЦрк░рлАркжрлА, рк╢рлЛрккрк┐ркВркЧ, рк╢рлЛрккрк┐ркВркЧ ркмрлЗркЧрлНрк╕, рк╣рлЛркЯрк▓
ЁЯЫОя╕П	ркШркВркЯркбрлА, ркШркВркЯрлА, ркмрлЗрк▓рк╣рлЛркк ркШркВркЯркбрлА, рк╣рлЛркЯрк▓
ЁЯЫПя╕П	ркКркВркШ, ркирк┐ркВркжрлНрк░рк╛, рккркерк╛рк░рлА, рк╣рлЛркЯрк▓
ЁЯЫая╕П	рк╕рк╛ркзрки, рк╣ркерлЛркбрлА ркЕркирлЗ рккрк╛ркирлБркВ
ЁЯЫбя╕П	ркврк╛рк▓, рк╣ркерк┐ркпрк╛рк░
ЁЯЫвя╕П	ркЯрк╛ркВркХрлА, ркдрлЗрк▓, ркдрлЗрк▓ркирлБркВ ркбрлНрк░рко
ЁЯЫгя╕П	ркорк╛рк░рлНркЧ, ркорлЛркЯрк░рк╡рлЗ, рк░рк╕рлНркдрлЛ, рк░рлЛркб, рк╣рк╛ркЗрк╡рлЗ
ЁЯЫдя╕П	ркЯрлНрк░рлЗрки, рк░рлЗрк▓рк╡рлЗ, рк░рлЗрк▓рлНрк╡рлЗ ркЯрлНрк░рлЗркХ
ЁЯЫея╕П	ркмрлЛркЯ, ркорлЛркЯрк░ ркмрлЛркЯ, рк╡рк╛рк╣рки
ЁЯЫйя╕П	ркирк╛ркирлБркВ ркПрк░рккрлНрк▓рлЗрки, рк╡рк┐ркорк╛рки
ЁЯЫ░я╕П	ркЕрк╡ркХрк╛рк╢, рк╡рк╛рк╣рки, рк╕рлЗркЯрлЗрк▓рк╛ркЗркЯ
ЁЯЫ│я╕П	ркпрк╛ркдрлНрк░рлА, ркпрк╛ркдрлНрк░рлА рк╡рк╣рк╛ркг, рк╡рк╣рк╛ркг, рк╡рк╛рк╣рки
