ğŸ»	tagwlimt taceÉ›lalt
ğŸ¼	tagwlimt taceÉ›lalt talemmast
ğŸ½	taglimt talemmast
ğŸ¾	tagwlimt tubrikt talemmast
ğŸ¿	tagwlimt tubrikt
ğŸ˜€	acmumeá¸¥ meqqren
ğŸ˜	acmumeá¸¥ n tuÉ£mas meá¹›á¹›a
ğŸ˜‚	taá¸sa ar imeá¹­á¹­awen
ğŸ¤£	axbibed di tmurt si tedsa
ğŸ˜ƒ	acmumeh n lfarh
ğŸ˜„	acmumeh amesrar
ğŸ˜…	acmumeh n reffu
ğŸ˜†	udem acmumaá¸¥ akked yimi yeldin d wallen imedlen
ğŸ˜‰	udem yemmalen aÉ£maz n ti
ğŸ˜Š	udem innecá¹›aá¸¥en s wallen icmumá¸¥en
ğŸ˜‹	ham-ham
ğŸ˜	acmumeá¸¥ s nwader n yiá¹­ij
ğŸ˜	udem yecmumhen d wallen igan am wul
ğŸ˜˜	tasudent d wul
ğŸ˜—	tamact
ğŸ˜™	tasudent meqren
ğŸ˜š	tasudent allen medlent
ğŸ™‚	acmumeh afessas
ğŸ¤—	udem yefkan ahennec
ğŸ¤”	udem ikecmen di ttexmim
ğŸ¤¨	afus irefden iá¸udan bejqen
ğŸ˜‘	udem war asunfal
ğŸ˜¶	ulac imi
ğŸ™„	baÉ›ar s wallen
ğŸ˜	acmumeh n tiherci
ğŸ˜£	udem akayay
ğŸ˜¥	uk
ğŸ˜®	vennej
ğŸ¤	udem d yimi ixaden
ğŸ˜¯	udem war taÉ£ect
ğŸ˜ª	udem yeá¹­á¹­sen
ğŸ˜«	udem yeÉ›yan
ğŸ˜´	udem anudam
ğŸ˜Œ	udem yenirsen
ğŸ˜›	Udem s yiles
ğŸ˜œ	Udem yessufÉ£en iles
ğŸ¤¤	asluddu
ğŸ˜’	udem ameklu
ğŸ˜·	udem s tgelmust
ğŸ¤’	udem s utirmumitr
ğŸ‘¶	á¹£ebyan
ğŸ§’	agrud
ğŸ‘¦	aqruá¹›
ğŸ‘§	Taqruá¹›t
ğŸ§‘	amengaá¸
ğŸ‘¨	argaz
ğŸ‘©	tameá¹­á¹­ut
ğŸ§“	amengaá¸ meqqren
ğŸ‘´	amÉ£aá¹›
ğŸ¦°	acekkuá¸¥ azeggaÉ£
ğŸ©	tarazalt
ğŸ“¿	teá¹£biá¸¥
ğŸ’„	zzin aÎ³ec
ğŸ’	taxatemt
ğŸ’	adgun aswa
ğŸµ	taqeá¹›á¹›uct n ivki
ğŸ’	ivki
ğŸ¦	aguril
ğŸ¶	taqeá¹›á¹›uct n waydi
ğŸ©	akennic
ğŸº	aguleh
ğŸ¦Š	avaá¹›aÉ£
ğŸ±	taqerruct n wemcic
ğŸœ	taweá¹­á¹­uft
ğŸ	tizizwit
ğŸ	takumda
ğŸ¦—	ajá¹›ad
ğŸ¦‚	tiÉ£iá¹›demt
ğŸ’	tafuseÈ›
ğŸŒ¸	ajeÄŸÄŸig n taknisya
ğŸ’®	ajeÄŸÄŸig amellal
ğŸŒ¹	tawerdett
ğŸ¥€	ajeÄŸÄŸig akiwan
ğŸŒº	tiviná¹£eá¹›t
ğŸŒ»	mager iá¹­á¹­ij
ğŸŒ¼	amgud
ğŸŒ·	taxlult
ğŸŒ±	imÉ£i aleqqaq
ğŸŒ²	tumert
ğŸŒ³	aseklu bu yifer
ğŸŒ´	tazdayt
ğŸŒµ	TasiÉ£awt
ğŸŒ¾	taceá¹›á¹›aft n á¹›á¹›uz
ğŸŒ¿	ifer
ğŸ€	ikeffis bu kuáº“ n wafriwen
ğŸ	ifer n kikev
ğŸ‚	ifer alvivec (ifer ucelvu)
ğŸƒ	tamjiwect n ifriwen
ğŸ‡	tiáº“urin
ğŸˆ	afeqqus
ğŸ‰	delleÉ›
ğŸŠ	tamandaritt
ğŸ‹	tilimett
ğŸŒ	tabanant
ğŸ	tananast
ğŸ¥­	tamungatt
ğŸ	adeffu azeggaÉ£
ğŸ	adeffu azegzaw
ğŸ	ifires
ğŸ‘	taxuxett
ğŸ’	taknisya
ğŸ“	tariwalt
ğŸ¥	takiwitt
ğŸ…	taá¹­umaá¹­ict
ğŸ¥¥	iÉ£san n koko
ğŸ¥‘	tavukatt
ğŸ†	tapatengalt
ğŸ¥”	tabaá¹­aá¹­att
ğŸ¥•	taáº“rudgatt
ğŸŒ½	ageá¹­á¹­uc
ğŸ¥’	ilekkel
ğŸ¥¬	Tidelt n iferrawen izegzawen
ğŸ„	taá¹›eÉ£lett
ğŸ¥œ	takawkawt
ğŸ¥„	tajÉ£elt
ğŸ”ª	tafruyt n usaÄÄet
ğŸº	abuqal
ğŸŒ	amtiweg turuft tafriqt
ğŸŒ	amtiweg asya ustralya
ğŸ—¾	takará¸a n Japun
ğŸ§­	tabusult
ğŸŒ‹	aburkan
ğŸ—»	Taqacuct Fuji
ğŸ§±	Tayajuá¹›t
ğŸ¡	axxam s tmazirt
ğŸ¢	aá¹£uk n tnariyin
ğŸ£	tanazent tajapunit
ğŸ¤	tanarit n tnazent
ğŸ¥	Asegnaf
ğŸ¦	tabanka
ğŸ¨	asensu
ğŸ©	asensu n tayri
ğŸª	talzuzt
ğŸ«	aÉ£erbaz
ğŸ¬	taá¸¥anut meqqren
ğŸ¯	tiÉ£remt tajapunit
ğŸ°	tiÉ£remt
ğŸ’’	tissulya
ğŸ—¼	TiÉ£remt n Tokyo
ğŸ—½	lemqam n tlelli
ğŸ•Œ	tamezgida n inselmen
ğŸ•	tamezgida n udayen
ğŸ•‹	lkaÉ›va
ğŸŒ	agu
ğŸŒƒ	iá¸ s itran
ğŸšˆ	amitru afess
ğŸš“	Takerrust n temsulta
ğŸš•	Ataksi
ğŸš—	Takerrust
ğŸ›¹	Avilu
ğŸš¨	Taftilt n tkerrust n tmsulta
ğŸ’º	tasÉ£imt
ğŸš	talikuptirt
ğŸš€	tallunt
ğŸ›¸	taÉ£awsa tarussint yettafgen
ğŸ”¥	times
ğŸƒ	taxsayt
ğŸ†	asfugel
ğŸ‡	ifá¹­iwej
âœ¨	itran
ğŸˆ	asfugel
ğŸ€	asfugel
ğŸ«	atiki
ğŸ…	ciÉ›a n waddal
ğŸ¥‡	ciÉ›a n dhev
ğŸ¥ˆ	ciÉ›a n lfeá¹­á¹­a
ğŸ¥‰	ciÉ›a n bá¹›unz
ğŸ”®	takurt n ukrisá¹­al
ğŸ´	takará¸a, urar
ğŸ”‡	asusam
ğŸ”‰	imesli
ğŸ”Š	imesli
ğŸ“£	amigafun
ğŸµ	tazmilt taáº“awant
ğŸ¶	tizmilin tiáº“awanin
ğŸ·	asaksufun
ğŸ¸	snitra
ğŸ“±	tiliÉ£ri tazirazt
ğŸ”‹	aáº“ru
ğŸ’½	aá¸ebsi n uselkim
ğŸ¥	takamirat
ğŸ“”	imedlis s tduli icebá¸¥en
ğŸ“•	adlis imedlen
ğŸ“–	adlis yeldin
ğŸ“—	adlis azegzaw
ğŸ“˜	adlis amidadi
ğŸ“™	adlis aÄinawi
ğŸ““	imedlis
ğŸ“’	ambellez
ğŸ“ƒ	asebter yettwasekwren
ğŸ“œ	adrurem
ğŸ“„	asebter
ğŸ“°	aÉ£mis
ğŸ“‘	tacreá¹­, tacreá¹­ n usebter
ğŸ”–	tacreá¹­ n usebter
ğŸ’²	adulaá¹›, idrimen, tadrimt
ğŸ“§	imayl
ğŸ“¨	izen ukcim
ğŸ“©	izen yettwazen
ğŸ“	akaram n ufaylu
ğŸ“‚	ldi akaram n ufaylu
ğŸ“†	awitay
ğŸ”¨	afecku
ğŸ”—	aseÉ£wen
ğŸ’‰	tisegnit
ğŸ’Š	amejjay, amuá¸in, tujjya
ğŸšª	tabburt
ğŸ›’	taqecwalt n tiÉ£in
ğŸš¬	ageá¹›á¹›u
ğŸ§	tamacint n tedrimt tawurmant
ğŸš®	tignit n iá¸umman
ğŸš°	aman deg ufus
ğŸš»	azamul n teslalayt
ğŸš¾	taslalayt
ğŸ”ƒ	ineccaben tanila n isegnan n temrilt
ğŸ”„	taqeffalt n ineccaben n tnila yettin n isegnan n temrilt
ğŸ”™	Aneccab n tuÉ£alin
ğŸ”š	Aneccab n tagara
ğŸ”›	urmid
ğŸ”œ	Aneccab Qrib
ğŸ”	aneccab n ufalla
â›	Aáº“udyak
ğŸ”€	Aneccab anmidag
ğŸ”	aneccab imdewweá¹›
â–¶	taqeffalt n tÉ£uri
ğŸ¦	sinima
ğŸ	anay s texxamin
ğŸš©	anay azeggaÉ£
ğŸŒ	anayen ijapuniyen
ğŸ´	anay aberkan
ğŸ³â€ğŸŒˆ	anay n teslit n unáº“ar
â†”ï¸	aneccab azelmaá¸ ayeffus
â†•ï¸	aneccab asawen akesser
â†–ï¸	aneccab asawen azelmaá¸
â†—ï¸	aneccab d asawen uáº“áº“il
â†˜ï¸	aneccab d akesser uáº“áº“il
â†™ï¸	aneccab akesser ayeffus
â†©ï¸	aneccab ayeffus yettin s azelmaá¸
â†ªï¸	aneccab azelmaá¸ yettin s ayeffus
âŒšï¸	tamrilt
âŒ›ï¸	tamrilt n ijdan
âŒ¨ï¸	anasiw
âï¸	taqeffalt n senzelli
â±ï¸	amesnakud
â²ï¸	Asakway
â³ï¸	tamrilt n ijdan yettmirin
â˜€ï¸	iá¹­ij
â˜ï¸	asigna
â˜˜ï¸	ikeffis
â˜¹ï¸	udem amiglaz
â˜ºï¸	udem n ucmumeá¸¥
â™ˆï¸	Ikerri
â™‰ï¸	Aramul
â™Šï¸	Akniwen
â™‹ï¸	Afurray
â™Œï¸	Izem
â™ï¸	Taá¸¥bayrit
â™ï¸	Tacihant
â™ï¸	TiÉ£irdemt
â™ï¸	Amnaccab
â™‘ï¸	Aqelwac
â™’ï¸	Azfuf
â™“ï¸	Islem
â™¿ï¸	azamul n unekcum n uneÉ›yabu
âš™ï¸	afecku
âš°ï¸	tamettant
âš½ï¸	ÄÄir n dabax n uá¸ar
â›…ï¸	asigna, iá¹­ij
â›‘ï¸	akaskiá¸ amidag amellal
â›©ï¸	lemqam shrine
â›ªï¸	tamezgida n imasiá¸¥iyen
â›°ï¸	adrar
â›²ï¸	tala
â›ºï¸	aqiá¸un
âœˆï¸	asafag
âœ‰ï¸	tajellabt
âœï¸	imru
âœ’ï¸	imru n tricet aberkan
â¡ï¸	aneccab ayeffus
â¤´ï¸	aneccab ayeffus yettin d asawen
â¤µï¸	aneccab ayeffus yettin d akesser
â¬…ï¸	aneccab azelmaá¸
â¬†ï¸	aneccab d asawen
â¬‡ï¸	aneccab akesser
ğŸ€„ï¸	azeggaÉ£, mahjong, urar
ğŸŒï¸	amtiweg timrikin
ğŸŒ¡ï¸	atirmumitr
ğŸŒ¤ï¸	asigna, iá¹­ij
ğŸŒ«ï¸	asigna
ğŸŒ¶ï¸	ifelfel azggaÉ£
ğŸ“ï¸	agerdas
ğŸ–ï¸	ciÉ›a taserdasant
ğŸ†ï¸	arraz
ğŸ”ï¸	adrar n udfel
ğŸ•ï¸	asdar
ğŸ—ï¸	bennu n uzadaÉ£
ğŸ˜ï¸	ixxamen
ğŸ™ï¸	tamdint
ğŸšï¸	axxam yettwaá¸eggren
ğŸ›ï¸	amedruz aklasikan
ğŸœï¸	aneáº“ruf
ğŸï¸	tigzirt taneáº“ruft
ğŸï¸	amá¹›aá¸¥ aÉ£elnaw
ğŸŸï¸	annar
ğŸ ï¸	axxam
ğŸ­ï¸	taneÉ£raft
ğŸ³ï¸	anay amellal
ğŸµï¸	tawardit
ğŸ·ï¸	tabzimt
ğŸ•ï¸	aydi
ğŸ’»ï¸	aselkim aziraz
ğŸ“šï¸	idlisen
ğŸ“¤ï¸	tanaka n tuzna
ğŸ“·ï¸	Takamiá¹›at
ğŸ“ºï¸	tiliáº“ri
ğŸ“»ï¸	rradyu
ğŸ“½ï¸	ameskan n yisura
ğŸ”ˆï¸	imesli
ğŸ”’ï¸	yeskweá¹›
ğŸ”“ï¸	yeldi
ğŸ•·ï¸	tissist
ğŸ•¸ï¸	azeá¹­á¹­a n tissit
ğŸ–¥ï¸	aselkim n tnarit
ğŸ–¨ï¸	tasaggazt
ğŸ–±ï¸	taÉ£erdayt n uselkim
ğŸ–²ï¸	aselkim
ğŸ—³ï¸	asenduq
ğŸ—ºï¸	takará¸a n umaá¸al
ğŸ˜ï¸	war awal
ğŸš‡ï¸	amitá¹›u
ğŸš¹ï¸	azamul n urgaz
ğŸšºï¸	azamul n tmeá¹­á¹­ut
ğŸš¼ï¸	azamul n á¹£ebyan
ğŸ›¡ï¸	abeckiá¸
ğŸ›©ï¸	asafag ameáº“yan
ğŸ›°ï¸	Aá¹£atilit
