,	ticcert
ØŒ	ticcert taÉ›rabt
Â·	taneqqiá¸t talemmast
Â§	taseddart
Â°	tafesna
â†	aneccab s azelmaá¸
â†’	aneccab s ayeffus
â†“	aneccab d akesser
â‡…	aneccab d asawen d uneccab d akessar
â‡†	aneccab azelmaá¸ nnig n uneccab ayeffus
âˆ‡	nabla
âˆˆ	aferdis n
+	azamul n tmerna
=	yegda
Â¬	tibawt
âˆ©	amyegzem
âˆª	tadukkli
â—	tawinest yeÄÄuren
ğŸ˜€	acmumeá¸¥ meqqren
ğŸ˜ƒ	udem n ucmumeá¸¥ s wallen yeldin
ğŸ˜„	acmumaá¸¥ amesrar
ğŸ˜	acmumeá¸¥ n tuÉ£mas meá¹›á¹›a
ğŸ˜†	udem icmumá¸¥en s yimi yeldin d wallen imedlen
ğŸ˜…	udem icmumá¸¥en s leá¸¥ya
ğŸ¤£	axbibeá¸ deg lqaÉ›a seg teá¸sa
ğŸ˜‚	taá¸sa almi i d-É£lin imeá¹­á¹­awen
ğŸ™‚	acmumeá¸¥ afessas
ğŸ™ƒ	udem yettin d akessar
ğŸ« 	udem yefsin
ğŸ˜‰	udem yemmalen aÉ£maz n tiá¹­
ğŸ˜Š	udem innecá¹›aá¸¥en s wallen icmumá¸¥en
ğŸ¥°	udem yecmumá¸¥en s wulawen
ğŸ˜	udem yecmumá¸¥en s wallen am wulawen
ğŸ¤©	udem yecmumá¸¥en s wallen am yitran
ğŸ˜˜	tasudent d wul
ğŸ˜—	tasudent
â˜ºï¸	udem n ucmumeá¸¥
ğŸ˜š	tasudent allen medlent
ğŸ˜™	tasudent meqren
ğŸ¥²	udem yecmumá¸¥en s yimeá¹­á¹­awen
ğŸ˜‹	udem yessibninen uÄÄi
ğŸ˜›	Udem s yiles
ğŸ˜œ	Udem yessufÉ£en iles
ğŸ¤ª	udem yesseá¸sayen
ğŸ¤—	udem yefkan ahennec
ğŸ¤­	udem s ufus É£ef yimi
ğŸ«¢	udem s wallen yeldin d ufus É£ef yimi
ğŸ¤«	udem asusam
ğŸ¤”	udem ikecmen di ttexmim
ğŸ¤	udem d yimi ixaden
ğŸ¤¨	afus irefden iá¸udan bejqen
ğŸ˜ï¸	war awal
ğŸ˜‘	udem war asunfal
ğŸ˜¶	ulac imi
ğŸ˜	acmumeh n tiherci
ğŸ˜’	udem ameklu
ğŸ™„	baÉ›ar s wallen
ğŸ¤¥	udem yeskiddiben
ğŸ˜Œ	udem yenirsen
ğŸ˜ª	udem yeá¹­á¹­sen
ğŸ¤¤	asluddu
ğŸ˜´	udem anudam
ğŸ˜·	udem s tgelmust
ğŸ¤’	udem s utirmumitr
ğŸ¤•	udem icudden deg uqerruy
ğŸ¤®	udem yettarran
ğŸ¤§	udem yettaá¸asen
ğŸ¥µ	udem yerÉ£an
ğŸ¥¶	udem asemmaá¸
ğŸ˜	acmumeá¸¥ s nwader n yiá¹­ij
ğŸ˜•	udem iÎµewqen
ğŸ˜Ÿ	udem yuggaden
â˜¹ï¸	udem amiglaz
ğŸ˜®	udem s yimi yeldin
ğŸ˜¯	udem war taÉ£ect
ğŸ˜¥	uk
ğŸ˜¢	udem yettrun
ğŸ˜£	udem akayay
ğŸ˜«	udem yeÉ›yan
ğŸ¥±	udem yettfan
ğŸ˜ 	udem yerfan
ğŸ˜ˆ	udem yeá¸san s wacciwen
ğŸ‘¿	udem yerfan s wacciwen
ğŸ¤¡	udem yesseá¸sayen
ğŸ‘¹	waÉ£zen
ğŸ‘»	afuná¹­um
ğŸ’	ul itezzin
ğŸ’•	sin wulawen
ğŸ’Ÿ	acebbeá¸¥ n wul
â£ï¸	ul ibehten
ğŸ’”	ul yeráº“en
â¤ï¸	ul azeggaÉ£
ğŸ§¡	ul aÄini
ğŸ’›	ul awreÉ£
ğŸ’š	ul azegzaw
ğŸ’™	ul anili
ğŸ’œ	ul ademdam
ğŸ¤	ul aqehwi
ğŸ–¤	ul aberkan
ğŸ¤	ul amellal
ğŸ•³ï¸	amruj
ğŸ’¬	tanaka n wawal
ğŸ—¨ï¸	tanaka n wawal tazelmaá¸t
ğŸ—¯ï¸	tanaka n reffu tayeffust
ğŸ’­	tanaka n tikta
ğŸ’¤	zzz
ğŸ‘‹	afus yettwehhin
ğŸ‘‹ğŸ»	afus yettwehhin, afus yettwehhin: taglimt taceÉ›lalt, taglimt taceÉ›lalt
ğŸ‘‹ğŸ¼	afus yettwehhin, afus yettwehhin: tagwlimt taceÉ›lalt talemmast, tagwlimt taceÉ›lalt talemmast
ğŸ‘‹ğŸ½	afus yettwehhin, afus yettwehhin: taglimt talemmast, taglimt talemmast
ğŸ‘‹ğŸ¾	afus yettwehhin, afus yettwehhin: taglimt tubrikt talemmast, taglimt tubrikt talemmast
ğŸ‘‹ğŸ¿	afus yettwehhin, afus yettwehhin: taglimt tubrikt, taglimt tubrikt
ğŸ¤š	talwaá¸¥t n ufus irefden
ğŸ¤šğŸ»	taglimt taceÉ›lalt, talwaá¸¥t n ufus irefden, talwaá¸¥t n ufus irefden: taglimt taceÉ›lalt
ğŸ¤šğŸ¼	tagwlimt taceÉ›lalt talemmast, talwaá¸¥t n ufus irefden, talwaá¸¥t n ufus irefden: tagwlimt taceÉ›lalt talemmast
ğŸ¤šğŸ½	taglimt talemmast, talwaá¸¥t n ufus irefden, talwaá¸¥t n ufus irefden: taglimt talemmast
ğŸ¤šğŸ¾	taglimt tubrikt talemmast, talwaá¸¥t n ufus irefden, talwaá¸¥t n ufus irefden: taglimt tubrikt talemmast
ğŸ¤šğŸ¿	taglimt tubrikt, talwaá¸¥t n ufus irefden, talwaá¸¥t n ufus irefden: taglimt tubrikt
ğŸ–ï¸	afus s yiá¸udan yeldin
ğŸ–ğŸ»	afus s yiá¸udan yeldin, afus s yiá¸udan yeldin: taglimt taceÉ›lalt, taglimt taceÉ›lalt
ğŸ–ğŸ¼	afus s yiá¸udan yeldin, afus s yiá¸udan yeldin: tagwlimt taceÉ›lalt talemmast, tagwlimt taceÉ›lalt talemmast
ğŸ–ğŸ½	afus s yiá¸udan yeldin, afus s yiá¸udan yeldin: taglimt talemmast, taglimt talemmast
ğŸ–ğŸ¾	afus s yiá¸udan yeldin, afus s yiá¸udan yeldin: taglimt tubrikt talemmast, taglimt tubrikt talemmast
ğŸ–ğŸ¿	afus s yiá¸udan yeldin, afus s yiá¸udan yeldin: taglimt tubrikt, taglimt tubrikt
âœ‹	afus irefden
âœ‹ğŸ»	afus irefden, afus irefden: taglimt taceÉ›lalt, taglimt taceÉ›lalt
âœ‹ğŸ¼	afus irefden, afus irefden: tagwlimt taceÉ›lalt talemmast, tagwlimt taceÉ›lalt talemmast
âœ‹ğŸ½	afus irefden, afus irefden: taglimt talemmast, taglimt talemmast
âœ‹ğŸ¾	afus irefden, afus irefden: taglimt tubrikt talemmast, taglimt tubrikt talemmast
âœ‹ğŸ¿	afus irefden, afus irefden: taglimt tubrikt, taglimt tubrikt
ğŸ––	aburkan n tezmert
ğŸ––ğŸ»	aburkan n tezmert, aburkan n tezmert: taglimt taceÉ›lalt, taglimt taceÉ›lalt
ğŸ––ğŸ¼	aburkan n tezmert, aburkan n tezmert: tagwlimt taceÉ›lalt talemmast, tagwlimt taceÉ›lalt talemmast
ğŸ––ğŸ½	aburkan n tezmert, aburkan n tezmert: taglimt talemmast, taglimt talemmast
ğŸ––ğŸ¾	aburkan n tezmert, aburkan n tezmert: taglimt tubrikt talemmast, taglimt tubrikt talemmast
ğŸ––ğŸ¿	aburkan n tezmert, aburkan n tezmert: taglimt tubrikt, taglimt tubrikt
ğŸ«±	afus ayeffus
ğŸ«±ğŸ»	afus ayeffus, afus ayeffus: taglimt taceÉ›lalt, taglimt taceÉ›lalt
ğŸ«±ğŸ¼	afus ayeffus, afus ayeffus: tagwlimt taceÉ›lalt talemmast, tagwlimt taceÉ›lalt talemmast
ğŸ«±ğŸ½	afus ayeffus, afus ayeffus: taglimt talemmast, taglimt talemmast
ğŸ«±ğŸ¾	afus ayeffus, afus ayeffus: taglimt tubrikt talemmast, taglimt tubrikt talemmast
ğŸ«±ğŸ¿	afus ayeffus, afus ayeffus: taglimt tubrikt, taglimt tubrikt
ğŸ«±ğŸ»â€ğŸ«²ğŸ¼	amsalem, amsalem: taglimt taceÉ›lalt, tagwlimt taceÉ›lalt talemmast, taglimt taceÉ›lalt, tagwlimt taceÉ›lalt talemmast
ğŸ«±ğŸ»â€ğŸ«²ğŸ½	amsalem, amsalem: taglimt taceÉ›lalt, taglimt talemmast, taglimt taceÉ›lalt, taglimt talemmast
ğŸ«±ğŸ»â€ğŸ«²ğŸ¾	amsalem, amsalem: taglimt taceÉ›lalt, taglimt tubrikt talemmast, taglimt taceÉ›lalt, taglimt tubrikt talemmast
ğŸ«±ğŸ»â€ğŸ«²ğŸ¿	amsalem, amsalem: taglimt taceÉ›lalt, taglimt tubrikt, taglimt taceÉ›lalt, taglimt tubrikt
ğŸ«±ğŸ¼â€ğŸ«²ğŸ»	amsalem, amsalem: tagwlimt taceÉ›lalt talemmast, taglimt taceÉ›lalt, taglimt taceÉ›lalt, tagwlimt taceÉ›lalt talemmast
ğŸ«±ğŸ¼â€ğŸ«²ğŸ½	amsalem, amsalem: tagwlimt taceÉ›lalt talemmast, taglimt talemmast, taglimt talemmast, tagwlimt taceÉ›lalt talemmast
ğŸ«±ğŸ¼â€ğŸ«²ğŸ¾	amsalem, amsalem: tagwlimt taceÉ›lalt talemmast, taglimt tubrikt talemmast, taglimt tubrikt talemmast, tagwlimt taceÉ›lalt talemmast
ğŸ«±ğŸ¼â€ğŸ«²ğŸ¿	amsalem, amsalem: tagwlimt taceÉ›lalt talemmast, taglimt tubrikt, taglimt tubrikt, tagwlimt taceÉ›lalt talemmast
ğŸ«±ğŸ½â€ğŸ«²ğŸ»	amsalem, amsalem: taglimt talemmast, taglimt taceÉ›lalt, taglimt taceÉ›lalt, taglimt talemmast
ğŸ«±ğŸ½â€ğŸ«²ğŸ¼	amsalem, amsalem: taglimt talemmast, tagwlimt taceÉ›lalt talemmast, taglimt talemmast, tagwlimt taceÉ›lalt talemmast
ğŸ«±ğŸ½â€ğŸ«²ğŸ¾	amsalem, amsalem: taglimt talemmast, taglimt tubrikt talemmast, taglimt talemmast, taglimt tubrikt talemmast
ğŸ«±ğŸ½â€ğŸ«²ğŸ¿	amsalem, amsalem: taglimt talemmast, taglimt tubrikt, taglimt talemmast, taglimt tubrikt
ğŸ«±ğŸ¾â€ğŸ«²ğŸ»	amsalem, amsalem: taglimt tubrikt talemmast, taglimt taceÉ›lalt, taglimt taceÉ›lalt, taglimt tubrikt talemmast
ğŸ«±ğŸ¾â€ğŸ«²ğŸ¼	amsalem, amsalem: taglimt tubrikt talemmast, tagwlimt taceÉ›lalt talemmast, taglimt tubrikt talemmast, tagwlimt taceÉ›lalt talemmast
ğŸ«±ğŸ¾â€ğŸ«²ğŸ½	amsalem, amsalem: taglimt tubrikt talemmast, taglimt talemmast, taglimt talemmast, taglimt tubrikt talemmast
ğŸ«±ğŸ¾â€ğŸ«²ğŸ¿	amsalem, amsalem: taglimt tubrikt talemmast, taglimt tubrikt, taglimt tubrikt, taglimt tubrikt talemmast
ğŸ«±ğŸ¿â€ğŸ«²ğŸ»	amsalem, amsalem: taglimt tubrikt, taglimt taceÉ›lalt, taglimt taceÉ›lalt, taglimt tubrikt
ğŸ«±ğŸ¿â€ğŸ«²ğŸ¼	amsalem, amsalem: taglimt tubrikt, tagwlimt taceÉ›lalt talemmast, taglimt tubrikt, tagwlimt taceÉ›lalt talemmast
ğŸ«±ğŸ¿â€ğŸ«²ğŸ½	amsalem, amsalem: taglimt tubrikt, taglimt talemmast, taglimt talemmast, taglimt tubrikt
ğŸ«±ğŸ¿â€ğŸ«²ğŸ¾	amsalem, amsalem: taglimt tubrikt, taglimt tubrikt talemmast, taglimt tubrikt, taglimt tubrikt talemmast
ğŸ«²	afus azelmaá¸
ğŸ«²ğŸ»	afus azelmaá¸, afus azelmaá¸: taglimt taceÉ›lalt, taglimt taceÉ›lalt
ğŸ«²ğŸ¼	afus azelmaá¸, afus azelmaá¸: tagwlimt taceÉ›lalt talemmast, tagwlimt taceÉ›lalt talemmast
ğŸ«²ğŸ½	afus azelmaá¸, afus azelmaá¸: taglimt talemmast, taglimt talemmast
ğŸ«²ğŸ¾	afus azelmaá¸, afus azelmaá¸: taglimt tubrikt talemmast, taglimt tubrikt talemmast
ğŸ«²ğŸ¿	afus azelmaá¸, afus azelmaá¸: taglimt tubrikt, taglimt tubrikt
ğŸ«³	tidikelt d akesser
ğŸ«³ğŸ»	taglimt taceÉ›lalt, tidikelt d akesser, tidikelt d akesser: taglimt taceÉ›lalt
ğŸ«³ğŸ¼	tagwlimt taceÉ›lalt talemmast, tidikelt d akesser, tidikelt d akesser: tagwlimt taceÉ›lalt talemmast
ğŸ«³ğŸ½	taglimt talemmast, tidikelt d akesser, tidikelt d akesser: taglimt talemmast
ğŸ«³ğŸ¾	taglimt tubrikt talemmast, tidikelt d akesser, tidikelt d akesser: taglimt tubrikt talemmast
ğŸ«³ğŸ¿	taglimt tubrikt, tidikelt d akesser, tidikelt d akesser: taglimt tubrikt
ğŸ«´	tidikelt d asawen
ğŸ«´ğŸ»	taglimt taceÉ›lalt, tidikelt d asawen, tidikelt d asawen: taglimt taceÉ›lalt
ğŸ«´ğŸ¼	tagwlimt taceÉ›lalt talemmast, tidikelt d asawen, tidikelt d asawen: tagwlimt taceÉ›lalt talemmast
ğŸ«´ğŸ½	taglimt talemmast, tidikelt d asawen, tidikelt d asawen: taglimt talemmast
ğŸ«´ğŸ¾	taglimt tubrikt talemmast, tidikelt d asawen, tidikelt d asawen: taglimt tubrikt talemmast
ğŸ«´ğŸ¿	taglimt tubrikt, tidikelt d asawen, tidikelt d asawen: taglimt tubrikt
ğŸ‘Œ	afus n IH
ğŸ‘ŒğŸ»	afus n IH, afus n IH: taglimt taceÉ›lalt, taglimt taceÉ›lalt
ğŸ‘ŒğŸ¼	afus n IH, afus n IH: tagwlimt taceÉ›lalt talemmast, tagwlimt taceÉ›lalt talemmast
ğŸ‘ŒğŸ½	afus n IH, afus n IH: taglimt talemmast, taglimt talemmast
ğŸ‘ŒğŸ¾	afus n IH, afus n IH: taglimt tubrikt talemmast, taglimt tubrikt talemmast
ğŸ‘ŒğŸ¿	afus n IH, afus n IH: taglimt tubrikt, taglimt tubrikt
ğŸ¤Œ	Iduá¸an yemlalen
ğŸ¤ŒğŸ»	Iduá¸an yemlalen, Iduá¸an yemlalen: taglimt taceÉ›lalt, taglimt taceÉ›lalt
ğŸ¤ŒğŸ¼	Iduá¸an yemlalen, Iduá¸an yemlalen: tagwlimt taceÉ›lalt talemmast, tagwlimt taceÉ›lalt talemmast
ğŸ¤ŒğŸ½	Iduá¸an yemlalen, Iduá¸an yemlalen: taglimt talemmast, taglimt talemmast
ğŸ¤ŒğŸ¾	Iduá¸an yemlalen, Iduá¸an yemlalen: taglimt tubrikt talemmast, taglimt tubrikt talemmast
ğŸ¤ŒğŸ¿	Iduá¸an yemlalen, Iduá¸an yemlalen: taglimt tubrikt, taglimt tubrikt
ğŸ¤	tubbya n ufus
ğŸ¤ğŸ»	taglimt taceÉ›lalt, tubbya n ufus, tubbya n ufus: taglimt taceÉ›lalt
ğŸ¤ğŸ¼	tagwlimt taceÉ›lalt talemmast, tubbya n ufus, tubbya n ufus: tagwlimt taceÉ›lalt talemmast
ğŸ¤ğŸ½	taglimt talemmast, tubbya n ufus, tubbya n ufus: taglimt talemmast
ğŸ¤ğŸ¾	taglimt tubrikt talemmast, tubbya n ufus, tubbya n ufus: taglimt tubrikt talemmast
ğŸ¤ğŸ¿	taglimt tubrikt, tubbya n ufus, tubbya n ufus: taglimt tubrikt
âœŒï¸	afus n rrbeá¸¥
âœŒğŸ»	afus n rrbeá¸¥, afus n rrbeá¸¥: taglimt taceÉ›lalt, taglimt taceÉ›lalt
âœŒğŸ¼	afus n rrbeá¸¥, afus n rrbeá¸¥: tagwlimt taceÉ›lalt talemmast, tagwlimt taceÉ›lalt talemmast
âœŒğŸ½	afus n rrbeá¸¥, afus n rrbeá¸¥: taglimt talemmast, taglimt talemmast
âœŒğŸ¾	afus n rrbeá¸¥, afus n rrbeá¸¥: taglimt tubrikt talemmast, taglimt tubrikt talemmast
âœŒğŸ¿	afus n rrbeá¸¥, afus n rrbeá¸¥: taglimt tubrikt, taglimt tubrikt
ğŸ¤	iá¸udan yemcubbaken
ğŸ¤ğŸ»	iá¸udan yemcubbaken, iá¸udan yemcubbaken: taglimt taceÉ›lalt, taglimt taceÉ›lalt
ğŸ¤ğŸ¼	iá¸udan yemcubbaken, iá¸udan yemcubbaken: tagwlimt taceÉ›lalt talemmast, tagwlimt taceÉ›lalt talemmast
ğŸ¤ğŸ½	iá¸udan yemcubbaken, iá¸udan yemcubbaken: taglimt talemmast, taglimt talemmast
ğŸ¤ğŸ¾	iá¸udan yemcubbaken, iá¸udan yemcubbaken: taglimt tubrikt talemmast, taglimt tubrikt talemmast
ğŸ¤ğŸ¿	iá¸udan yemcubbaken, iá¸udan yemcubbaken: taglimt tubrikt, taglimt tubrikt
ğŸ«°	afus s udebbuz d ccahed yemcubbaken
ğŸ«°ğŸ»	afus s udebbuz d ccahed yemcubbaken, afus s udebbuz d ccahed yemcubbaken: taglimt taceÉ›lalt, taglimt taceÉ›lalt
ğŸ«°ğŸ¼	afus s udebbuz d ccahed yemcubbaken, afus s udebbuz d ccahed yemcubbaken: tagwlimt taceÉ›lalt talemmast, tagwlimt taceÉ›lalt talemmast
ğŸ«°ğŸ½	afus s udebbuz d ccahed yemcubbaken, afus s udebbuz d ccahed yemcubbaken: taglimt talemmast, taglimt talemmast
ğŸ«°ğŸ¾	afus s udebbuz d ccahed yemcubbaken, afus s udebbuz d ccahed yemcubbaken: taglimt tubrikt talemmast, taglimt tubrikt talemmast
ğŸ«°ğŸ¿	afus s udebbuz d ccahed yemcubbaken, afus s udebbuz d ccahed yemcubbaken: taglimt tubrikt, taglimt tubrikt
ğŸ¤Ÿ	afus n tayri
ğŸ¤ŸğŸ»	afus n tayri, afus n tayri: taglimt taceÉ›lalt, taglimt taceÉ›lalt
ğŸ¤ŸğŸ¼	afus n tayri, afus n tayri: tagwlimt taceÉ›lalt talemmast, tagwlimt taceÉ›lalt talemmast
ğŸ¤ŸğŸ½	afus n tayri, afus n tayri: taglimt talemmast, taglimt talemmast
ğŸ¤ŸğŸ¾	afus n tayri, afus n tayri: taglimt tubrikt talemmast, taglimt tubrikt talemmast
ğŸ¤ŸğŸ¿	afus n tayri, afus n tayri: taglimt tubrikt, taglimt tubrikt
ğŸ¤˜	azamul n wacciwen
ğŸ¤˜ğŸ»	azamul n wacciwen, azamul n wacciwen: taglimt taceÉ›lalt, taglimt taceÉ›lalt
ğŸ¤˜ğŸ¼	azamul n wacciwen, azamul n wacciwen: tagwlimt taceÉ›lalt talemmast, tagwlimt taceÉ›lalt talemmast
ğŸ¤˜ğŸ½	azamul n wacciwen, azamul n wacciwen: taglimt talemmast, taglimt talemmast
ğŸ¤˜ğŸ¾	azamul n wacciwen, azamul n wacciwen: taglimt tubrikt talemmast, taglimt tubrikt talemmast
ğŸ¤˜ğŸ¿	azamul n wacciwen, azamul n wacciwen: taglimt tubrikt, taglimt tubrikt
ğŸ¤™	afus n usiwel
ğŸ¤™ğŸ»	afus n usiwel, afus n usiwel: taglimt taceÉ›lalt, taglimt taceÉ›lalt
ğŸ¤™ğŸ¼	afus n usiwel, afus n usiwel: tagwlimt taceÉ›lalt talemmast, tagwlimt taceÉ›lalt talemmast
ğŸ¤™ğŸ½	afus n usiwel, afus n usiwel: taglimt talemmast, taglimt talemmast
ğŸ¤™ğŸ¾	afus n usiwel, afus n usiwel: taglimt tubrikt talemmast, taglimt tubrikt talemmast
ğŸ¤™ğŸ¿	afus n usiwel, afus n usiwel: taglimt tubrikt, taglimt tubrikt
ğŸ‘ˆï¸	afus s udebbuz yerran s azelmaá¸
ğŸ‘ˆğŸ»	afus s udebbuz yerran s azelmaá¸, afus s udebbuz yerran s azelmaá¸: taglimt taceÉ›lalt, taglimt taceÉ›lalt
ğŸ‘ˆğŸ¼	afus s udebbuz yerran s azelmaá¸, afus s udebbuz yerran s azelmaá¸: tagwlimt taceÉ›lalt talemmast, tagwlimt taceÉ›lalt talemmast
ğŸ‘ˆğŸ½	afus s udebbuz yerran s azelmaá¸, afus s udebbuz yerran s azelmaá¸: taglimt talemmast, taglimt talemmast
ğŸ‘ˆğŸ¾	afus s udebbuz yerran s azelmaá¸, afus s udebbuz yerran s azelmaá¸: taglimt tubrikt talemmast, taglimt tubrikt talemmast
ğŸ‘ˆğŸ¿	afus s udebbuz yerran s azelmaá¸, afus s udebbuz yerran s azelmaá¸: taglimt tubrikt, taglimt tubrikt
ğŸ‘‰ï¸	afus s udebbuz yerran s ayeffus
ğŸ‘‰ğŸ»	afus s udebbuz yerran s ayeffus, afus s udebbuz yerran s ayeffus: taglimt taceÉ›lalt, taglimt taceÉ›lalt
ğŸ‘‰ğŸ¼	afus s udebbuz yerran s ayeffus, afus s udebbuz yerran s ayeffus: tagwlimt taceÉ›lalt talemmast, tagwlimt taceÉ›lalt talemmast
ğŸ‘‰ğŸ½	afus s udebbuz yerran s ayeffus, afus s udebbuz yerran s ayeffus: taglimt talemmast, taglimt talemmast
ğŸ‘‰ğŸ¾	afus s udebbuz yerran s ayeffus, afus s udebbuz yerran s ayeffus: taglimt tubrikt talemmast, taglimt tubrikt talemmast
ğŸ‘‰ğŸ¿	afus s udebbuz yerran s ayeffus, afus s udebbuz yerran s ayeffus: taglimt tubrikt, taglimt tubrikt
ğŸ‘†ï¸	afus s udebbuz yerran d asawen
ğŸ‘†ğŸ»	afus s udebbuz yerran d asawen, afus s udebbuz yerran d asawen: taglimt taceÉ›lalt, taglimt taceÉ›lalt
ğŸ‘†ğŸ¼	afus s udebbuz yerran d asawen, afus s udebbuz yerran d asawen: tagwlimt taceÉ›lalt talemmast, tagwlimt taceÉ›lalt talemmast
ğŸ‘†ğŸ½	afus s udebbuz yerran d asawen, afus s udebbuz yerran d asawen: taglimt talemmast, taglimt talemmast
ğŸ‘†ğŸ¾	afus s udebbuz yerran d asawen, afus s udebbuz yerran d asawen: taglimt tubrikt talemmast, taglimt tubrikt talemmast
ğŸ‘†ğŸ¿	afus s udebbuz yerran d asawen, afus s udebbuz yerran d asawen: taglimt tubrikt, taglimt tubrikt
ğŸ–•	aá¸ad alemmas
ğŸ–•ğŸ»	aá¸ad alemmas, aá¸ad alemmas: taglimt taceÉ›lalt, taglimt taceÉ›lalt
ğŸ–•ğŸ¼	aá¸ad alemmas, aá¸ad alemmas: tagwlimt taceÉ›lalt talemmast, tagwlimt taceÉ›lalt talemmast
ğŸ–•ğŸ½	aá¸ad alemmas, aá¸ad alemmas: taglimt talemmast, taglimt talemmast
ğŸ–•ğŸ¾	aá¸ad alemmas, aá¸ad alemmas: taglimt tubrikt talemmast, taglimt tubrikt talemmast
ğŸ–•ğŸ¿	aá¸ad alemmas, aá¸ad alemmas: taglimt tubrikt, taglimt tubrikt
ğŸ‘‡ï¸	afus s udebbuz yerran d akesser
ğŸ‘‡ğŸ»	afus s udebbuz yerran d akesser, afus s udebbuz yerran d akesser: taglimt taceÉ›lalt, taglimt taceÉ›lalt
ğŸ‘‡ğŸ¼	afus s udebbuz yerran d akesser, afus s udebbuz yerran d akesser: tagwlimt taceÉ›lalt talemmast, tagwlimt taceÉ›lalt talemmast
ğŸ‘‡ğŸ½	afus s udebbuz yerran d akesser, afus s udebbuz yerran d akesser: taglimt talemmast, taglimt talemmast
ğŸ‘‡ğŸ¾	afus s udebbuz yerran d akesser, afus s udebbuz yerran d akesser: taglimt tubrikt talemmast, taglimt tubrikt talemmast
ğŸ‘‡ğŸ¿	afus s udebbuz yerran d akesser, afus s udebbuz yerran d akesser: taglimt tubrikt, taglimt tubrikt
â˜ï¸	ccahed yerran d asawen
â˜ğŸ»	ccahed yerran d asawen, ccahed yerran d asawen: taglimt taceÉ›lalt, taglimt taceÉ›lalt
â˜ğŸ¼	ccahed yerran d asawen, ccahed yerran d asawen: tagwlimt taceÉ›lalt talemmast, tagwlimt taceÉ›lalt talemmast
â˜ğŸ½	ccahed yerran d asawen, ccahed yerran d asawen: taglimt talemmast, taglimt talemmast
â˜ğŸ¾	ccahed yerran d asawen, ccahed yerran d asawen: taglimt tubrikt talemmast, taglimt tubrikt talemmast
â˜ğŸ¿	ccahed yerran d asawen, ccahed yerran d asawen: taglimt tubrikt, taglimt tubrikt
ğŸ«µ	ccahed iwehhan É£er useqdac
ğŸ«µğŸ»	ccahed iwehhan É£er useqdac, ccahed iwehhan É£er useqdac: taglimt taceÉ›lalt, taglimt taceÉ›lalt
ğŸ«µğŸ¼	ccahed iwehhan É£er useqdac, ccahed iwehhan É£er useqdac: tagwlimt taceÉ›lalt talemmast, tagwlimt taceÉ›lalt talemmast
ğŸ«µğŸ½	ccahed iwehhan É£er useqdac, ccahed iwehhan É£er useqdac: taglimt talemmast, taglimt talemmast
ğŸ«µğŸ¾	ccahed iwehhan É£er useqdac, ccahed iwehhan É£er useqdac: taglimt tubrikt talemmast, taglimt tubrikt talemmast
ğŸ«µğŸ¿	ccahed iwehhan É£er useqdac, ccahed iwehhan É£er useqdac: taglimt tubrikt, taglimt tubrikt
ğŸ‘ï¸	adebbuz d asawen
ğŸ‘ğŸ»	adebbuz d asawen, adebbuz d asawen: taglimt taceÉ›lalt, taglimt taceÉ›lalt
ğŸ‘ğŸ¼	adebbuz d asawen, adebbuz d asawen: tagwlimt taceÉ›lalt talemmast, tagwlimt taceÉ›lalt talemmast
ğŸ‘ğŸ½	adebbuz d asawen, adebbuz d asawen: taglimt talemmast, taglimt talemmast
ğŸ‘ğŸ¾	adebbuz d asawen, adebbuz d asawen: taglimt tubrikt talemmast, taglimt tubrikt talemmast
ğŸ‘ğŸ¿	adebbuz d asawen, adebbuz d asawen: taglimt tubrikt, taglimt tubrikt
ğŸ‘ï¸	adebbuz d akessar
ğŸ‘ğŸ»	adebbuz d akessar, adebbuz d akessar: taglimt taceÉ›lalt, taglimt taceÉ›lalt
ğŸ‘ğŸ¼	adebbuz d akessar, adebbuz d akessar: tagwlimt taceÉ›lalt talemmast, tagwlimt taceÉ›lalt talemmast
ğŸ‘ğŸ½	adebbuz d akessar, adebbuz d akessar: taglimt talemmast, taglimt talemmast
ğŸ‘ğŸ¾	adebbuz d akessar, adebbuz d akessar: taglimt tubrikt talemmast, taglimt tubrikt talemmast
ğŸ‘ğŸ¿	adebbuz d akessar, adebbuz d akessar: taglimt tubrikt, taglimt tubrikt
âœŠ	arfad n ufus ikersen
âœŠğŸ»	arfad n ufus ikersen, arfad n ufus ikersen: taglimt taceÉ›lalt, taglimt taceÉ›lalt
âœŠğŸ¼	arfad n ufus ikersen, arfad n ufus ikersen: tagwlimt taceÉ›lalt talemmast, tagwlimt taceÉ›lalt talemmast
âœŠğŸ½	arfad n ufus ikersen, arfad n ufus ikersen: taglimt talemmast, taglimt talemmast
âœŠğŸ¾	arfad n ufus ikersen, arfad n ufus ikersen: taglimt tubrikt talemmast, taglimt tubrikt talemmast
âœŠğŸ¿	arfad n ufus ikersen, arfad n ufus ikersen: taglimt tubrikt, taglimt tubrikt
ğŸ‘Š	awwaá¸ n lbunya
ğŸ‘ŠğŸ»	awwaá¸ n lbunya, awwaá¸ n lbunya: taglimt taceÉ›lalt, taglimt taceÉ›lalt
ğŸ‘ŠğŸ¼	awwaá¸ n lbunya, awwaá¸ n lbunya: tagwlimt taceÉ›lalt talemmast, tagwlimt taceÉ›lalt talemmast
ğŸ‘ŠğŸ½	awwaá¸ n lbunya, awwaá¸ n lbunya: taglimt talemmast, taglimt talemmast
ğŸ‘ŠğŸ¾	awwaá¸ n lbunya, awwaá¸ n lbunya: taglimt tubrikt talemmast, taglimt tubrikt talemmast
ğŸ‘ŠğŸ¿	awwaá¸ n lbunya, awwaá¸ n lbunya: taglimt tubrikt, taglimt tubrikt
ğŸ¤›	afus ikersen É£er uzelmaá¸
ğŸ¤›ğŸ»	afus ikersen É£er uzelmaá¸, afus ikersen É£er uzelmaá¸: taglimt taceÉ›lalt, taglimt taceÉ›lalt
ğŸ¤›ğŸ¼	afus ikersen É£er uzelmaá¸, afus ikersen É£er uzelmaá¸: tagwlimt taceÉ›lalt talemmast, tagwlimt taceÉ›lalt talemmast
ğŸ¤›ğŸ½	afus ikersen É£er uzelmaá¸, afus ikersen É£er uzelmaá¸: taglimt talemmast, taglimt talemmast
ğŸ¤›ğŸ¾	afus ikersen É£er uzelmaá¸, afus ikersen É£er uzelmaá¸: taglimt tubrikt talemmast, taglimt tubrikt talemmast
ğŸ¤›ğŸ¿	afus ikersen É£er uzelmaá¸, afus ikersen É£er uzelmaá¸: taglimt tubrikt, taglimt tubrikt
ğŸ¤œ	afus ikersen É£er uyeffus
ğŸ¤œğŸ»	afus ikersen É£er uyeffus, afus ikersen É£er uyeffus: taglimt taceÉ›lalt, taglimt taceÉ›lalt
ğŸ¤œğŸ¼	afus ikersen É£er uyeffus, afus ikersen É£er uyeffus: tagwlimt taceÉ›lalt talemmast, tagwlimt taceÉ›lalt talemmast
ğŸ¤œğŸ½	afus ikersen É£er uyeffus, afus ikersen É£er uyeffus: taglimt talemmast, taglimt talemmast
ğŸ¤œğŸ¾	afus ikersen É£er uyeffus, afus ikersen É£er uyeffus: taglimt tubrikt talemmast, taglimt tubrikt talemmast
ğŸ¤œğŸ¿	afus ikersen É£er uyeffus, afus ikersen É£er uyeffus: taglimt tubrikt, taglimt tubrikt
ğŸ‘	aá¹£erfeq
ğŸ‘ğŸ»	aá¹£erfeq, aá¹£erfeq: taglimt taceÉ›lalt, taglimt taceÉ›lalt
ğŸ‘ğŸ¼	aá¹£erfeq, aá¹£erfeq: tagwlimt taceÉ›lalt talemmast, tagwlimt taceÉ›lalt talemmast
ğŸ‘ğŸ½	aá¹£erfeq, aá¹£erfeq: taglimt talemmast, taglimt talemmast
ğŸ‘ğŸ¾	aá¹£erfeq, aá¹£erfeq: taglimt tubrikt talemmast, taglimt tubrikt talemmast
ğŸ‘ğŸ¿	aá¹£erfeq, aá¹£erfeq: taglimt tubrikt, taglimt tubrikt
ğŸ™Œ	ifassen yulin
ğŸ™ŒğŸ»	ifassen yulin, ifassen yulin: taglimt taceÉ›lalt, taglimt taceÉ›lalt
ğŸ™ŒğŸ¼	ifassen yulin, ifassen yulin: tagwlimt taceÉ›lalt talemmast, tagwlimt taceÉ›lalt talemmast
ğŸ™ŒğŸ½	ifassen yulin, ifassen yulin: taglimt talemmast, taglimt talemmast
ğŸ™ŒğŸ¾	ifassen yulin, ifassen yulin: taglimt tubrikt talemmast, taglimt tubrikt talemmast
ğŸ™ŒğŸ¿	ifassen yulin, ifassen yulin: taglimt tubrikt, taglimt tubrikt
ğŸ«¶	ifassen am wul
ğŸ«¶ğŸ»	ifassen am wul, ifassen am wul: taglimt taceÉ›lalt, taglimt taceÉ›lalt
ğŸ«¶ğŸ¼	ifassen am wul, ifassen am wul: tagwlimt taceÉ›lalt talemmast, tagwlimt taceÉ›lalt talemmast
ğŸ«¶ğŸ½	ifassen am wul, ifassen am wul: taglimt talemmast, taglimt talemmast
ğŸ«¶ğŸ¾	ifassen am wul, ifassen am wul: taglimt tubrikt talemmast, taglimt tubrikt talemmast
ğŸ«¶ğŸ¿	ifassen am wul, ifassen am wul: taglimt tubrikt, taglimt tubrikt
ğŸ‘	ifassen yeldin
ğŸ‘ğŸ»	ifassen yeldin, ifassen yeldin: taglimt taceÉ›lalt, taglimt taceÉ›lalt
ğŸ‘ğŸ¼	ifassen yeldin, ifassen yeldin: tagwlimt taceÉ›lalt talemmast, tagwlimt taceÉ›lalt talemmast
ğŸ‘ğŸ½	ifassen yeldin, ifassen yeldin: taglimt talemmast, taglimt talemmast
ğŸ‘ğŸ¾	ifassen yeldin, ifassen yeldin: taglimt tubrikt talemmast, taglimt tubrikt talemmast
ğŸ‘ğŸ¿	ifassen yeldin, ifassen yeldin: taglimt tubrikt, taglimt tubrikt
ğŸ¤²	tidikal yeddukklen d asawen
ğŸ¤²ğŸ»	taglimt taceÉ›lalt, tidikal yeddukklen d asawen, tidikal yeddukklen d asawen: taglimt taceÉ›lalt
ğŸ¤²ğŸ¼	tagwlimt taceÉ›lalt talemmast, tidikal yeddukklen d asawen, tidikal yeddukklen d asawen: tagwlimt taceÉ›lalt talemmast
ğŸ¤²ğŸ½	taglimt talemmast, tidikal yeddukklen d asawen, tidikal yeddukklen d asawen: taglimt talemmast
ğŸ¤²ğŸ¾	taglimt tubrikt talemmast, tidikal yeddukklen d asawen, tidikal yeddukklen d asawen: taglimt tubrikt talemmast
ğŸ¤²ğŸ¿	taglimt tubrikt, tidikal yeddukklen d asawen, tidikal yeddukklen d asawen: taglimt tubrikt
ğŸ¤	amsalem
ğŸ¤ğŸ»	amsalem, amsalem: taglimt taceÉ›lalt, taglimt taceÉ›lalt
ğŸ¤ğŸ¼	amsalem, amsalem: tagwlimt taceÉ›lalt talemmast, tagwlimt taceÉ›lalt talemmast
ğŸ¤ğŸ½	amsalem, amsalem: taglimt talemmast, taglimt talemmast
ğŸ¤ğŸ¾	amsalem, amsalem: taglimt tubrikt talemmast, taglimt tubrikt talemmast
ğŸ¤ğŸ¿	amsalem, amsalem: taglimt tubrikt, taglimt tubrikt
ğŸ™	ifassen ineá¹­á¸en
ğŸ™ğŸ»	ifassen ineá¹­á¸en, ifassen ineá¹­á¸en: taglimt taceÉ›lalt, taglimt taceÉ›lalt
ğŸ™ğŸ¼	ifassen ineá¹­á¸en, ifassen ineá¹­á¸en: tagwlimt taceÉ›lalt talemmast, tagwlimt taceÉ›lalt talemmast
ğŸ™ğŸ½	ifassen ineá¹­á¸en, ifassen ineá¹­á¸en: taglimt talemmast, taglimt talemmast
ğŸ™ğŸ¾	ifassen ineá¹­á¸en, ifassen ineá¹­á¸en: taglimt tubrikt talemmast, taglimt tubrikt talemmast
ğŸ™ğŸ¿	ifassen ineá¹­á¸en, ifassen ineá¹­á¸en: taglimt tubrikt, taglimt tubrikt
âœï¸	afus yettarun
âœğŸ»	afus yettarun, afus yettarun: taglimt taceÉ›lalt, taglimt taceÉ›lalt
âœğŸ¼	afus yettarun, afus yettarun: tagwlimt taceÉ›lalt talemmast, tagwlimt taceÉ›lalt talemmast
âœğŸ½	afus yettarun, afus yettarun: taglimt talemmast, taglimt talemmast
âœğŸ¾	afus yettarun, afus yettarun: taglimt tubrikt talemmast, taglimt tubrikt talemmast
âœğŸ¿	afus yettarun, afus yettarun: taglimt tubrikt, taglimt tubrikt
ğŸ’…	iÉ£mi n waccaren
ğŸ’…ğŸ»	iÉ£mi n waccaren, iÉ£mi n waccaren: taglimt taceÉ›lalt, taglimt taceÉ›lalt
ğŸ’…ğŸ¼	iÉ£mi n waccaren, iÉ£mi n waccaren: tagwlimt taceÉ›lalt talemmast, tagwlimt taceÉ›lalt talemmast
ğŸ’…ğŸ½	iÉ£mi n waccaren, iÉ£mi n waccaren: taglimt talemmast, taglimt talemmast
ğŸ’…ğŸ¾	iÉ£mi n waccaren, iÉ£mi n waccaren: taglimt tubrikt talemmast, taglimt tubrikt talemmast
ğŸ’…ğŸ¿	iÉ£mi n waccaren, iÉ£mi n waccaren: taglimt tubrikt, taglimt tubrikt
ğŸ¤³	asilfi
ğŸ¤³ğŸ»	asilfi, asilfi: taglimt taceÉ›lalt, taglimt taceÉ›lalt
ğŸ¤³ğŸ¼	asilfi, asilfi: tagwlimt taceÉ›lalt talemmast, tagwlimt taceÉ›lalt talemmast
ğŸ¤³ğŸ½	asilfi, asilfi: taglimt talemmast, taglimt talemmast
ğŸ¤³ğŸ¾	asilfi, asilfi: taglimt tubrikt talemmast, taglimt tubrikt talemmast
ğŸ¤³ğŸ¿	asilfi, asilfi: taglimt tubrikt, taglimt tubrikt
ğŸ¦¾	iÉ£il n tmacint
ğŸ¦¿	aqejjir n tmacint
ğŸ¦µ	aqejjir
ğŸ¦µğŸ»	aqejjir, aqejjir: taglimt taceÉ›lalt, taglimt taceÉ›lalt
ğŸ¦µğŸ¼	aqejjir, aqejjir: tagwlimt taceÉ›lalt talemmast, tagwlimt taceÉ›lalt talemmast
ğŸ¦µğŸ½	aqejjir, aqejjir: taglimt talemmast, taglimt talemmast
ğŸ¦µğŸ¾	aqejjir, aqejjir: taglimt tubrikt talemmast, taglimt tubrikt talemmast
ğŸ¦µğŸ¿	aqejjir, aqejjir: taglimt tubrikt, taglimt tubrikt
ğŸ¦¶	aá¸ar
ğŸ¦¶ğŸ»	aá¸ar, aá¸ar: taglimt taceÉ›lalt, taglimt taceÉ›lalt
ğŸ¦¶ğŸ¼	aá¸ar, aá¸ar: tagwlimt taceÉ›lalt talemmast, tagwlimt taceÉ›lalt talemmast
ğŸ¦¶ğŸ½	aá¸ar, aá¸ar: taglimt talemmast, taglimt talemmast
ğŸ¦¶ğŸ¾	aá¸ar, aá¸ar: taglimt tubrikt talemmast, taglimt tubrikt talemmast
ğŸ¦¶ğŸ¿	aá¸ar, aá¸ar: taglimt tubrikt, taglimt tubrikt
ğŸ‘‚ï¸	ameáº“áº“uÉ£
ğŸ‘‚ğŸ»	ameáº“áº“uÉ£, ameáº“áº“uÉ£: taglimt taceÉ›lalt, taglimt taceÉ›lalt
ğŸ‘‚ğŸ¼	ameáº“áº“uÉ£, ameáº“áº“uÉ£: tagwlimt taceÉ›lalt talemmast, tagwlimt taceÉ›lalt talemmast
ğŸ‘‚ğŸ½	ameáº“áº“uÉ£, ameáº“áº“uÉ£: taglimt talemmast, taglimt talemmast
ğŸ‘‚ğŸ¾	ameáº“áº“uÉ£, ameáº“áº“uÉ£: taglimt tubrikt talemmast, taglimt tubrikt talemmast
ğŸ‘‚ğŸ¿	ameáº“áº“uÉ£, ameáº“áº“uÉ£: taglimt tubrikt, taglimt tubrikt
ğŸ¦»	ameáº“áº“uÉ£ s ufecku n tmesliwt
ğŸ¦»ğŸ»	ameáº“áº“uÉ£ s ufecku n tmesliwt, ameáº“áº“uÉ£ s ufecku n tmesliwt: taglimt taceÉ›lalt, taglimt taceÉ›lalt
ğŸ¦»ğŸ¼	ameáº“áº“uÉ£ s ufecku n tmesliwt, ameáº“áº“uÉ£ s ufecku n tmesliwt: tagwlimt taceÉ›lalt talemmast, tagwlimt taceÉ›lalt talemmast
ğŸ¦»ğŸ½	ameáº“áº“uÉ£ s ufecku n tmesliwt, ameáº“áº“uÉ£ s ufecku n tmesliwt: taglimt talemmast, taglimt talemmast
ğŸ¦»ğŸ¾	ameáº“áº“uÉ£ s ufecku n tmesliwt, ameáº“áº“uÉ£ s ufecku n tmesliwt: taglimt tubrikt talemmast, taglimt tubrikt talemmast
ğŸ¦»ğŸ¿	ameáº“áº“uÉ£ s ufecku n tmesliwt, ameáº“áº“uÉ£ s ufecku n tmesliwt: taglimt tubrikt, taglimt tubrikt
ğŸ‘ƒ	anzaren
ğŸ‘ƒğŸ»	anzaren, anzaren: taglimt taceÉ›lalt, taglimt taceÉ›lalt
ğŸ‘ƒğŸ¼	anzaren, anzaren: tagwlimt taceÉ›lalt talemmast, tagwlimt taceÉ›lalt talemmast
ğŸ‘ƒğŸ½	anzaren, anzaren: taglimt talemmast, taglimt talemmast
ğŸ‘ƒğŸ¾	anzaren, anzaren: taglimt tubrikt talemmast, taglimt tubrikt talemmast
ğŸ‘ƒğŸ¿	anzaren, anzaren: taglimt tubrikt, taglimt tubrikt
ğŸ§ 	allaÉ£
ğŸ«	turin
ğŸ¦·	tuÉ£mest
ğŸ¦´	iÉ£es
ğŸ‘€	allen
ğŸ‘ï¸	tiá¹­
ğŸ‘…	iles
ğŸ‘„	imi
ğŸ«¦	acenfir yettwakercen
ğŸ‘¶	aá¹­ufan
ğŸ‘¶ğŸ»	aá¹­ufan, aá¹­ufan: taglimt taceÉ›lalt, taglimt taceÉ›lalt
ğŸ‘¶ğŸ¼	aá¹­ufan, aá¹­ufan: tagwlimt taceÉ›lalt talemmast, tagwlimt taceÉ›lalt talemmast
ğŸ‘¶ğŸ½	aá¹­ufan, aá¹­ufan: taglimt talemmast, taglimt talemmast
ğŸ‘¶ğŸ¾	aá¹­ufan, aá¹­ufan: taglimt tubrikt talemmast, taglimt tubrikt talemmast
ğŸ‘¶ğŸ¿	aá¹­ufan, aá¹­ufan: taglimt tubrikt, taglimt tubrikt
ğŸ§’	agrud
ğŸ§’ğŸ»	agrud, agrud: taglimt taceÉ›lalt, taglimt taceÉ›lalt
ğŸ§’ğŸ¼	agrud, agrud: tagwlimt taceÉ›lalt talemmast, tagwlimt taceÉ›lalt talemmast
ğŸ§’ğŸ½	agrud, agrud: taglimt talemmast, taglimt talemmast
ğŸ§’ğŸ¾	agrud, agrud: taglimt tubrikt talemmast, taglimt tubrikt talemmast
ğŸ§’ğŸ¿	agrud, agrud: taglimt tubrikt, taglimt tubrikt
ğŸ‘¦	aqcic
ğŸ‘¦ğŸ»	aqcic, aqcic: taglimt taceÉ›lalt, taglimt taceÉ›lalt
ğŸ‘¦ğŸ¼	aqcic, aqcic: tagwlimt taceÉ›lalt talemmast, tagwlimt taceÉ›lalt talemmast
ğŸ‘¦ğŸ½	aqcic, aqcic: taglimt talemmast, taglimt talemmast
ğŸ‘¦ğŸ¾	aqcic, aqcic: taglimt tubrikt talemmast, taglimt tubrikt talemmast
ğŸ‘¦ğŸ¿	aqcic, aqcic: taglimt tubrikt, taglimt tubrikt
ğŸ‘§	taqcict
ğŸ‘§ğŸ»	taglimt taceÉ›lalt, taqcict, taqcict: taglimt taceÉ›lalt
ğŸ‘§ğŸ¼	tagwlimt taceÉ›lalt talemmast, taqcict, taqcict: tagwlimt taceÉ›lalt talemmast
ğŸ‘§ğŸ½	taglimt talemmast, taqcict, taqcict: taglimt talemmast
ğŸ‘§ğŸ¾	taglimt tubrikt talemmast, taqcict, taqcict: taglimt tubrikt talemmast
ğŸ‘§ğŸ¿	taglimt tubrikt, taqcict, taqcict: taglimt tubrikt
ğŸ§‘	amdan
ğŸ§‘ğŸ»	amdan, amdan: taglimt taceÉ›lalt, taglimt taceÉ›lalt
ğŸ§‘ğŸ¼	amdan, amdan: tagwlimt taceÉ›lalt talemmast, tagwlimt taceÉ›lalt talemmast
ğŸ§‘ğŸ½	amdan, amdan: taglimt talemmast, taglimt talemmast
ğŸ§‘ğŸ¾	amdan, amdan: taglimt tubrikt talemmast, taglimt tubrikt talemmast
ğŸ§‘ğŸ¿	amdan, amdan: taglimt tubrikt, taglimt tubrikt
ğŸ‘±	amdan: acekkuá¸¥ aceÉ›lal
ğŸ‘±ğŸ»	acekkuá¸¥ aceÉ›lal, amdan: acekkuá¸¥ aceÉ›lal, amdan: taglimt taceÉ›lalt, acekkuá¸¥ aceÉ›lal, taglimt taceÉ›lalt
ğŸ‘±ğŸ¼	acekkuá¸¥ aceÉ›lal, amdan: acekkuá¸¥ aceÉ›lal, amdan: tagwlimt taceÉ›lalt talemmast, acekkuá¸¥ aceÉ›lal, tagwlimt taceÉ›lalt talemmast
ğŸ‘±ğŸ½	acekkuá¸¥ aceÉ›lal, amdan: acekkuá¸¥ aceÉ›lal, amdan: taglimt talemmast, acekkuá¸¥ aceÉ›lal, taglimt talemmast
ğŸ‘±ğŸ¾	acekkuá¸¥ aceÉ›lal, amdan: acekkuá¸¥ aceÉ›lal, amdan: taglimt tubrikt talemmast, acekkuá¸¥ aceÉ›lal, taglimt tubrikt talemmast
ğŸ‘±ğŸ¿	acekkuá¸¥ aceÉ›lal, amdan: acekkuá¸¥ aceÉ›lal, amdan: taglimt tubrikt, acekkuá¸¥ aceÉ›lal, taglimt tubrikt
ğŸ§‘ğŸ»â€â¤â€ğŸ§‘ğŸ¼	amdan, taglimt taceÉ›lalt, tagwlimt taceÉ›lalt talemmast, tayuga s wul, tayuga s wul: amdan, amdan, taglimt taceÉ›lalt, tagwlimt taceÉ›lalt talemmast
ğŸ§‘ğŸ»â€â¤â€ğŸ§‘ğŸ½	amdan, taglimt taceÉ›lalt, taglimt talemmast, tayuga s wul, tayuga s wul: amdan, amdan, taglimt taceÉ›lalt, taglimt talemmast
ğŸ§‘ğŸ»â€â¤â€ğŸ§‘ğŸ¾	amdan, taglimt taceÉ›lalt, taglimt tubrikt talemmast, tayuga s wul, tayuga s wul: amdan, amdan, taglimt taceÉ›lalt, taglimt tubrikt talemmast
ğŸ§‘ğŸ»â€â¤â€ğŸ§‘ğŸ¿	amdan, taglimt taceÉ›lalt, taglimt tubrikt, tayuga s wul, tayuga s wul: amdan, amdan, taglimt taceÉ›lalt, taglimt tubrikt
ğŸ§‘ğŸ¼â€â¤â€ğŸ§‘ğŸ»	amdan, taglimt taceÉ›lalt, tagwlimt taceÉ›lalt talemmast, tayuga s wul, tayuga s wul: amdan, amdan, tagwlimt taceÉ›lalt talemmast, taglimt taceÉ›lalt
ğŸ§‘ğŸ¼â€â¤â€ğŸ§‘ğŸ½	amdan, taglimt talemmast, tagwlimt taceÉ›lalt talemmast, tayuga s wul, tayuga s wul: amdan, amdan, tagwlimt taceÉ›lalt talemmast, taglimt talemmast
ğŸ§‘ğŸ¼â€â¤â€ğŸ§‘ğŸ¾	amdan, taglimt tubrikt talemmast, tagwlimt taceÉ›lalt talemmast, tayuga s wul, tayuga s wul: amdan, amdan, tagwlimt taceÉ›lalt talemmast, taglimt tubrikt talemmast
ğŸ§‘ğŸ¼â€â¤â€ğŸ§‘ğŸ¿	amdan, taglimt tubrikt, tagwlimt taceÉ›lalt talemmast, tayuga s wul, tayuga s wul: amdan, amdan, tagwlimt taceÉ›lalt talemmast, taglimt tubrikt
ğŸ§‘ğŸ½â€â¤â€ğŸ§‘ğŸ»	amdan, taglimt taceÉ›lalt, taglimt talemmast, tayuga s wul, tayuga s wul: amdan, amdan, taglimt talemmast, taglimt taceÉ›lalt
ğŸ§‘ğŸ½â€â¤â€ğŸ§‘ğŸ¼	amdan, taglimt talemmast, tagwlimt taceÉ›lalt talemmast, tayuga s wul, tayuga s wul: amdan, amdan, taglimt talemmast, tagwlimt taceÉ›lalt talemmast
ğŸ§‘ğŸ½â€â¤â€ğŸ§‘ğŸ¾	amdan, taglimt talemmast, taglimt tubrikt talemmast, tayuga s wul, tayuga s wul: amdan, amdan, taglimt talemmast, taglimt tubrikt talemmast
ğŸ§‘ğŸ½â€â¤â€ğŸ§‘ğŸ¿	amdan, taglimt talemmast, taglimt tubrikt, tayuga s wul, tayuga s wul: amdan, amdan, taglimt talemmast, taglimt tubrikt
ğŸ§‘ğŸ¾â€â¤â€ğŸ§‘ğŸ»	amdan, taglimt taceÉ›lalt, taglimt tubrikt talemmast, tayuga s wul, tayuga s wul: amdan, amdan, taglimt tubrikt talemmast, taglimt taceÉ›lalt
ğŸ§‘ğŸ¾â€â¤â€ğŸ§‘ğŸ¼	amdan, taglimt tubrikt talemmast, tagwlimt taceÉ›lalt talemmast, tayuga s wul, tayuga s wul: amdan, amdan, taglimt tubrikt talemmast, tagwlimt taceÉ›lalt talemmast
ğŸ§‘ğŸ¾â€â¤â€ğŸ§‘ğŸ½	amdan, taglimt talemmast, taglimt tubrikt talemmast, tayuga s wul, tayuga s wul: amdan, amdan, taglimt tubrikt talemmast, taglimt talemmast
ğŸ§‘ğŸ¾â€â¤â€ğŸ§‘ğŸ¿	amdan, taglimt tubrikt, taglimt tubrikt talemmast, tayuga s wul, tayuga s wul: amdan, amdan, taglimt tubrikt talemmast, taglimt tubrikt
ğŸ§‘ğŸ¿â€â¤â€ğŸ§‘ğŸ»	amdan, taglimt taceÉ›lalt, taglimt tubrikt, tayuga s wul, tayuga s wul: amdan, amdan, taglimt tubrikt, taglimt taceÉ›lalt
ğŸ§‘ğŸ¿â€â¤â€ğŸ§‘ğŸ¼	amdan, taglimt tubrikt, tagwlimt taceÉ›lalt talemmast, tayuga s wul, tayuga s wul: amdan, amdan, taglimt tubrikt, tagwlimt taceÉ›lalt talemmast
ğŸ§‘ğŸ¿â€â¤â€ğŸ§‘ğŸ½	amdan, taglimt talemmast, taglimt tubrikt, tayuga s wul, tayuga s wul: amdan, amdan, taglimt tubrikt, taglimt talemmast
ğŸ§‘ğŸ¿â€â¤â€ğŸ§‘ğŸ¾	amdan, taglimt tubrikt, taglimt tubrikt talemmast, tayuga s wul, tayuga s wul: amdan, amdan, taglimt tubrikt, taglimt tubrikt talemmast
ğŸ§‘â€ğŸ¦°	acekkuá¸¥ azeggaÉ£, amdan, amdan: acekkuá¸¥ azeggaÉ£
ğŸ§‘ğŸ»â€ğŸ¦°	acekkuá¸¥ azeggaÉ£, amdan, amdan: taglimt taceÉ›lalt, acekkuá¸¥ azeggaÉ£, taglimt taceÉ›lalt
ğŸ§‘ğŸ¼â€ğŸ¦°	acekkuá¸¥ azeggaÉ£, amdan, amdan: tagwlimt taceÉ›lalt talemmast, acekkuá¸¥ azeggaÉ£, tagwlimt taceÉ›lalt talemmast
ğŸ§‘ğŸ½â€ğŸ¦°	acekkuá¸¥ azeggaÉ£, amdan, amdan: taglimt talemmast, acekkuá¸¥ azeggaÉ£, taglimt talemmast
ğŸ§‘ğŸ¾â€ğŸ¦°	acekkuá¸¥ azeggaÉ£, amdan, amdan: taglimt tubrikt talemmast, acekkuá¸¥ azeggaÉ£, taglimt tubrikt talemmast
ğŸ§‘ğŸ¿â€ğŸ¦°	acekkuá¸¥ azeggaÉ£, amdan, amdan: taglimt tubrikt, acekkuá¸¥ azeggaÉ£, taglimt tubrikt
ğŸ§‘â€ğŸ¦±	acekkuá¸¥Â akerá¹­uá¹­fan, amdan, amdan: acekkuá¸¥Â akerá¹­uá¹­fan
ğŸ§‘ğŸ»â€ğŸ¦±	acekkuá¸¥Â akerá¹­uá¹­fan, amdan, amdan: taglimt taceÉ›lalt, acekkuá¸¥Â akerá¹­uá¹­fan, taglimt taceÉ›lalt
ğŸ§‘ğŸ¼â€ğŸ¦±	acekkuá¸¥Â akerá¹­uá¹­fan, amdan, amdan: tagwlimt taceÉ›lalt talemmast, acekkuá¸¥Â akerá¹­uá¹­fan, tagwlimt taceÉ›lalt talemmast
ğŸ§‘ğŸ½â€ğŸ¦±	acekkuá¸¥Â akerá¹­uá¹­fan, amdan, amdan: taglimt talemmast, acekkuá¸¥Â akerá¹­uá¹­fan, taglimt talemmast
ğŸ§‘ğŸ¾â€ğŸ¦±	acekkuá¸¥Â akerá¹­uá¹­fan, amdan, amdan: taglimt tubrikt talemmast, acekkuá¸¥Â akerá¹­uá¹­fan, taglimt tubrikt talemmast
ğŸ§‘ğŸ¿â€ğŸ¦±	acekkuá¸¥Â akerá¹­uá¹­fan, amdan, amdan: taglimt tubrikt, acekkuá¸¥Â akerá¹­uá¹­fan, taglimt tubrikt
ğŸ§‘â€ğŸ¦³	acekkuá¸¥Â amellal, amdan, amdan: acekkuá¸¥Â amellal
ğŸ§‘ğŸ»â€ğŸ¦³	acekkuá¸¥Â amellal, amdan, amdan: taglimt taceÉ›lalt, acekkuá¸¥Â amellal, taglimt taceÉ›lalt
ğŸ§‘ğŸ¼â€ğŸ¦³	acekkuá¸¥Â amellal, amdan, amdan: tagwlimt taceÉ›lalt talemmast, acekkuá¸¥Â amellal, tagwlimt taceÉ›lalt talemmast
ğŸ§‘ğŸ½â€ğŸ¦³	acekkuá¸¥Â amellal, amdan, amdan: taglimt talemmast, acekkuá¸¥Â amellal, taglimt talemmast
ğŸ§‘ğŸ¾â€ğŸ¦³	acekkuá¸¥Â amellal, amdan, amdan: taglimt tubrikt talemmast, acekkuá¸¥Â amellal, taglimt tubrikt talemmast
ğŸ§‘ğŸ¿â€ğŸ¦³	acekkuá¸¥Â amellal, amdan, amdan: taglimt tubrikt, acekkuá¸¥Â amellal, taglimt tubrikt
ğŸ§‘â€ğŸ¦²	aferá¸as, amdan, amdan: aferá¸as
ğŸ§‘ğŸ»â€ğŸ¦²	aferá¸as, amdan, amdan: taglimt taceÉ›lalt, aferá¸as, taglimt taceÉ›lalt
ğŸ§‘ğŸ¼â€ğŸ¦²	aferá¸as, amdan, amdan: tagwlimt taceÉ›lalt talemmast, aferá¸as, tagwlimt taceÉ›lalt talemmast
ğŸ§‘ğŸ½â€ğŸ¦²	aferá¸as, amdan, amdan: taglimt talemmast, aferá¸as, taglimt talemmast
ğŸ§‘ğŸ¾â€ğŸ¦²	aferá¸as, amdan, amdan: taglimt tubrikt talemmast, aferá¸as, taglimt tubrikt talemmast
ğŸ§‘ğŸ¿â€ğŸ¦²	aferá¸as, amdan, amdan: taglimt tubrikt, aferá¸as, taglimt tubrikt
ğŸ‘¨	argaz
ğŸ‘¨ğŸ»	argaz, argaz: taglimt taceÉ›lalt, taglimt taceÉ›lalt
ğŸ‘¨ğŸ¼	argaz, argaz: tagwlimt taceÉ›lalt talemmast, tagwlimt taceÉ›lalt talemmast
ğŸ‘¨ğŸ½	argaz, argaz: taglimt talemmast, taglimt talemmast
ğŸ‘¨ğŸ¾	argaz, argaz: taglimt tubrikt talemmast, taglimt tubrikt talemmast
ğŸ‘¨ğŸ¿	argaz, argaz: taglimt tubrikt, taglimt tubrikt
ğŸ§”	amdan: tamart
ğŸ§”ğŸ»	amdan: taglimt taceÉ›lalt, tamart, amdan: tamart, taglimt taceÉ›lalt, tamart
ğŸ§”ğŸ¼	amdan: tagwlimt taceÉ›lalt talemmast, tamart, amdan: tamart, tagwlimt taceÉ›lalt talemmast, tamart
ğŸ§”ğŸ½	amdan: taglimt talemmast, tamart, amdan: tamart, taglimt talemmast, tamart
ğŸ§”ğŸ¾	amdan: taglimt tubrikt talemmast, tamart, amdan: tamart, taglimt tubrikt talemmast, tamart
ğŸ§”ğŸ¿	amdan: taglimt tubrikt, tamart, amdan: tamart, taglimt tubrikt, tamart
ğŸ‘¨ğŸ»â€â¤â€ğŸ‘¨ğŸ»	argaz, taglimt taceÉ›lalt, tayuga s wul, tayuga s wul: argaz, argaz, taglimt taceÉ›lalt
ğŸ‘¨ğŸ»â€â¤â€ğŸ‘¨ğŸ¼	argaz, taglimt taceÉ›lalt, tagwlimt taceÉ›lalt talemmast, tayuga s wul, tayuga s wul: argaz, argaz, taglimt taceÉ›lalt, tagwlimt taceÉ›lalt talemmast
ğŸ‘¨ğŸ»â€â¤â€ğŸ‘¨ğŸ½	argaz, taglimt taceÉ›lalt, taglimt talemmast, tayuga s wul, tayuga s wul: argaz, argaz, taglimt taceÉ›lalt, taglimt talemmast
ğŸ‘¨ğŸ»â€â¤â€ğŸ‘¨ğŸ¾	argaz, taglimt taceÉ›lalt, taglimt tubrikt talemmast, tayuga s wul, tayuga s wul: argaz, argaz, taglimt taceÉ›lalt, taglimt tubrikt talemmast
ğŸ‘¨ğŸ»â€â¤â€ğŸ‘¨ğŸ¿	argaz, taglimt taceÉ›lalt, taglimt tubrikt, tayuga s wul, tayuga s wul: argaz, argaz, taglimt taceÉ›lalt, taglimt tubrikt
ğŸ‘¨ğŸ¼â€â¤â€ğŸ‘¨ğŸ»	argaz, taglimt taceÉ›lalt, tagwlimt taceÉ›lalt talemmast, tayuga s wul, tayuga s wul: argaz, argaz, tagwlimt taceÉ›lalt talemmast, taglimt taceÉ›lalt
ğŸ‘¨ğŸ¼â€â¤â€ğŸ‘¨ğŸ¼	argaz, tagwlimt taceÉ›lalt talemmast, tayuga s wul, tayuga s wul: argaz, argaz, tagwlimt taceÉ›lalt talemmast
ğŸ‘¨ğŸ¼â€â¤â€ğŸ‘¨ğŸ½	argaz, taglimt talemmast, tagwlimt taceÉ›lalt talemmast, tayuga s wul, tayuga s wul: argaz, argaz, tagwlimt taceÉ›lalt talemmast, taglimt talemmast
ğŸ‘¨ğŸ¼â€â¤â€ğŸ‘¨ğŸ¾	argaz, taglimt tubrikt talemmast, tagwlimt taceÉ›lalt talemmast, tayuga s wul, tayuga s wul: argaz, argaz, tagwlimt taceÉ›lalt talemmast, taglimt tubrikt talemmast
ğŸ‘¨ğŸ¼â€â¤â€ğŸ‘¨ğŸ¿	argaz, taglimt tubrikt, tagwlimt taceÉ›lalt talemmast, tayuga s wul, tayuga s wul: argaz, argaz, tagwlimt taceÉ›lalt talemmast, taglimt tubrikt
ğŸ‘¨ğŸ½â€â¤â€ğŸ‘¨ğŸ»	argaz, taglimt taceÉ›lalt, taglimt talemmast, tayuga s wul, tayuga s wul: argaz, argaz, taglimt talemmast, taglimt taceÉ›lalt
ğŸ‘¨ğŸ½â€â¤â€ğŸ‘¨ğŸ¼	argaz, taglimt talemmast, tagwlimt taceÉ›lalt talemmast, tayuga s wul, tayuga s wul: argaz, argaz, taglimt talemmast, tagwlimt taceÉ›lalt talemmast
ğŸ‘¨ğŸ½â€â¤â€ğŸ‘¨ğŸ½	argaz, taglimt talemmast, tayuga s wul, tayuga s wul: argaz, argaz, taglimt talemmast
ğŸ‘¨ğŸ½â€â¤â€ğŸ‘¨ğŸ¾	argaz, taglimt talemmast, taglimt tubrikt talemmast, tayuga s wul, tayuga s wul: argaz, argaz, taglimt talemmast, taglimt tubrikt talemmast
ğŸ‘¨ğŸ½â€â¤â€ğŸ‘¨ğŸ¿	argaz, taglimt talemmast, taglimt tubrikt, tayuga s wul, tayuga s wul: argaz, argaz, taglimt talemmast, taglimt tubrikt
ğŸ‘¨ğŸ¾â€â¤â€ğŸ‘¨ğŸ»	argaz, taglimt taceÉ›lalt, taglimt tubrikt talemmast, tayuga s wul, tayuga s wul: argaz, argaz, taglimt tubrikt talemmast, taglimt taceÉ›lalt
ğŸ‘¨ğŸ¾â€â¤â€ğŸ‘¨ğŸ¼	argaz, taglimt tubrikt talemmast, tagwlimt taceÉ›lalt talemmast, tayuga s wul, tayuga s wul: argaz, argaz, taglimt tubrikt talemmast, tagwlimt taceÉ›lalt talemmast
ğŸ‘¨ğŸ¾â€â¤â€ğŸ‘¨ğŸ½	argaz, taglimt talemmast, taglimt tubrikt talemmast, tayuga s wul, tayuga s wul: argaz, argaz, taglimt tubrikt talemmast, taglimt talemmast
ğŸ‘¨ğŸ¾â€â¤â€ğŸ‘¨ğŸ¾	argaz, taglimt tubrikt talemmast, tayuga s wul, tayuga s wul: argaz, argaz, taglimt tubrikt talemmast
ğŸ‘¨ğŸ¾â€â¤â€ğŸ‘¨ğŸ¿	argaz, taglimt tubrikt, taglimt tubrikt talemmast, tayuga s wul, tayuga s wul: argaz, argaz, taglimt tubrikt talemmast, taglimt tubrikt
ğŸ‘¨ğŸ¿â€â¤â€ğŸ‘¨ğŸ»	argaz, taglimt taceÉ›lalt, taglimt tubrikt, tayuga s wul, tayuga s wul: argaz, argaz, taglimt tubrikt, taglimt taceÉ›lalt
ğŸ‘¨ğŸ¿â€â¤â€ğŸ‘¨ğŸ¼	argaz, taglimt tubrikt, tagwlimt taceÉ›lalt talemmast, tayuga s wul, tayuga s wul: argaz, argaz, taglimt tubrikt, tagwlimt taceÉ›lalt talemmast
ğŸ‘¨ğŸ¿â€â¤â€ğŸ‘¨ğŸ½	argaz, taglimt talemmast, taglimt tubrikt, tayuga s wul, tayuga s wul: argaz, argaz, taglimt tubrikt, taglimt talemmast
ğŸ‘¨ğŸ¿â€â¤â€ğŸ‘¨ğŸ¾	argaz, taglimt tubrikt, taglimt tubrikt talemmast, tayuga s wul, tayuga s wul: argaz, argaz, taglimt tubrikt, taglimt tubrikt talemmast
ğŸ‘¨ğŸ¿â€â¤â€ğŸ‘¨ğŸ¿	argaz, taglimt tubrikt, tayuga s wul, tayuga s wul: argaz, argaz, taglimt tubrikt
ğŸ‘¨â€ğŸ¦°	acekkuá¸¥ azeggaÉ£, argaz, argaz: acekkuá¸¥ azeggaÉ£
ğŸ‘¨ğŸ»â€ğŸ¦°	acekkuá¸¥ azeggaÉ£, argaz, argaz: taglimt taceÉ›lalt, acekkuá¸¥ azeggaÉ£, taglimt taceÉ›lalt
ğŸ‘¨ğŸ¼â€ğŸ¦°	acekkuá¸¥ azeggaÉ£, argaz, argaz: tagwlimt taceÉ›lalt talemmast, acekkuá¸¥ azeggaÉ£, tagwlimt taceÉ›lalt talemmast
ğŸ‘¨ğŸ½â€ğŸ¦°	acekkuá¸¥ azeggaÉ£, argaz, argaz: taglimt talemmast, acekkuá¸¥ azeggaÉ£, taglimt talemmast
ğŸ‘¨ğŸ¾â€ğŸ¦°	acekkuá¸¥ azeggaÉ£, argaz, argaz: taglimt tubrikt talemmast, acekkuá¸¥ azeggaÉ£, taglimt tubrikt talemmast
ğŸ‘¨ğŸ¿â€ğŸ¦°	acekkuá¸¥ azeggaÉ£, argaz, argaz: taglimt tubrikt, acekkuá¸¥ azeggaÉ£, taglimt tubrikt
ğŸ‘¨â€ğŸ¦±	acekkuá¸¥Â akerá¹­uá¹­fan, argaz, argaz: acekkuá¸¥Â akerá¹­uá¹­fan
ğŸ‘¨ğŸ»â€ğŸ¦±	acekkuá¸¥Â akerá¹­uá¹­fan, argaz, argaz: taglimt taceÉ›lalt, acekkuá¸¥Â akerá¹­uá¹­fan, taglimt taceÉ›lalt
ğŸ‘¨ğŸ¼â€ğŸ¦±	acekkuá¸¥Â akerá¹­uá¹­fan, argaz, argaz: tagwlimt taceÉ›lalt talemmast, acekkuá¸¥Â akerá¹­uá¹­fan, tagwlimt taceÉ›lalt talemmast
ğŸ‘¨ğŸ½â€ğŸ¦±	acekkuá¸¥Â akerá¹­uá¹­fan, argaz, argaz: taglimt talemmast, acekkuá¸¥Â akerá¹­uá¹­fan, taglimt talemmast
ğŸ‘¨ğŸ¾â€ğŸ¦±	acekkuá¸¥Â akerá¹­uá¹­fan, argaz, argaz: taglimt tubrikt talemmast, acekkuá¸¥Â akerá¹­uá¹­fan, taglimt tubrikt talemmast
ğŸ‘¨ğŸ¿â€ğŸ¦±	acekkuá¸¥Â akerá¹­uá¹­fan, argaz, argaz: taglimt tubrikt, acekkuá¸¥Â akerá¹­uá¹­fan, taglimt tubrikt
ğŸ‘¨â€ğŸ¦³	acekkuá¸¥Â amellal, argaz, argaz: acekkuá¸¥Â amellal
ğŸ‘¨ğŸ»â€ğŸ¦³	acekkuá¸¥Â amellal, argaz, argaz: taglimt taceÉ›lalt, acekkuá¸¥Â amellal, taglimt taceÉ›lalt
ğŸ‘¨ğŸ¼â€ğŸ¦³	acekkuá¸¥Â amellal, argaz, argaz: tagwlimt taceÉ›lalt talemmast, acekkuá¸¥Â amellal, tagwlimt taceÉ›lalt talemmast
ğŸ‘¨ğŸ½â€ğŸ¦³	acekkuá¸¥Â amellal, argaz, argaz: taglimt talemmast, acekkuá¸¥Â amellal, taglimt talemmast
ğŸ‘¨ğŸ¾â€ğŸ¦³	acekkuá¸¥Â amellal, argaz, argaz: taglimt tubrikt talemmast, acekkuá¸¥Â amellal, taglimt tubrikt talemmast
ğŸ‘¨ğŸ¿â€ğŸ¦³	acekkuá¸¥Â amellal, argaz, argaz: taglimt tubrikt, acekkuá¸¥Â amellal, taglimt tubrikt
ğŸ‘¨â€ğŸ¦²	aferá¸as, argaz, argaz: aferá¸as
ğŸ‘¨ğŸ»â€ğŸ¦²	aferá¸as, argaz, argaz: taglimt taceÉ›lalt, aferá¸as, taglimt taceÉ›lalt
ğŸ‘¨ğŸ¼â€ğŸ¦²	aferá¸as, argaz, argaz: tagwlimt taceÉ›lalt talemmast, aferá¸as, tagwlimt taceÉ›lalt talemmast
ğŸ‘¨ğŸ½â€ğŸ¦²	aferá¸as, argaz, argaz: taglimt talemmast, aferá¸as, taglimt talemmast
ğŸ‘¨ğŸ¾â€ğŸ¦²	aferá¸as, argaz, argaz: taglimt tubrikt talemmast, aferá¸as, taglimt tubrikt talemmast
ğŸ‘¨ğŸ¿â€ğŸ¦²	aferá¸as, argaz, argaz: taglimt tubrikt, aferá¸as, taglimt tubrikt
ğŸ‘©	tameá¹­á¹­ut
ğŸ‘©ğŸ»	taglimt taceÉ›lalt, tameá¹­á¹­ut, tameá¹­á¹­ut: taglimt taceÉ›lalt
ğŸ‘©ğŸ¼	tagwlimt taceÉ›lalt talemmast, tameá¹­á¹­ut, tameá¹­á¹­ut: tagwlimt taceÉ›lalt talemmast
ğŸ‘©ğŸ½	taglimt talemmast, tameá¹­á¹­ut, tameá¹­á¹­ut: taglimt talemmast
ğŸ‘©ğŸ¾	taglimt tubrikt talemmast, tameá¹­á¹­ut, tameá¹­á¹­ut: taglimt tubrikt talemmast
ğŸ‘©ğŸ¿	taglimt tubrikt, tameá¹­á¹­ut, tameá¹­á¹­ut: taglimt tubrikt
ğŸ‘©ğŸ»â€â¤â€ğŸ‘¨ğŸ»	argaz, taglimt taceÉ›lalt, tameá¹­á¹­ut, tayuga s wul, tayuga s wul: tameá¹­á¹­ut, argaz, taglimt taceÉ›lalt
ğŸ‘©ğŸ»â€â¤â€ğŸ‘¨ğŸ¼	argaz, taglimt taceÉ›lalt, tagwlimt taceÉ›lalt talemmast, tameá¹­á¹­ut, tayuga s wul, tayuga s wul: tameá¹­á¹­ut, argaz, taglimt taceÉ›lalt, tagwlimt taceÉ›lalt talemmast
ğŸ‘©ğŸ»â€â¤â€ğŸ‘¨ğŸ½	argaz, taglimt taceÉ›lalt, taglimt talemmast, tameá¹­á¹­ut, tayuga s wul, tayuga s wul: tameá¹­á¹­ut, argaz, taglimt taceÉ›lalt, taglimt talemmast
ğŸ‘©ğŸ»â€â¤â€ğŸ‘¨ğŸ¾	argaz, taglimt taceÉ›lalt, taglimt tubrikt talemmast, tameá¹­á¹­ut, tayuga s wul, tayuga s wul: tameá¹­á¹­ut, argaz, taglimt taceÉ›lalt, taglimt tubrikt talemmast
ğŸ‘©ğŸ»â€â¤â€ğŸ‘¨ğŸ¿	argaz, taglimt taceÉ›lalt, taglimt tubrikt, tameá¹­á¹­ut, tayuga s wul, tayuga s wul: tameá¹­á¹­ut, argaz, taglimt taceÉ›lalt, taglimt tubrikt
ğŸ‘©ğŸ¼â€â¤â€ğŸ‘¨ğŸ»	argaz, taglimt taceÉ›lalt, tagwlimt taceÉ›lalt talemmast, tameá¹­á¹­ut, tayuga s wul, tayuga s wul: tameá¹­á¹­ut, argaz, tagwlimt taceÉ›lalt talemmast, taglimt taceÉ›lalt
ğŸ‘©ğŸ¼â€â¤â€ğŸ‘¨ğŸ¼	argaz, tagwlimt taceÉ›lalt talemmast, tameá¹­á¹­ut, tayuga s wul, tayuga s wul: tameá¹­á¹­ut, argaz, tagwlimt taceÉ›lalt talemmast
ğŸ‘©ğŸ¼â€â¤â€ğŸ‘¨ğŸ½	argaz, taglimt talemmast, tagwlimt taceÉ›lalt talemmast, tameá¹­á¹­ut, tayuga s wul, tayuga s wul: tameá¹­á¹­ut, argaz, tagwlimt taceÉ›lalt talemmast, taglimt talemmast
ğŸ‘©ğŸ¼â€â¤â€ğŸ‘¨ğŸ¾	argaz, taglimt tubrikt talemmast, tagwlimt taceÉ›lalt talemmast, tameá¹­á¹­ut, tayuga s wul, tayuga s wul: tameá¹­á¹­ut, argaz, tagwlimt taceÉ›lalt talemmast, taglimt tubrikt talemmast
ğŸ‘©ğŸ¼â€â¤â€ğŸ‘¨ğŸ¿	argaz, taglimt tubrikt, tagwlimt taceÉ›lalt talemmast, tameá¹­á¹­ut, tayuga s wul, tayuga s wul: tameá¹­á¹­ut, argaz, tagwlimt taceÉ›lalt talemmast, taglimt tubrikt
ğŸ‘©ğŸ½â€â¤â€ğŸ‘¨ğŸ»	argaz, taglimt taceÉ›lalt, taglimt talemmast, tameá¹­á¹­ut, tayuga s wul, tayuga s wul: tameá¹­á¹­ut, argaz, taglimt talemmast, taglimt taceÉ›lalt
ğŸ‘©ğŸ½â€â¤â€ğŸ‘¨ğŸ¼	argaz, taglimt talemmast, tagwlimt taceÉ›lalt talemmast, tameá¹­á¹­ut, tayuga s wul, tayuga s wul: tameá¹­á¹­ut, argaz, taglimt talemmast, tagwlimt taceÉ›lalt talemmast
ğŸ‘©ğŸ½â€â¤â€ğŸ‘¨ğŸ½	argaz, taglimt talemmast, tameá¹­á¹­ut, tayuga s wul, tayuga s wul: tameá¹­á¹­ut, argaz, taglimt talemmast
ğŸ‘©ğŸ½â€â¤â€ğŸ‘¨ğŸ¾	argaz, taglimt talemmast, taglimt tubrikt talemmast, tameá¹­á¹­ut, tayuga s wul, tayuga s wul: tameá¹­á¹­ut, argaz, taglimt talemmast, taglimt tubrikt talemmast
ğŸ‘©ğŸ½â€â¤â€ğŸ‘¨ğŸ¿	argaz, taglimt talemmast, taglimt tubrikt, tameá¹­á¹­ut, tayuga s wul, tayuga s wul: tameá¹­á¹­ut, argaz, taglimt talemmast, taglimt tubrikt
ğŸ‘©ğŸ¾â€â¤â€ğŸ‘¨ğŸ»	argaz, taglimt taceÉ›lalt, taglimt tubrikt talemmast, tameá¹­á¹­ut, tayuga s wul, tayuga s wul: tameá¹­á¹­ut, argaz, taglimt tubrikt talemmast, taglimt taceÉ›lalt
ğŸ‘©ğŸ¾â€â¤â€ğŸ‘¨ğŸ¼	argaz, taglimt tubrikt talemmast, tagwlimt taceÉ›lalt talemmast, tameá¹­á¹­ut, tayuga s wul, tayuga s wul: tameá¹­á¹­ut, argaz, taglimt tubrikt talemmast, tagwlimt taceÉ›lalt talemmast
ğŸ‘©ğŸ¾â€â¤â€ğŸ‘¨ğŸ½	argaz, taglimt talemmast, taglimt tubrikt talemmast, tameá¹­á¹­ut, tayuga s wul, tayuga s wul: tameá¹­á¹­ut, argaz, taglimt tubrikt talemmast, taglimt talemmast
ğŸ‘©ğŸ¾â€â¤â€ğŸ‘¨ğŸ¾	argaz, taglimt tubrikt talemmast, tameá¹­á¹­ut, tayuga s wul, tayuga s wul: tameá¹­á¹­ut, argaz, taglimt tubrikt talemmast
ğŸ‘©ğŸ¾â€â¤â€ğŸ‘¨ğŸ¿	argaz, taglimt tubrikt, taglimt tubrikt talemmast, tameá¹­á¹­ut, tayuga s wul, tayuga s wul: tameá¹­á¹­ut, argaz, taglimt tubrikt talemmast, taglimt tubrikt
ğŸ‘©ğŸ¿â€â¤â€ğŸ‘¨ğŸ»	argaz, taglimt taceÉ›lalt, taglimt tubrikt, tameá¹­á¹­ut, tayuga s wul, tayuga s wul: tameá¹­á¹­ut, argaz, taglimt tubrikt, taglimt taceÉ›lalt
ğŸ‘©ğŸ¿â€â¤â€ğŸ‘¨ğŸ¼	argaz, taglimt tubrikt, tagwlimt taceÉ›lalt talemmast, tameá¹­á¹­ut, tayuga s wul, tayuga s wul: tameá¹­á¹­ut, argaz, taglimt tubrikt, tagwlimt taceÉ›lalt talemmast
ğŸ‘©ğŸ¿â€â¤â€ğŸ‘¨ğŸ½	argaz, taglimt talemmast, taglimt tubrikt, tameá¹­á¹­ut, tayuga s wul, tayuga s wul: tameá¹­á¹­ut, argaz, taglimt tubrikt, taglimt talemmast
ğŸ‘©ğŸ¿â€â¤â€ğŸ‘¨ğŸ¾	argaz, taglimt tubrikt, taglimt tubrikt talemmast, tameá¹­á¹­ut, tayuga s wul, tayuga s wul: tameá¹­á¹­ut, argaz, taglimt tubrikt, taglimt tubrikt talemmast
ğŸ‘©ğŸ¿â€â¤â€ğŸ‘¨ğŸ¿	argaz, taglimt tubrikt, tameá¹­á¹­ut, tayuga s wul, tayuga s wul: tameá¹­á¹­ut, argaz, taglimt tubrikt
ğŸ‘©ğŸ»â€â¤â€ğŸ‘©ğŸ»	taglimt taceÉ›lalt, tameá¹­á¹­ut, tayuga s wul, tayuga s wul: tameá¹­á¹­ut, tameá¹­á¹­ut, taglimt taceÉ›lalt
ğŸ‘©ğŸ»â€â¤â€ğŸ‘©ğŸ¼	taglimt taceÉ›lalt, tagwlimt taceÉ›lalt talemmast, tameá¹­á¹­ut, tayuga s wul, tayuga s wul: tameá¹­á¹­ut, tameá¹­á¹­ut, taglimt taceÉ›lalt, tagwlimt taceÉ›lalt talemmast
ğŸ‘©ğŸ»â€â¤â€ğŸ‘©ğŸ½	taglimt taceÉ›lalt, taglimt talemmast, tameá¹­á¹­ut, tayuga s wul, tayuga s wul: tameá¹­á¹­ut, tameá¹­á¹­ut, taglimt taceÉ›lalt, taglimt talemmast
ğŸ‘©ğŸ»â€â¤â€ğŸ‘©ğŸ¾	taglimt taceÉ›lalt, taglimt tubrikt talemmast, tameá¹­á¹­ut, tayuga s wul, tayuga s wul: tameá¹­á¹­ut, tameá¹­á¹­ut, taglimt taceÉ›lalt, taglimt tubrikt talemmast
ğŸ‘©ğŸ»â€â¤â€ğŸ‘©ğŸ¿	taglimt taceÉ›lalt, taglimt tubrikt, tameá¹­á¹­ut, tayuga s wul, tayuga s wul: tameá¹­á¹­ut, tameá¹­á¹­ut, taglimt taceÉ›lalt, taglimt tubrikt
ğŸ‘©ğŸ¼â€â¤â€ğŸ‘©ğŸ»	taglimt taceÉ›lalt, tagwlimt taceÉ›lalt talemmast, tameá¹­á¹­ut, tayuga s wul, tayuga s wul: tameá¹­á¹­ut, tameá¹­á¹­ut, tagwlimt taceÉ›lalt talemmast, taglimt taceÉ›lalt
ğŸ‘©ğŸ¼â€â¤â€ğŸ‘©ğŸ¼	tagwlimt taceÉ›lalt talemmast, tameá¹­á¹­ut, tayuga s wul, tayuga s wul: tameá¹­á¹­ut, tameá¹­á¹­ut, tagwlimt taceÉ›lalt talemmast
ğŸ‘©ğŸ¼â€â¤â€ğŸ‘©ğŸ½	taglimt talemmast, tagwlimt taceÉ›lalt talemmast, tameá¹­á¹­ut, tayuga s wul, tayuga s wul: tameá¹­á¹­ut, tameá¹­á¹­ut, tagwlimt taceÉ›lalt talemmast, taglimt talemmast
ğŸ‘©ğŸ¼â€â¤â€ğŸ‘©ğŸ¾	taglimt tubrikt talemmast, tagwlimt taceÉ›lalt talemmast, tameá¹­á¹­ut, tayuga s wul, tayuga s wul: tameá¹­á¹­ut, tameá¹­á¹­ut, tagwlimt taceÉ›lalt talemmast, taglimt tubrikt talemmast
ğŸ‘©ğŸ¼â€â¤â€ğŸ‘©ğŸ¿	taglimt tubrikt, tagwlimt taceÉ›lalt talemmast, tameá¹­á¹­ut, tayuga s wul, tayuga s wul: tameá¹­á¹­ut, tameá¹­á¹­ut, tagwlimt taceÉ›lalt talemmast, taglimt tubrikt
ğŸ‘©ğŸ½â€â¤â€ğŸ‘©ğŸ»	taglimt taceÉ›lalt, taglimt talemmast, tameá¹­á¹­ut, tayuga s wul, tayuga s wul: tameá¹­á¹­ut, tameá¹­á¹­ut, taglimt talemmast, taglimt taceÉ›lalt
ğŸ‘©ğŸ½â€â¤â€ğŸ‘©ğŸ¼	taglimt talemmast, tagwlimt taceÉ›lalt talemmast, tameá¹­á¹­ut, tayuga s wul, tayuga s wul: tameá¹­á¹­ut, tameá¹­á¹­ut, taglimt talemmast, tagwlimt taceÉ›lalt talemmast
ğŸ‘©ğŸ½â€â¤â€ğŸ‘©ğŸ½	taglimt talemmast, tameá¹­á¹­ut, tayuga s wul, tayuga s wul: tameá¹­á¹­ut, tameá¹­á¹­ut, taglimt talemmast
ğŸ‘©ğŸ½â€â¤â€ğŸ‘©ğŸ¾	taglimt talemmast, taglimt tubrikt talemmast, tameá¹­á¹­ut, tayuga s wul, tayuga s wul: tameá¹­á¹­ut, tameá¹­á¹­ut, taglimt talemmast, taglimt tubrikt talemmast
ğŸ‘©ğŸ½â€â¤â€ğŸ‘©ğŸ¿	taglimt talemmast, taglimt tubrikt, tameá¹­á¹­ut, tayuga s wul, tayuga s wul: tameá¹­á¹­ut, tameá¹­á¹­ut, taglimt talemmast, taglimt tubrikt
ğŸ‘©ğŸ¾â€â¤â€ğŸ‘©ğŸ»	taglimt taceÉ›lalt, taglimt tubrikt talemmast, tameá¹­á¹­ut, tayuga s wul, tayuga s wul: tameá¹­á¹­ut, tameá¹­á¹­ut, taglimt tubrikt talemmast, taglimt taceÉ›lalt
ğŸ‘©ğŸ¾â€â¤â€ğŸ‘©ğŸ¼	taglimt tubrikt talemmast, tagwlimt taceÉ›lalt talemmast, tameá¹­á¹­ut, tayuga s wul, tayuga s wul: tameá¹­á¹­ut, tameá¹­á¹­ut, taglimt tubrikt talemmast, tagwlimt taceÉ›lalt talemmast
ğŸ‘©ğŸ¾â€â¤â€ğŸ‘©ğŸ½	taglimt talemmast, taglimt tubrikt talemmast, tameá¹­á¹­ut, tayuga s wul, tayuga s wul: tameá¹­á¹­ut, tameá¹­á¹­ut, taglimt tubrikt talemmast, taglimt talemmast
ğŸ‘©ğŸ¾â€â¤â€ğŸ‘©ğŸ¾	taglimt tubrikt talemmast, tameá¹­á¹­ut, tayuga s wul, tayuga s wul: tameá¹­á¹­ut, tameá¹­á¹­ut, taglimt tubrikt talemmast
ğŸ‘©ğŸ¾â€â¤â€ğŸ‘©ğŸ¿	taglimt tubrikt, taglimt tubrikt talemmast, tameá¹­á¹­ut, tayuga s wul, tayuga s wul: tameá¹­á¹­ut, tameá¹­á¹­ut, taglimt tubrikt talemmast, taglimt tubrikt
ğŸ‘©ğŸ¿â€â¤â€ğŸ‘©ğŸ»	taglimt taceÉ›lalt, taglimt tubrikt, tameá¹­á¹­ut, tayuga s wul, tayuga s wul: tameá¹­á¹­ut, tameá¹­á¹­ut, taglimt tubrikt, taglimt taceÉ›lalt
ğŸ‘©ğŸ¿â€â¤â€ğŸ‘©ğŸ¼	taglimt tubrikt, tagwlimt taceÉ›lalt talemmast, tameá¹­á¹­ut, tayuga s wul, tayuga s wul: tameá¹­á¹­ut, tameá¹­á¹­ut, taglimt tubrikt, tagwlimt taceÉ›lalt talemmast
ğŸ‘©ğŸ¿â€â¤â€ğŸ‘©ğŸ½	taglimt talemmast, taglimt tubrikt, tameá¹­á¹­ut, tayuga s wul, tayuga s wul: tameá¹­á¹­ut, tameá¹­á¹­ut, taglimt tubrikt, taglimt talemmast
ğŸ‘©ğŸ¿â€â¤â€ğŸ‘©ğŸ¾	taglimt tubrikt, taglimt tubrikt talemmast, tameá¹­á¹­ut, tayuga s wul, tayuga s wul: tameá¹­á¹­ut, tameá¹­á¹­ut, taglimt tubrikt, taglimt tubrikt talemmast
ğŸ‘©ğŸ¿â€â¤â€ğŸ‘©ğŸ¿	taglimt tubrikt, tameá¹­á¹­ut, tayuga s wul, tayuga s wul: tameá¹­á¹­ut, tameá¹­á¹­ut, taglimt tubrikt
ğŸ‘©â€ğŸ¦°	acekkuá¸¥ azeggaÉ£, tameá¹­á¹­ut, tameá¹­á¹­ut: acekkuá¸¥ azeggaÉ£
ğŸ‘©ğŸ»â€ğŸ¦°	acekkuá¸¥ azeggaÉ£, taglimt taceÉ›lalt, tameá¹­á¹­ut, tameá¹­á¹­ut: taglimt taceÉ›lalt, acekkuá¸¥ azeggaÉ£
ğŸ‘©ğŸ¼â€ğŸ¦°	acekkuá¸¥ azeggaÉ£, tagwlimt taceÉ›lalt talemmast, tameá¹­á¹­ut, tameá¹­á¹­ut: tagwlimt taceÉ›lalt talemmast, acekkuá¸¥ azeggaÉ£
ğŸ‘©ğŸ½â€ğŸ¦°	acekkuá¸¥ azeggaÉ£, taglimt talemmast, tameá¹­á¹­ut, tameá¹­á¹­ut: taglimt talemmast, acekkuá¸¥ azeggaÉ£
ğŸ‘©ğŸ¾â€ğŸ¦°	acekkuá¸¥ azeggaÉ£, taglimt tubrikt talemmast, tameá¹­á¹­ut, tameá¹­á¹­ut: taglimt tubrikt talemmast, acekkuá¸¥ azeggaÉ£
ğŸ‘©ğŸ¿â€ğŸ¦°	acekkuá¸¥ azeggaÉ£, taglimt tubrikt, tameá¹­á¹­ut, tameá¹­á¹­ut: taglimt tubrikt, acekkuá¸¥ azeggaÉ£
ğŸ‘©â€ğŸ¦±	acekkuá¸¥Â akerá¹­uá¹­fan, tameá¹­á¹­ut, tameá¹­á¹­ut: acekkuá¸¥Â akerá¹­uá¹­fan
ğŸ‘©ğŸ»â€ğŸ¦±	acekkuá¸¥Â akerá¹­uá¹­fan, taglimt taceÉ›lalt, tameá¹­á¹­ut, tameá¹­á¹­ut: taglimt taceÉ›lalt, acekkuá¸¥Â akerá¹­uá¹­fan
ğŸ‘©ğŸ¼â€ğŸ¦±	acekkuá¸¥Â akerá¹­uá¹­fan, tagwlimt taceÉ›lalt talemmast, tameá¹­á¹­ut, tameá¹­á¹­ut: tagwlimt taceÉ›lalt talemmast, acekkuá¸¥Â akerá¹­uá¹­fan
ğŸ‘©ğŸ½â€ğŸ¦±	acekkuá¸¥Â akerá¹­uá¹­fan, taglimt talemmast, tameá¹­á¹­ut, tameá¹­á¹­ut: taglimt talemmast, acekkuá¸¥Â akerá¹­uá¹­fan
ğŸ‘©ğŸ¾â€ğŸ¦±	acekkuá¸¥Â akerá¹­uá¹­fan, taglimt tubrikt talemmast, tameá¹­á¹­ut, tameá¹­á¹­ut: taglimt tubrikt talemmast, acekkuá¸¥Â akerá¹­uá¹­fan
ğŸ‘©ğŸ¿â€ğŸ¦±	acekkuá¸¥Â akerá¹­uá¹­fan, taglimt tubrikt, tameá¹­á¹­ut, tameá¹­á¹­ut: taglimt tubrikt, acekkuá¸¥Â akerá¹­uá¹­fan
ğŸ‘©â€ğŸ¦³	acekkuá¸¥Â amellal, tameá¹­á¹­ut, tameá¹­á¹­ut: acekkuá¸¥Â amellal
ğŸ‘©ğŸ»â€ğŸ¦³	acekkuá¸¥Â amellal, taglimt taceÉ›lalt, tameá¹­á¹­ut, tameá¹­á¹­ut: taglimt taceÉ›lalt, acekkuá¸¥Â amellal
ğŸ‘©ğŸ¼â€ğŸ¦³	acekkuá¸¥Â amellal, tagwlimt taceÉ›lalt talemmast, tameá¹­á¹­ut, tameá¹­á¹­ut: tagwlimt taceÉ›lalt talemmast, acekkuá¸¥Â amellal
ğŸ‘©ğŸ½â€ğŸ¦³	acekkuá¸¥Â amellal, taglimt talemmast, tameá¹­á¹­ut, tameá¹­á¹­ut: taglimt talemmast, acekkuá¸¥Â amellal
ğŸ‘©ğŸ¾â€ğŸ¦³	acekkuá¸¥Â amellal, taglimt tubrikt talemmast, tameá¹­á¹­ut, tameá¹­á¹­ut: taglimt tubrikt talemmast, acekkuá¸¥Â amellal
ğŸ‘©ğŸ¿â€ğŸ¦³	acekkuá¸¥Â amellal, taglimt tubrikt, tameá¹­á¹­ut, tameá¹­á¹­ut: taglimt tubrikt, acekkuá¸¥Â amellal
ğŸ‘©â€ğŸ¦²	aferá¸as, tameá¹­á¹­ut, tameá¹­á¹­ut: aferá¸as
ğŸ‘©ğŸ»â€ğŸ¦²	aferá¸as, taglimt taceÉ›lalt, tameá¹­á¹­ut, tameá¹­á¹­ut: taglimt taceÉ›lalt, aferá¸as
ğŸ‘©ğŸ¼â€ğŸ¦²	aferá¸as, tagwlimt taceÉ›lalt talemmast, tameá¹­á¹­ut, tameá¹­á¹­ut: tagwlimt taceÉ›lalt talemmast, aferá¸as
ğŸ‘©ğŸ½â€ğŸ¦²	aferá¸as, taglimt talemmast, tameá¹­á¹­ut, tameá¹­á¹­ut: taglimt talemmast, aferá¸as
ğŸ‘©ğŸ¾â€ğŸ¦²	aferá¸as, taglimt tubrikt talemmast, tameá¹­á¹­ut, tameá¹­á¹­ut: taglimt tubrikt talemmast, aferá¸as
ğŸ‘©ğŸ¿â€ğŸ¦²	aferá¸as, taglimt tubrikt, tameá¹­á¹­ut, tameá¹­á¹­ut: taglimt tubrikt, aferá¸as
ğŸ§“	amdan meqqren
ğŸ§“ğŸ»	amdan meqqren, amdan meqqren: taglimt taceÉ›lalt, taglimt taceÉ›lalt
ğŸ§“ğŸ¼	amdan meqqren, amdan meqqren: tagwlimt taceÉ›lalt talemmast, tagwlimt taceÉ›lalt talemmast
ğŸ§“ğŸ½	amdan meqqren, amdan meqqren: taglimt talemmast, taglimt talemmast
ğŸ§“ğŸ¾	amdan meqqren, amdan meqqren: taglimt tubrikt talemmast, taglimt tubrikt talemmast
ğŸ§“ğŸ¿	amdan meqqren, amdan meqqren: taglimt tubrikt, taglimt tubrikt
ğŸ‘´	amÉ£ar
ğŸ‘´ğŸ»	amÉ£ar, amÉ£ar: taglimt taceÉ›lalt, taglimt taceÉ›lalt
ğŸ‘´ğŸ¼	amÉ£ar, amÉ£ar: tagwlimt taceÉ›lalt talemmast, tagwlimt taceÉ›lalt talemmast
ğŸ‘´ğŸ½	amÉ£ar, amÉ£ar: taglimt talemmast, taglimt talemmast
ğŸ‘´ğŸ¾	amÉ£ar, amÉ£ar: taglimt tubrikt talemmast, taglimt tubrikt talemmast
ğŸ‘´ğŸ¿	amÉ£ar, amÉ£ar: taglimt tubrikt, taglimt tubrikt
ğŸ‘µ	tamÉ£art
ğŸ‘µğŸ»	taglimt taceÉ›lalt, tamÉ£art, tamÉ£art: taglimt taceÉ›lalt
ğŸ‘µğŸ¼	tagwlimt taceÉ›lalt talemmast, tamÉ£art, tamÉ£art: tagwlimt taceÉ›lalt talemmast
ğŸ‘µğŸ½	taglimt talemmast, tamÉ£art, tamÉ£art: taglimt talemmast
ğŸ‘µğŸ¾	taglimt tubrikt talemmast, tamÉ£art, tamÉ£art: taglimt tubrikt talemmast
ğŸ‘µğŸ¿	taglimt tubrikt, tamÉ£art, tamÉ£art: taglimt tubrikt
ğŸ§	amdan aÉ›eáº“áº“ug
ğŸ§ğŸ»	amdan aÉ›eáº“áº“ug, amdan aÉ›eáº“áº“ug: taglimt taceÉ›lalt, taglimt taceÉ›lalt
ğŸ§ğŸ¼	amdan aÉ›eáº“áº“ug, amdan aÉ›eáº“áº“ug: tagwlimt taceÉ›lalt talemmast, tagwlimt taceÉ›lalt talemmast
ğŸ§ğŸ½	amdan aÉ›eáº“áº“ug, amdan aÉ›eáº“áº“ug: taglimt talemmast, taglimt talemmast
ğŸ§ğŸ¾	amdan aÉ›eáº“áº“ug, amdan aÉ›eáº“áº“ug: taglimt tubrikt talemmast, taglimt tubrikt talemmast
ğŸ§ğŸ¿	amdan aÉ›eáº“áº“ug, amdan aÉ›eáº“áº“ug: taglimt tubrikt, taglimt tubrikt
ğŸ‘®	amsaltu
ğŸ‘®ğŸ»	amsaltu, amsaltu: taglimt taceÉ›lalt, taglimt taceÉ›lalt
ğŸ‘®ğŸ¼	amsaltu, amsaltu: tagwlimt taceÉ›lalt talemmast, tagwlimt taceÉ›lalt talemmast
ğŸ‘®ğŸ½	amsaltu, amsaltu: taglimt talemmast, taglimt talemmast
ğŸ‘®ğŸ¾	amsaltu, amsaltu: taglimt tubrikt talemmast, taglimt tubrikt talemmast
ğŸ‘®ğŸ¿	amsaltu, amsaltu: taglimt tubrikt, taglimt tubrikt
ğŸ’‚	aÉ›essas
ğŸ’‚ğŸ»	aÉ›essas, aÉ›essas: taglimt taceÉ›lalt, taglimt taceÉ›lalt
ğŸ’‚ğŸ¼	aÉ›essas, aÉ›essas: tagwlimt taceÉ›lalt talemmast, tagwlimt taceÉ›lalt talemmast
ğŸ’‚ğŸ½	aÉ›essas, aÉ›essas: taglimt talemmast, taglimt talemmast
ğŸ’‚ğŸ¾	aÉ›essas, aÉ›essas: taglimt tubrikt talemmast, taglimt tubrikt talemmast
ğŸ’‚ğŸ¿	aÉ›essas, aÉ›essas: taglimt tubrikt, taglimt tubrikt
ğŸ¥·	aninja
ğŸ¥·ğŸ»	aninja, aninja: taglimt taceÉ›lalt, taglimt taceÉ›lalt
ğŸ¥·ğŸ¼	aninja, aninja: tagwlimt taceÉ›lalt talemmast, tagwlimt taceÉ›lalt talemmast
ğŸ¥·ğŸ½	aninja, aninja: taglimt talemmast, taglimt talemmast
ğŸ¥·ğŸ¾	aninja, aninja: taglimt tubrikt talemmast, taglimt tubrikt talemmast
ğŸ¥·ğŸ¿	aninja, aninja: taglimt tubrikt, taglimt tubrikt
ğŸ¤´	ageldun
ğŸ¤´ğŸ»	ageldun, ageldun: taglimt taceÉ›lalt, taglimt taceÉ›lalt
ğŸ¤´ğŸ¼	ageldun, ageldun: tagwlimt taceÉ›lalt talemmast, tagwlimt taceÉ›lalt talemmast
ğŸ¤´ğŸ½	ageldun, ageldun: taglimt talemmast, taglimt talemmast
ğŸ¤´ğŸ¾	ageldun, ageldun: taglimt tubrikt talemmast, taglimt tubrikt talemmast
ğŸ¤´ğŸ¿	ageldun, ageldun: taglimt tubrikt, taglimt tubrikt
ğŸ‘¸	tageldunt
ğŸ‘¸ğŸ»	tageldunt, tageldunt: taglimt taceÉ›lalt, taglimt taceÉ›lalt
ğŸ‘¸ğŸ¼	tageldunt, tageldunt: tagwlimt taceÉ›lalt talemmast, tagwlimt taceÉ›lalt talemmast
ğŸ‘¸ğŸ½	tageldunt, tageldunt: taglimt talemmast, taglimt talemmast
ğŸ‘¸ğŸ¾	tageldunt, tageldunt: taglimt tubrikt talemmast, taglimt tubrikt talemmast
ğŸ‘¸ğŸ¿	tageldunt, tageldunt: taglimt tubrikt, taglimt tubrikt
ğŸ‘³	amdan s uÉ›essab
ğŸ‘³ğŸ»	amdan s uÉ›essab, amdan s uÉ›essab: taglimt taceÉ›lalt, taglimt taceÉ›lalt
ğŸ‘³ğŸ¼	amdan s uÉ›essab, amdan s uÉ›essab: tagwlimt taceÉ›lalt talemmast, tagwlimt taceÉ›lalt talemmast
ğŸ‘³ğŸ½	amdan s uÉ›essab, amdan s uÉ›essab: taglimt talemmast, taglimt talemmast
ğŸ‘³ğŸ¾	amdan s uÉ›essab, amdan s uÉ›essab: taglimt tubrikt talemmast, taglimt tubrikt talemmast
ğŸ‘³ğŸ¿	amdan s uÉ›essab, amdan s uÉ›essab: taglimt tubrikt, taglimt tubrikt
ğŸ¤°	tameá¹­á¹­ut s tadist
ğŸ¤°ğŸ»	taglimt taceÉ›lalt, tameá¹­á¹­ut s tadist, tameá¹­á¹­ut s tadist: taglimt taceÉ›lalt
ğŸ¤°ğŸ¼	tagwlimt taceÉ›lalt talemmast, tameá¹­á¹­ut s tadist, tameá¹­á¹­ut s tadist: tagwlimt taceÉ›lalt talemmast
ğŸ¤°ğŸ½	taglimt talemmast, tameá¹­á¹­ut s tadist, tameá¹­á¹­ut s tadist: taglimt talemmast
ğŸ¤°ğŸ¾	taglimt tubrikt talemmast, tameá¹­á¹­ut s tadist, tameá¹­á¹­ut s tadist: taglimt tubrikt talemmast
ğŸ¤°ğŸ¿	taglimt tubrikt, tameá¹­á¹­ut s tadist, tameá¹­á¹­ut s tadist: taglimt tubrikt
ğŸ«ƒ	argaz s tadist
ğŸ«ƒğŸ»	argaz s tadist, argaz s tadist: taglimt taceÉ›lalt, taglimt taceÉ›lalt
ğŸ«ƒğŸ¼	argaz s tadist, argaz s tadist: tagwlimt taceÉ›lalt talemmast, tagwlimt taceÉ›lalt talemmast
ğŸ«ƒğŸ½	argaz s tadist, argaz s tadist: taglimt talemmast, taglimt talemmast
ğŸ«ƒğŸ¾	argaz s tadist, argaz s tadist: taglimt tubrikt talemmast, taglimt tubrikt talemmast
ğŸ«ƒğŸ¿	argaz s tadist, argaz s tadist: taglimt tubrikt, taglimt tubrikt
ğŸ«„	amdan s tawist
ğŸ«„ğŸ»	amdan s tawist, amdan s tawist: taglimt taceÉ›lalt, taglimt taceÉ›lalt
ğŸ«„ğŸ¼	amdan s tawist, amdan s tawist: tagwlimt taceÉ›lalt talemmast, tagwlimt taceÉ›lalt talemmast
ğŸ«„ğŸ½	amdan s tawist, amdan s tawist: taglimt talemmast, taglimt talemmast
ğŸ«„ğŸ¾	amdan s tawist, amdan s tawist: taglimt tubrikt talemmast, taglimt tubrikt talemmast
ğŸ«„ğŸ¿	amdan s tawist, amdan s tawist: taglimt tubrikt, taglimt tubrikt
ğŸ‘¼	aá¹­ufan aneglus
ğŸ‘¼ğŸ»	aá¹­ufan aneglus, aá¹­ufan aneglus: taglimt taceÉ›lalt, taglimt taceÉ›lalt
ğŸ‘¼ğŸ¼	aá¹­ufan aneglus, aá¹­ufan aneglus: tagwlimt taceÉ›lalt talemmast, tagwlimt taceÉ›lalt talemmast
ğŸ‘¼ğŸ½	aá¹­ufan aneglus, aá¹­ufan aneglus: taglimt talemmast, taglimt talemmast
ğŸ‘¼ğŸ¾	aá¹­ufan aneglus, aá¹­ufan aneglus: taglimt tubrikt talemmast, taglimt tubrikt talemmast
ğŸ‘¼ğŸ¿	aá¹­ufan aneglus, aá¹­ufan aneglus: taglimt tubrikt, taglimt tubrikt
ğŸ§Ÿ	aáº“umbi
ğŸ§Œ	aÉ£uliw
ğŸš¶	amdan ileá¸¥á¸¥un
ğŸš¶ğŸ»	amdan ileá¸¥á¸¥un, amdan ileá¸¥á¸¥un: taglimt taceÉ›lalt, taglimt taceÉ›lalt
ğŸš¶ğŸ¼	amdan ileá¸¥á¸¥un, amdan ileá¸¥á¸¥un: tagwlimt taceÉ›lalt talemmast, tagwlimt taceÉ›lalt talemmast
ğŸš¶ğŸ½	amdan ileá¸¥á¸¥un, amdan ileá¸¥á¸¥un: taglimt talemmast, taglimt talemmast
ğŸš¶ğŸ¾	amdan ileá¸¥á¸¥un, amdan ileá¸¥á¸¥un: taglimt tubrikt talemmast, taglimt tubrikt talemmast
ğŸš¶ğŸ¿	amdan ileá¸¥á¸¥un, amdan ileá¸¥á¸¥un: taglimt tubrikt, taglimt tubrikt
ğŸ§	amdan ibedden
ğŸ§ğŸ»	amdan ibedden, amdan ibedden: taglimt taceÉ›lalt, taglimt taceÉ›lalt
ğŸ§ğŸ¼	amdan ibedden, amdan ibedden: tagwlimt taceÉ›lalt talemmast, tagwlimt taceÉ›lalt talemmast
ğŸ§ğŸ½	amdan ibedden, amdan ibedden: taglimt talemmast, taglimt talemmast
ğŸ§ğŸ¾	amdan ibedden, amdan ibedden: taglimt tubrikt talemmast, taglimt tubrikt talemmast
ğŸ§ğŸ¿	amdan ibedden, amdan ibedden: taglimt tubrikt, taglimt tubrikt
ğŸ§	amdan É£ef tgecrar
ğŸ§ğŸ»	amdan É£ef tgecrar, amdan É£ef tgecrar: taglimt taceÉ›lalt, taglimt taceÉ›lalt
ğŸ§ğŸ¼	amdan É£ef tgecrar, amdan É£ef tgecrar: tagwlimt taceÉ›lalt talemmast, tagwlimt taceÉ›lalt talemmast
ğŸ§ğŸ½	amdan É£ef tgecrar, amdan É£ef tgecrar: taglimt talemmast, taglimt talemmast
ğŸ§ğŸ¾	amdan É£ef tgecrar, amdan É£ef tgecrar: taglimt tubrikt talemmast, taglimt tubrikt talemmast
ğŸ§ğŸ¿	amdan É£ef tgecrar, amdan É£ef tgecrar: taglimt tubrikt, taglimt tubrikt
ğŸƒ	amdan yettazzalen
ğŸƒğŸ»	amdan yettazzalen, amdan yettazzalen: taglimt taceÉ›lalt, taglimt taceÉ›lalt
ğŸƒğŸ¼	amdan yettazzalen, amdan yettazzalen: tagwlimt taceÉ›lalt talemmast, tagwlimt taceÉ›lalt talemmast
ğŸƒğŸ½	amdan yettazzalen, amdan yettazzalen: taglimt talemmast, taglimt talemmast
ğŸƒğŸ¾	amdan yettazzalen, amdan yettazzalen: taglimt tubrikt talemmast, taglimt tubrikt talemmast
ğŸƒğŸ¿	amdan yettazzalen, amdan yettazzalen: taglimt tubrikt, taglimt tubrikt
ğŸ’ƒ	tameá¹­á¹­ut iceá¹­á¹­á¸¥en
ğŸ’ƒğŸ»	taglimt taceÉ›lalt, tameá¹­á¹­ut iceá¹­á¹­á¸¥en, tameá¹­á¹­ut iceá¹­á¹­á¸¥en: taglimt taceÉ›lalt
ğŸ’ƒğŸ¼	tagwlimt taceÉ›lalt talemmast, tameá¹­á¹­ut iceá¹­á¹­á¸¥en, tameá¹­á¹­ut iceá¹­á¹­á¸¥en: tagwlimt taceÉ›lalt talemmast
ğŸ’ƒğŸ½	taglimt talemmast, tameá¹­á¹­ut iceá¹­á¹­á¸¥en, tameá¹­á¹­ut iceá¹­á¹­á¸¥en: taglimt talemmast
ğŸ’ƒğŸ¾	taglimt tubrikt talemmast, tameá¹­á¹­ut iceá¹­á¹­á¸¥en, tameá¹­á¹­ut iceá¹­á¹­á¸¥en: taglimt tubrikt talemmast
ğŸ’ƒğŸ¿	taglimt tubrikt, tameá¹­á¹­ut iceá¹­á¹­á¸¥en, tameá¹­á¹­ut iceá¹­á¹­á¸¥en: taglimt tubrikt
ğŸ•º	argaz iceá¹­á¹­á¸¥en
ğŸ•ºğŸ»	argaz iceá¹­á¹­á¸¥en, argaz iceá¹­á¹­á¸¥en: taglimt taceÉ›lalt, taglimt taceÉ›lalt
ğŸ•ºğŸ¼	argaz iceá¹­á¹­á¸¥en, argaz iceá¹­á¹­á¸¥en: tagwlimt taceÉ›lalt talemmast, tagwlimt taceÉ›lalt talemmast
ğŸ•ºğŸ½	argaz iceá¹­á¹­á¸¥en, argaz iceá¹­á¹­á¸¥en: taglimt talemmast, taglimt talemmast
ğŸ•ºğŸ¾	argaz iceá¹­á¹­á¸¥en, argaz iceá¹­á¹­á¸¥en: taglimt tubrikt talemmast, taglimt tubrikt talemmast
ğŸ•ºğŸ¿	argaz iceá¹­á¹­á¸¥en, argaz iceá¹­á¹­á¸¥en: taglimt tubrikt, taglimt tubrikt
ğŸ‘¯	imdanen s yimeáº“áº“uÉ£en n yiwtal
ğŸš´	amdan s uvilu
ğŸš´ğŸ»	amdan s uvilu, amdan s uvilu: taglimt taceÉ›lalt, taglimt taceÉ›lalt
ğŸš´ğŸ¼	amdan s uvilu, amdan s uvilu: tagwlimt taceÉ›lalt talemmast, tagwlimt taceÉ›lalt talemmast
ğŸš´ğŸ½	amdan s uvilu, amdan s uvilu: taglimt talemmast, taglimt talemmast
ğŸš´ğŸ¾	amdan s uvilu, amdan s uvilu: taglimt tubrikt talemmast, taglimt tubrikt talemmast
ğŸš´ğŸ¿	amdan s uvilu, amdan s uvilu: taglimt tubrikt, taglimt tubrikt
ğŸ¤½	amdan yetturare water polo
ğŸ¤½ğŸ»	amdan yetturare water polo, amdan yetturare water polo: taglimt taceÉ›lalt, taglimt taceÉ›lalt
ğŸ¤½ğŸ¼	amdan yetturare water polo, amdan yetturare water polo: tagwlimt taceÉ›lalt talemmast, tagwlimt taceÉ›lalt talemmast
ğŸ¤½ğŸ½	amdan yetturare water polo, amdan yetturare water polo: taglimt talemmast, taglimt talemmast
ğŸ¤½ğŸ¾	amdan yetturare water polo, amdan yetturare water polo: taglimt tubrikt talemmast, taglimt tubrikt talemmast
ğŸ¤½ğŸ¿	amdan yetturare water polo, amdan yetturare water polo: taglimt tubrikt, taglimt tubrikt
ğŸ¤¾	amdan yetturaren ddabex n ufus
ğŸ¤¾ğŸ»	amdan yetturaren ddabex n ufus, amdan yetturaren ddabex n ufus: taglimt taceÉ›lalt, taglimt taceÉ›lalt
ğŸ¤¾ğŸ¼	amdan yetturaren ddabex n ufus, amdan yetturaren ddabex n ufus: tagwlimt taceÉ›lalt talemmast, tagwlimt taceÉ›lalt talemmast
ğŸ¤¾ğŸ½	amdan yetturaren ddabex n ufus, amdan yetturaren ddabex n ufus: taglimt talemmast, taglimt talemmast
ğŸ¤¾ğŸ¾	amdan yetturaren ddabex n ufus, amdan yetturaren ddabex n ufus: taglimt tubrikt talemmast, taglimt tubrikt talemmast
ğŸ¤¾ğŸ¿	amdan yetturaren ddabex n ufus, amdan yetturaren ddabex n ufus: taglimt tubrikt, taglimt tubrikt
ğŸ›€	amdan yeccucufen
ğŸ›€ğŸ»	amdan yeccucufen, amdan yeccucufen: taglimt taceÉ›lalt, taglimt taceÉ›lalt
ğŸ›€ğŸ¼	amdan yeccucufen, amdan yeccucufen: tagwlimt taceÉ›lalt talemmast, tagwlimt taceÉ›lalt talemmast
ğŸ›€ğŸ½	amdan yeccucufen, amdan yeccucufen: taglimt talemmast, taglimt talemmast
ğŸ›€ğŸ¾	amdan yeccucufen, amdan yeccucufen: taglimt tubrikt talemmast, taglimt tubrikt talemmast
ğŸ›€ğŸ¿	amdan yeccucufen, amdan yeccucufen: taglimt tubrikt, taglimt tubrikt
ğŸ›Œ	amdan deg wusu
ğŸ›ŒğŸ»	amdan deg wusu, amdan deg wusu: taglimt taceÉ›lalt, taglimt taceÉ›lalt
ğŸ›ŒğŸ¼	amdan deg wusu, amdan deg wusu: tagwlimt taceÉ›lalt talemmast, tagwlimt taceÉ›lalt talemmast
ğŸ›ŒğŸ½	amdan deg wusu, amdan deg wusu: taglimt talemmast, taglimt talemmast
ğŸ›ŒğŸ¾	amdan deg wusu, amdan deg wusu: taglimt tubrikt talemmast, taglimt tubrikt talemmast
ğŸ›ŒğŸ¿	amdan deg wusu, amdan deg wusu: taglimt tubrikt, taglimt tubrikt
ğŸ‘­	tulawin myuá¹­á¹­afent ifassen
ğŸ‘­ğŸ»	taglimt taceÉ›lalt, tulawin myuá¹­á¹­afent ifassen, tulawin myuá¹­á¹­afent ifassen: taglimt taceÉ›lalt
ğŸ‘©ğŸ»â€ğŸ¤â€ğŸ‘©ğŸ¼	taglimt taceÉ›lalt, tagwlimt taceÉ›lalt talemmast, tulawin myuá¹­á¹­afent ifassen, tulawin myuá¹­á¹­afent ifassen: taglimt taceÉ›lalt, tagwlimt taceÉ›lalt talemmast
ğŸ‘©ğŸ»â€ğŸ¤â€ğŸ‘©ğŸ½	taglimt taceÉ›lalt, taglimt talemmast, tulawin myuá¹­á¹­afent ifassen, tulawin myuá¹­á¹­afent ifassen: taglimt taceÉ›lalt, taglimt talemmast
ğŸ‘©ğŸ»â€ğŸ¤â€ğŸ‘©ğŸ¾	taglimt taceÉ›lalt, taglimt tubrikt talemmast, tulawin myuá¹­á¹­afent ifassen, tulawin myuá¹­á¹­afent ifassen: taglimt taceÉ›lalt, taglimt tubrikt talemmast
ğŸ‘©ğŸ»â€ğŸ¤â€ğŸ‘©ğŸ¿	taglimt taceÉ›lalt, taglimt tubrikt, tulawin myuá¹­á¹­afent ifassen, tulawin myuá¹­á¹­afent ifassen: taglimt taceÉ›lalt, taglimt tubrikt
ğŸ‘©ğŸ¼â€ğŸ¤â€ğŸ‘©ğŸ»	taglimt taceÉ›lalt, tagwlimt taceÉ›lalt talemmast, tulawin myuá¹­á¹­afent ifassen, tulawin myuá¹­á¹­afent ifassen: tagwlimt taceÉ›lalt talemmast, taglimt taceÉ›lalt
ğŸ‘­ğŸ¼	tagwlimt taceÉ›lalt talemmast, tulawin myuá¹­á¹­afent ifassen, tulawin myuá¹­á¹­afent ifassen: tagwlimt taceÉ›lalt talemmast
ğŸ‘©ğŸ¼â€ğŸ¤â€ğŸ‘©ğŸ½	taglimt talemmast, tagwlimt taceÉ›lalt talemmast, tulawin myuá¹­á¹­afent ifassen, tulawin myuá¹­á¹­afent ifassen: tagwlimt taceÉ›lalt talemmast, taglimt talemmast
ğŸ‘©ğŸ¼â€ğŸ¤â€ğŸ‘©ğŸ¾	taglimt tubrikt talemmast, tagwlimt taceÉ›lalt talemmast, tulawin myuá¹­á¹­afent ifassen, tulawin myuá¹­á¹­afent ifassen: tagwlimt taceÉ›lalt talemmast, taglimt tubrikt talemmast
ğŸ‘©ğŸ¼â€ğŸ¤â€ğŸ‘©ğŸ¿	taglimt tubrikt, tagwlimt taceÉ›lalt talemmast, tulawin myuá¹­á¹­afent ifassen, tulawin myuá¹­á¹­afent ifassen: tagwlimt taceÉ›lalt talemmast, taglimt tubrikt
ğŸ‘©ğŸ½â€ğŸ¤â€ğŸ‘©ğŸ»	taglimt taceÉ›lalt, taglimt talemmast, tulawin myuá¹­á¹­afent ifassen, tulawin myuá¹­á¹­afent ifassen: taglimt talemmast, taglimt taceÉ›lalt
ğŸ‘©ğŸ½â€ğŸ¤â€ğŸ‘©ğŸ¼	taglimt talemmast, tagwlimt taceÉ›lalt talemmast, tulawin myuá¹­á¹­afent ifassen, tulawin myuá¹­á¹­afent ifassen: taglimt talemmast, tagwlimt taceÉ›lalt talemmast
ğŸ‘­ğŸ½	taglimt talemmast, tulawin myuá¹­á¹­afent ifassen, tulawin myuá¹­á¹­afent ifassen: taglimt talemmast
ğŸ‘©ğŸ½â€ğŸ¤â€ğŸ‘©ğŸ¾	taglimt talemmast, taglimt tubrikt talemmast, tulawin myuá¹­á¹­afent ifassen, tulawin myuá¹­á¹­afent ifassen: taglimt talemmast, taglimt tubrikt talemmast
ğŸ‘©ğŸ½â€ğŸ¤â€ğŸ‘©ğŸ¿	taglimt talemmast, taglimt tubrikt, tulawin myuá¹­á¹­afent ifassen, tulawin myuá¹­á¹­afent ifassen: taglimt talemmast, taglimt tubrikt
ğŸ‘©ğŸ¾â€ğŸ¤â€ğŸ‘©ğŸ»	taglimt taceÉ›lalt, taglimt tubrikt talemmast, tulawin myuá¹­á¹­afent ifassen, tulawin myuá¹­á¹­afent ifassen: taglimt tubrikt talemmast, taglimt taceÉ›lalt
ğŸ‘©ğŸ¾â€ğŸ¤â€ğŸ‘©ğŸ¼	taglimt tubrikt talemmast, tagwlimt taceÉ›lalt talemmast, tulawin myuá¹­á¹­afent ifassen, tulawin myuá¹­á¹­afent ifassen: taglimt tubrikt talemmast, tagwlimt taceÉ›lalt talemmast
ğŸ‘©ğŸ¾â€ğŸ¤â€ğŸ‘©ğŸ½	taglimt talemmast, taglimt tubrikt talemmast, tulawin myuá¹­á¹­afent ifassen, tulawin myuá¹­á¹­afent ifassen: taglimt tubrikt talemmast, taglimt talemmast
ğŸ‘­ğŸ¾	taglimt tubrikt talemmast, tulawin myuá¹­á¹­afent ifassen, tulawin myuá¹­á¹­afent ifassen: taglimt tubrikt talemmast
ğŸ‘©ğŸ¾â€ğŸ¤â€ğŸ‘©ğŸ¿	taglimt tubrikt, taglimt tubrikt talemmast, tulawin myuá¹­á¹­afent ifassen, tulawin myuá¹­á¹­afent ifassen: taglimt tubrikt talemmast, taglimt tubrikt
ğŸ‘©ğŸ¿â€ğŸ¤â€ğŸ‘©ğŸ»	taglimt taceÉ›lalt, taglimt tubrikt, tulawin myuá¹­á¹­afent ifassen, tulawin myuá¹­á¹­afent ifassen: taglimt tubrikt, taglimt taceÉ›lalt
ğŸ‘©ğŸ¿â€ğŸ¤â€ğŸ‘©ğŸ¼	taglimt tubrikt, tagwlimt taceÉ›lalt talemmast, tulawin myuá¹­á¹­afent ifassen, tulawin myuá¹­á¹­afent ifassen: taglimt tubrikt, tagwlimt taceÉ›lalt talemmast
ğŸ‘©ğŸ¿â€ğŸ¤â€ğŸ‘©ğŸ½	taglimt talemmast, taglimt tubrikt, tulawin myuá¹­á¹­afent ifassen, tulawin myuá¹­á¹­afent ifassen: taglimt tubrikt, taglimt talemmast
ğŸ‘©ğŸ¿â€ğŸ¤â€ğŸ‘©ğŸ¾	taglimt tubrikt, taglimt tubrikt talemmast, tulawin myuá¹­á¹­afent ifassen, tulawin myuá¹­á¹­afent ifassen: taglimt tubrikt, taglimt tubrikt talemmast
ğŸ‘­ğŸ¿	taglimt tubrikt, tulawin myuá¹­á¹­afent ifassen, tulawin myuá¹­á¹­afent ifassen: taglimt tubrikt
ğŸ‘«	tameá¹­á¹­ut d urgaz myuá¹­á¹­afen ifassen
ğŸ‘«ğŸ»	taglimt taceÉ›lalt, tameá¹­á¹­ut d urgaz myuá¹­á¹­afen ifassen, tameá¹­á¹­ut d urgaz myuá¹­á¹­afen ifassen: taglimt taceÉ›lalt
ğŸ‘©ğŸ»â€ğŸ¤â€ğŸ‘¨ğŸ¼	taglimt taceÉ›lalt, tagwlimt taceÉ›lalt talemmast, tameá¹­á¹­ut d urgaz myuá¹­á¹­afen ifassen, tameá¹­á¹­ut d urgaz myuá¹­á¹­afen ifassen: taglimt taceÉ›lalt, tagwlimt taceÉ›lalt talemmast
ğŸ‘©ğŸ»â€ğŸ¤â€ğŸ‘¨ğŸ½	taglimt taceÉ›lalt, taglimt talemmast, tameá¹­á¹­ut d urgaz myuá¹­á¹­afen ifassen, tameá¹­á¹­ut d urgaz myuá¹­á¹­afen ifassen: taglimt taceÉ›lalt, taglimt talemmast
ğŸ‘©ğŸ»â€ğŸ¤â€ğŸ‘¨ğŸ¾	taglimt taceÉ›lalt, taglimt tubrikt talemmast, tameá¹­á¹­ut d urgaz myuá¹­á¹­afen ifassen, tameá¹­á¹­ut d urgaz myuá¹­á¹­afen ifassen: taglimt taceÉ›lalt, taglimt tubrikt talemmast
ğŸ‘©ğŸ»â€ğŸ¤â€ğŸ‘¨ğŸ¿	taglimt taceÉ›lalt, taglimt tubrikt, tameá¹­á¹­ut d urgaz myuá¹­á¹­afen ifassen, tameá¹­á¹­ut d urgaz myuá¹­á¹­afen ifassen: taglimt taceÉ›lalt, taglimt tubrikt
ğŸ‘©ğŸ¼â€ğŸ¤â€ğŸ‘¨ğŸ»	taglimt taceÉ›lalt, tagwlimt taceÉ›lalt talemmast, tameá¹­á¹­ut d urgaz myuá¹­á¹­afen ifassen, tameá¹­á¹­ut d urgaz myuá¹­á¹­afen ifassen: tagwlimt taceÉ›lalt talemmast, taglimt taceÉ›lalt
ğŸ‘«ğŸ¼	tagwlimt taceÉ›lalt talemmast, tameá¹­á¹­ut d urgaz myuá¹­á¹­afen ifassen, tameá¹­á¹­ut d urgaz myuá¹­á¹­afen ifassen: tagwlimt taceÉ›lalt talemmast
ğŸ‘©ğŸ¼â€ğŸ¤â€ğŸ‘¨ğŸ½	taglimt talemmast, tagwlimt taceÉ›lalt talemmast, tameá¹­á¹­ut d urgaz myuá¹­á¹­afen ifassen, tameá¹­á¹­ut d urgaz myuá¹­á¹­afen ifassen: tagwlimt taceÉ›lalt talemmast, taglimt talemmast
ğŸ‘©ğŸ¼â€ğŸ¤â€ğŸ‘¨ğŸ¾	taglimt tubrikt talemmast, tagwlimt taceÉ›lalt talemmast, tameá¹­á¹­ut d urgaz myuá¹­á¹­afen ifassen, tameá¹­á¹­ut d urgaz myuá¹­á¹­afen ifassen: tagwlimt taceÉ›lalt talemmast, taglimt tubrikt talemmast
ğŸ‘©ğŸ¼â€ğŸ¤â€ğŸ‘¨ğŸ¿	taglimt tubrikt, tagwlimt taceÉ›lalt talemmast, tameá¹­á¹­ut d urgaz myuá¹­á¹­afen ifassen, tameá¹­á¹­ut d urgaz myuá¹­á¹­afen ifassen: tagwlimt taceÉ›lalt talemmast, taglimt tubrikt
ğŸ‘©ğŸ½â€ğŸ¤â€ğŸ‘¨ğŸ»	taglimt taceÉ›lalt, taglimt talemmast, tameá¹­á¹­ut d urgaz myuá¹­á¹­afen ifassen, tameá¹­á¹­ut d urgaz myuá¹­á¹­afen ifassen: taglimt talemmast, taglimt taceÉ›lalt
ğŸ‘©ğŸ½â€ğŸ¤â€ğŸ‘¨ğŸ¼	taglimt talemmast, tagwlimt taceÉ›lalt talemmast, tameá¹­á¹­ut d urgaz myuá¹­á¹­afen ifassen, tameá¹­á¹­ut d urgaz myuá¹­á¹­afen ifassen: taglimt talemmast, tagwlimt taceÉ›lalt talemmast
ğŸ‘«ğŸ½	taglimt talemmast, tameá¹­á¹­ut d urgaz myuá¹­á¹­afen ifassen, tameá¹­á¹­ut d urgaz myuá¹­á¹­afen ifassen: taglimt talemmast
ğŸ‘©ğŸ½â€ğŸ¤â€ğŸ‘¨ğŸ¾	taglimt talemmast, taglimt tubrikt talemmast, tameá¹­á¹­ut d urgaz myuá¹­á¹­afen ifassen, tameá¹­á¹­ut d urgaz myuá¹­á¹­afen ifassen: taglimt talemmast, taglimt tubrikt talemmast
ğŸ‘©ğŸ½â€ğŸ¤â€ğŸ‘¨ğŸ¿	taglimt talemmast, taglimt tubrikt, tameá¹­á¹­ut d urgaz myuá¹­á¹­afen ifassen, tameá¹­á¹­ut d urgaz myuá¹­á¹­afen ifassen: taglimt talemmast, taglimt tubrikt
ğŸ‘©ğŸ¾â€ğŸ¤â€ğŸ‘¨ğŸ»	taglimt taceÉ›lalt, taglimt tubrikt talemmast, tameá¹­á¹­ut d urgaz myuá¹­á¹­afen ifassen, tameá¹­á¹­ut d urgaz myuá¹­á¹­afen ifassen: taglimt tubrikt talemmast, taglimt taceÉ›lalt
ğŸ‘©ğŸ¾â€ğŸ¤â€ğŸ‘¨ğŸ¼	taglimt tubrikt talemmast, tagwlimt taceÉ›lalt talemmast, tameá¹­á¹­ut d urgaz myuá¹­á¹­afen ifassen, tameá¹­á¹­ut d urgaz myuá¹­á¹­afen ifassen: taglimt tubrikt talemmast, tagwlimt taceÉ›lalt talemmast
ğŸ‘©ğŸ¾â€ğŸ¤â€ğŸ‘¨ğŸ½	taglimt talemmast, taglimt tubrikt talemmast, tameá¹­á¹­ut d urgaz myuá¹­á¹­afen ifassen, tameá¹­á¹­ut d urgaz myuá¹­á¹­afen ifassen: taglimt tubrikt talemmast, taglimt talemmast
ğŸ‘«ğŸ¾	taglimt tubrikt talemmast, tameá¹­á¹­ut d urgaz myuá¹­á¹­afen ifassen, tameá¹­á¹­ut d urgaz myuá¹­á¹­afen ifassen: taglimt tubrikt talemmast
ğŸ‘©ğŸ¾â€ğŸ¤â€ğŸ‘¨ğŸ¿	taglimt tubrikt, taglimt tubrikt talemmast, tameá¹­á¹­ut d urgaz myuá¹­á¹­afen ifassen, tameá¹­á¹­ut d urgaz myuá¹­á¹­afen ifassen: taglimt tubrikt talemmast, taglimt tubrikt
ğŸ‘©ğŸ¿â€ğŸ¤â€ğŸ‘¨ğŸ»	taglimt taceÉ›lalt, taglimt tubrikt, tameá¹­á¹­ut d urgaz myuá¹­á¹­afen ifassen, tameá¹­á¹­ut d urgaz myuá¹­á¹­afen ifassen: taglimt tubrikt, taglimt taceÉ›lalt
ğŸ‘©ğŸ¿â€ğŸ¤â€ğŸ‘¨ğŸ¼	taglimt tubrikt, tagwlimt taceÉ›lalt talemmast, tameá¹­á¹­ut d urgaz myuá¹­á¹­afen ifassen, tameá¹­á¹­ut d urgaz myuá¹­á¹­afen ifassen: taglimt tubrikt, tagwlimt taceÉ›lalt talemmast
ğŸ‘©ğŸ¿â€ğŸ¤â€ğŸ‘¨ğŸ½	taglimt talemmast, taglimt tubrikt, tameá¹­á¹­ut d urgaz myuá¹­á¹­afen ifassen, tameá¹­á¹­ut d urgaz myuá¹­á¹­afen ifassen: taglimt tubrikt, taglimt talemmast
ğŸ‘©ğŸ¿â€ğŸ¤â€ğŸ‘¨ğŸ¾	taglimt tubrikt, taglimt tubrikt talemmast, tameá¹­á¹­ut d urgaz myuá¹­á¹­afen ifassen, tameá¹­á¹­ut d urgaz myuá¹­á¹­afen ifassen: taglimt tubrikt, taglimt tubrikt talemmast
ğŸ‘«ğŸ¿	taglimt tubrikt, tameá¹­á¹­ut d urgaz myuá¹­á¹­afen ifassen, tameá¹­á¹­ut d urgaz myuá¹­á¹­afen ifassen: taglimt tubrikt
ğŸ‘¬	irgazen myuá¹­á¹­afen ifassen
ğŸ‘¬ğŸ»	irgazen myuá¹­á¹­afen ifassen, irgazen myuá¹­á¹­afen ifassen: taglimt taceÉ›lalt, taglimt taceÉ›lalt
ğŸ‘¨ğŸ»â€ğŸ¤â€ğŸ‘¨ğŸ¼	irgazen myuá¹­á¹­afen ifassen, irgazen myuá¹­á¹­afen ifassen: taglimt taceÉ›lalt, tagwlimt taceÉ›lalt talemmast, taglimt taceÉ›lalt, tagwlimt taceÉ›lalt talemmast
ğŸ‘¨ğŸ»â€ğŸ¤â€ğŸ‘¨ğŸ½	irgazen myuá¹­á¹­afen ifassen, irgazen myuá¹­á¹­afen ifassen: taglimt taceÉ›lalt, taglimt talemmast, taglimt taceÉ›lalt, taglimt talemmast
ğŸ‘¨ğŸ»â€ğŸ¤â€ğŸ‘¨ğŸ¾	irgazen myuá¹­á¹­afen ifassen, irgazen myuá¹­á¹­afen ifassen: taglimt taceÉ›lalt, taglimt tubrikt talemmast, taglimt taceÉ›lalt, taglimt tubrikt talemmast
ğŸ‘¨ğŸ»â€ğŸ¤â€ğŸ‘¨ğŸ¿	irgazen myuá¹­á¹­afen ifassen, irgazen myuá¹­á¹­afen ifassen: taglimt taceÉ›lalt, taglimt tubrikt, taglimt taceÉ›lalt, taglimt tubrikt
ğŸ‘¨ğŸ¼â€ğŸ¤â€ğŸ‘¨ğŸ»	irgazen myuá¹­á¹­afen ifassen, irgazen myuá¹­á¹­afen ifassen: tagwlimt taceÉ›lalt talemmast, taglimt taceÉ›lalt, taglimt taceÉ›lalt, tagwlimt taceÉ›lalt talemmast
ğŸ‘¬ğŸ¼	irgazen myuá¹­á¹­afen ifassen, irgazen myuá¹­á¹­afen ifassen: tagwlimt taceÉ›lalt talemmast, tagwlimt taceÉ›lalt talemmast
ğŸ‘¨ğŸ¼â€ğŸ¤â€ğŸ‘¨ğŸ½	irgazen myuá¹­á¹­afen ifassen, irgazen myuá¹­á¹­afen ifassen: tagwlimt taceÉ›lalt talemmast, taglimt talemmast, taglimt talemmast, tagwlimt taceÉ›lalt talemmast
ğŸ‘¨ğŸ¼â€ğŸ¤â€ğŸ‘¨ğŸ¾	irgazen myuá¹­á¹­afen ifassen, irgazen myuá¹­á¹­afen ifassen: tagwlimt taceÉ›lalt talemmast, taglimt tubrikt talemmast, taglimt tubrikt talemmast, tagwlimt taceÉ›lalt talemmast
ğŸ‘¨ğŸ¼â€ğŸ¤â€ğŸ‘¨ğŸ¿	irgazen myuá¹­á¹­afen ifassen, irgazen myuá¹­á¹­afen ifassen: tagwlimt taceÉ›lalt talemmast, taglimt tubrikt, taglimt tubrikt, tagwlimt taceÉ›lalt talemmast
ğŸ‘¨ğŸ½â€ğŸ¤â€ğŸ‘¨ğŸ»	irgazen myuá¹­á¹­afen ifassen, irgazen myuá¹­á¹­afen ifassen: taglimt talemmast, taglimt taceÉ›lalt, taglimt taceÉ›lalt, taglimt talemmast
ğŸ‘¨ğŸ½â€ğŸ¤â€ğŸ‘¨ğŸ¼	irgazen myuá¹­á¹­afen ifassen, irgazen myuá¹­á¹­afen ifassen: taglimt talemmast, tagwlimt taceÉ›lalt talemmast, taglimt talemmast, tagwlimt taceÉ›lalt talemmast
ğŸ‘¬ğŸ½	irgazen myuá¹­á¹­afen ifassen, irgazen myuá¹­á¹­afen ifassen: taglimt talemmast, taglimt talemmast
ğŸ‘¨ğŸ½â€ğŸ¤â€ğŸ‘¨ğŸ¾	irgazen myuá¹­á¹­afen ifassen, irgazen myuá¹­á¹­afen ifassen: taglimt talemmast, taglimt tubrikt talemmast, taglimt talemmast, taglimt tubrikt talemmast
ğŸ‘¨ğŸ½â€ğŸ¤â€ğŸ‘¨ğŸ¿	irgazen myuá¹­á¹­afen ifassen, irgazen myuá¹­á¹­afen ifassen: taglimt talemmast, taglimt tubrikt, taglimt talemmast, taglimt tubrikt
ğŸ‘¨ğŸ¾â€ğŸ¤â€ğŸ‘¨ğŸ»	irgazen myuá¹­á¹­afen ifassen, irgazen myuá¹­á¹­afen ifassen: taglimt tubrikt talemmast, taglimt taceÉ›lalt, taglimt taceÉ›lalt, taglimt tubrikt talemmast
ğŸ‘¨ğŸ¾â€ğŸ¤â€ğŸ‘¨ğŸ¼	irgazen myuá¹­á¹­afen ifassen, irgazen myuá¹­á¹­afen ifassen: taglimt tubrikt talemmast, tagwlimt taceÉ›lalt talemmast, taglimt tubrikt talemmast, tagwlimt taceÉ›lalt talemmast
ğŸ‘¨ğŸ¾â€ğŸ¤â€ğŸ‘¨ğŸ½	irgazen myuá¹­á¹­afen ifassen, irgazen myuá¹­á¹­afen ifassen: taglimt tubrikt talemmast, taglimt talemmast, taglimt talemmast, taglimt tubrikt talemmast
ğŸ‘¬ğŸ¾	irgazen myuá¹­á¹­afen ifassen, irgazen myuá¹­á¹­afen ifassen: taglimt tubrikt talemmast, taglimt tubrikt talemmast
ğŸ‘¨ğŸ¾â€ğŸ¤â€ğŸ‘¨ğŸ¿	irgazen myuá¹­á¹­afen ifassen, irgazen myuá¹­á¹­afen ifassen: taglimt tubrikt talemmast, taglimt tubrikt, taglimt tubrikt, taglimt tubrikt talemmast
ğŸ‘¨ğŸ¿â€ğŸ¤â€ğŸ‘¨ğŸ»	irgazen myuá¹­á¹­afen ifassen, irgazen myuá¹­á¹­afen ifassen: taglimt tubrikt, taglimt taceÉ›lalt, taglimt taceÉ›lalt, taglimt tubrikt
ğŸ‘¨ğŸ¿â€ğŸ¤â€ğŸ‘¨ğŸ¼	irgazen myuá¹­á¹­afen ifassen, irgazen myuá¹­á¹­afen ifassen: taglimt tubrikt, tagwlimt taceÉ›lalt talemmast, taglimt tubrikt, tagwlimt taceÉ›lalt talemmast
ğŸ‘¨ğŸ¿â€ğŸ¤â€ğŸ‘¨ğŸ½	irgazen myuá¹­á¹­afen ifassen, irgazen myuá¹­á¹­afen ifassen: taglimt tubrikt, taglimt talemmast, taglimt talemmast, taglimt tubrikt
ğŸ‘¨ğŸ¿â€ğŸ¤â€ğŸ‘¨ğŸ¾	irgazen myuá¹­á¹­afen ifassen, irgazen myuá¹­á¹­afen ifassen: taglimt tubrikt, taglimt tubrikt talemmast, taglimt tubrikt, taglimt tubrikt talemmast
ğŸ‘¬ğŸ¿	irgazen myuá¹­á¹­afen ifassen, irgazen myuá¹­á¹­afen ifassen: taglimt tubrikt, taglimt tubrikt
ğŸ’‘	tayuga s wul
ğŸ’‘ğŸ»	taglimt taceÉ›lalt, tayuga s wul, tayuga s wul: taglimt taceÉ›lalt
ğŸ’‘ğŸ¼	tagwlimt taceÉ›lalt talemmast, tayuga s wul, tayuga s wul: tagwlimt taceÉ›lalt talemmast
ğŸ’‘ğŸ½	taglimt talemmast, tayuga s wul, tayuga s wul: taglimt talemmast
ğŸ’‘ğŸ¾	taglimt tubrikt talemmast, tayuga s wul, tayuga s wul: taglimt tubrikt talemmast
ğŸ’‘ğŸ¿	taglimt tubrikt, tayuga s wul, tayuga s wul: taglimt tubrikt
ğŸ‘©â€â¤â€ğŸ‘¨	argaz, tameá¹­á¹­ut, tayuga s wul, tayuga s wul: tameá¹­á¹­ut, argaz
ğŸ‘¨â€â¤â€ğŸ‘¨	argaz, tayuga s wul, tayuga s wul: argaz, argaz
ğŸ‘©â€â¤â€ğŸ‘©	tameá¹­á¹­ut, tayuga s wul, tayuga s wul: tameá¹­á¹­ut, tameá¹­á¹­ut
ğŸ‘ªï¸	tawacult
ğŸ‘¨â€ğŸ‘©â€ğŸ‘¦	aqcic, argaz, tameá¹­á¹­ut, tawacult, tawacult: argaz, tameá¹­á¹­ut, aqcic
ğŸ‘¨â€ğŸ‘©â€ğŸ‘§	argaz, tameá¹­á¹­ut, taqcict, tawacult, tawacult: argaz, tameá¹­á¹­ut, taqcict
ğŸ‘¨â€ğŸ‘©â€ğŸ‘§â€ğŸ‘¦	aqcic, argaz, tameá¹­á¹­ut, taqcict, tawacult, tawacult: argaz, tameá¹­á¹­ut, taqcict, aqcic
ğŸ‘¨â€ğŸ‘©â€ğŸ‘¦â€ğŸ‘¦	aqcic, argaz, tameá¹­á¹­ut, tawacult, tawacult: argaz, tameá¹­á¹­ut, aqcic, aqcic
ğŸ‘¨â€ğŸ‘©â€ğŸ‘§â€ğŸ‘§	argaz, tameá¹­á¹­ut, taqcict, tawacult, tawacult: argaz, tameá¹­á¹­ut, taqcict, taqcict
ğŸ‘¨â€ğŸ‘¨â€ğŸ‘¦	aqcic, argaz, tawacult, tawacult: argaz, argaz, aqcic
ğŸ‘¨â€ğŸ‘¨â€ğŸ‘§	argaz, taqcict, tawacult, tawacult: argaz, argaz, taqcict
ğŸ‘¨â€ğŸ‘¨â€ğŸ‘§â€ğŸ‘¦	aqcic, argaz, taqcict, tawacult, tawacult: argaz, argaz, taqcict, aqcic
ğŸ‘¨â€ğŸ‘¨â€ğŸ‘¦â€ğŸ‘¦	aqcic, argaz, tawacult, tawacult: argaz, argaz, aqcic, aqcic
ğŸ‘¨â€ğŸ‘¨â€ğŸ‘§â€ğŸ‘§	argaz, taqcict, tawacult, tawacult: argaz, argaz, taqcict, taqcict
ğŸ‘©â€ğŸ‘©â€ğŸ‘¦	aqcic, tameá¹­á¹­ut, tawacult, tawacult: tameá¹­á¹­ut, tameá¹­á¹­ut, aqcic
ğŸ‘©â€ğŸ‘©â€ğŸ‘§	tameá¹­á¹­ut, taqcict, tawacult, tawacult: tameá¹­á¹­ut, tameá¹­á¹­ut, taqcict
ğŸ‘©â€ğŸ‘©â€ğŸ‘§â€ğŸ‘¦	aqcic, tameá¹­á¹­ut, taqcict, tawacult, tawacult: tameá¹­á¹­ut, tameá¹­á¹­ut, taqcict, aqcic
ğŸ‘©â€ğŸ‘©â€ğŸ‘¦â€ğŸ‘¦	aqcic, tameá¹­á¹­ut, tawacult, tawacult: tameá¹­á¹­ut, tameá¹­á¹­ut, aqcic, aqcic
ğŸ‘©â€ğŸ‘©â€ğŸ‘§â€ğŸ‘§	tameá¹­á¹­ut, taqcict, tawacult, tawacult: tameá¹­á¹­ut, tameá¹­á¹­ut, taqcict, taqcict
ğŸ‘¨â€ğŸ‘¦	aqcic, argaz, tawacult, tawacult: argaz, aqcic
ğŸ‘¨â€ğŸ‘¦â€ğŸ‘¦	aqcic, argaz, tawacult, tawacult: argaz, aqcic, aqcic
ğŸ‘¨â€ğŸ‘§	argaz, taqcict, tawacult, tawacult: argaz, taqcict
ğŸ‘¨â€ğŸ‘§â€ğŸ‘¦	aqcic, argaz, taqcict, tawacult, tawacult: argaz, taqcict, aqcic
ğŸ‘¨â€ğŸ‘§â€ğŸ‘§	argaz, taqcict, tawacult, tawacult: argaz, taqcict, taqcict
ğŸ‘©â€ğŸ‘¦	aqcic, tameá¹­á¹­ut, tawacult, tawacult: tameá¹­á¹­ut, aqcic
ğŸ‘©â€ğŸ‘¦â€ğŸ‘¦	aqcic, tameá¹­á¹­ut, tawacult, tawacult: tameá¹­á¹­ut, aqcic, aqcic
ğŸ‘©â€ğŸ‘§	tameá¹­á¹­ut, taqcict, tawacult, tawacult: tameá¹­á¹­ut, taqcict
ğŸ‘©â€ğŸ‘§â€ğŸ‘¦	aqcic, tameá¹­á¹­ut, taqcict, tawacult, tawacult: tameá¹­á¹­ut, taqcict, aqcic
ğŸ‘©â€ğŸ‘§â€ğŸ‘§	tameá¹­á¹­ut, taqcict, tawacult, tawacult: tameá¹­á¹­ut, taqcict, taqcict
ğŸ—£ï¸	aqerru yettmeslayen
ğŸ«‚	imdanen ttemsalamen
ğŸ‘£	lÇ§erra n yiá¸arren
ğŸ¦°	acekkuá¸¥ azeggaÉ£
ğŸ¦±	acekkuá¸¥Â akerá¹­uá¹­fan
ğŸ¦³	acekkuá¸¥Â amellal
ğŸ¦²	aferá¸as
ğŸµ	adaqum n yibki
ğŸ’	ibki
ğŸ¦	aguril
ğŸ¦§	amdan n teáº“gi
ğŸ¶	udem n uydi
ğŸ•ï¸	aydi
ğŸ¦®	aydi amaway
ğŸ©	akanic
ğŸº	aguleh
ğŸ¦Š	abaraÉ£
ğŸ¦	arakun
ğŸ±	udem n umcic
ğŸˆï¸	amcic
ğŸ¯	udem n uÉ£ilas
ğŸ…	aÉ£ilas
ğŸ†	agiw
ğŸ´	udem n uÉ›ewdiw
ğŸ	aÉ›ewdiw
ğŸ¦„	bu yiwen n yiccew
ğŸ¦“	aÉ£yul n teáº“gi
ğŸ¦Œ	tizerzert
ğŸ¦¬	aramul n marikan
ğŸ®	udem n tfunast
ğŸ‚	azger
ğŸƒ	alebbic n waman
ğŸ„	tafunast
ğŸ·	aqadum n uá¸¥elluf
ğŸ–	aá¸¥elluf
ğŸ—	ilef
ğŸ½	tinzarin n uá¸¥elluf
ğŸ	akrar
ğŸ‘	tixsi
ğŸ	taÉ£aá¹­
ğŸª	alÉ£em
ğŸ«	alÉ£em bu snat n tkeÉ›rurin
ğŸ¦™	alama
ğŸ¦’	amdeÉ£
ğŸ˜	ilu
ğŸ¦£	amamut
ğŸ¦	arinusirus
ğŸ¦›	apuputam
ğŸ­	aqadum n uÉ£erda
ğŸ	aÉ£erda
ğŸ€	á¹­ubba
ğŸ¹	ahamester
ğŸ°	udem n uwtul
ğŸ‡	awtul
ğŸ¿ï¸	tadÉ£aÉ£at
ğŸ¦«	akastur
ğŸ¦”	inisi
ğŸ¦‡	azuÉ£nennay
ğŸ»	ursu
ğŸ¨	akwala
ğŸ¼	apanda
ğŸ¦¥	Asellaw
ğŸ¦¦	aselá¸ aman
ğŸ¦˜	akanguru
ğŸ¦¡	isirru
ğŸ¾	tirekkiá¸in n yiá¸arren
ğŸ¦ƒ	adandu
ğŸ”	tayaziá¸t
ğŸ“	ayaziá¸
ğŸ£	acewcew yefrurxen
ğŸ¤	acewcew
ğŸ¥	afellus si zdat
ğŸ¦ï¸	agá¸iá¸
ğŸ§	ameddul
ğŸ•Šï¸	itbir
ğŸ¦…	lbaz
ğŸ¦†	abá¹›ik
ğŸ¦¢	iblireÇ§
ğŸ¦‰	bururu
ğŸ¦¤	adudu
ğŸª¶	taricet
ğŸ¦©	aflaminku
ğŸ¦š	afrux n á¹­awes
ğŸ¦œ	babaÉ£ayu
ğŸ¸	imqerqer
ğŸŠ	aÉ£ucaf
ğŸ¢	ifker
ğŸ¦	tata
ğŸ	azrem
ğŸ²	udem n udragu
ğŸ‰	adragu
ğŸ¦•	aá¹£urupud
ğŸ¦–	T-Reks
ğŸ³	tizmekt i d-yessufuÉ£en aman
ğŸ‹	tizmekt
ğŸ¬	addenfil
ğŸ¦­	Aydi n waman
ğŸŸï¸	aslem
ğŸ¡	aslem icuffen
ğŸ¦ˆ	awqas
ğŸ™	iqirniá¸
ğŸš	ajeÉ£lal yenná¸en
ğŸª¸	lmerÇ§an
ğŸŒ	aÎµarus
ğŸ¦‹	aferteá¹­á¹­u
ğŸ›	aburbu
ğŸœ	taweá¹­á¹­uft
ğŸ	tizizwit
ğŸª²	axunefsiw
ğŸ	takumda
ğŸ¦—	ajá¹›ad
ğŸª³	akafaá¹›
ğŸ•·ï¸	tissist
ğŸ•¸ï¸	azeá¹­á¹­a n tissist
ğŸ¦Ÿ	tizit
ğŸª°	izi
ğŸª±	ijirmeá¸
ğŸ¦ 	amiká¹›ub
ğŸ’	tameqqunt
ğŸŒ¸	ajeÄŸÄŸig n taknisya
ğŸ’®	ajeÄŸÄŸig amellal
ğŸª·	abelbaquc
ğŸµï¸	tawerdit
ğŸŒ¹	tawerdet
ğŸ¥€	ajeÄŸÄŸig akiwan
ğŸŒº	tibiná¹£ert
ğŸŒ»	magriá¹­ij
ğŸŒ¼	amgud
ğŸŒ·	taxlult n nnbi
ğŸŒ±	imÉ£i aleqqaq
ğŸª´	imÉ£i deg uá¸¥ibus
ğŸŒ²	aseklu s yifer imezgi
ğŸŒ³	aseklu bu yifer
ğŸŒ´	tazdayt
ğŸŒµ	tasiÉ£awt
ğŸŒ¾	taceá¹›á¹›aft n á¹›á¹›uz
ğŸŒ¿	ifer
â˜˜ï¸	ikeffis
ğŸ€	ikeffis bu kuáº“ n wafriwen
ğŸ	ifer n kikeb
ğŸ‚	ifer yeÉ£lin
ğŸƒ	ifer yessafag waá¸u
ğŸª¹	lÉ›ec ilem
ğŸªº	lÉ›ec s tmellalin
ğŸ„	tagerselt
ğŸ‡	tiáº“urin
ğŸˆ	afeqqus
ğŸ‰	delleÉ›
ğŸŠ	tamandarit
ğŸ‹	talimet
ğŸŒ	tabanant
ğŸ	tananast
ğŸ¥­	tamungat
ğŸ	tatteffaá¸¥t tazeggaÉ£t
ğŸ	tatteffaá¸¥t tazegzawt
ğŸ	ifires
ğŸ‘	taxuxet
ğŸ’	areá¸li
ğŸ“	tariwalt
ğŸ«	cilmun
ğŸ¥	takiwit
ğŸ…	taá¹­umaá¹­ict
ğŸ«’	azemmur
ğŸ¥¥	iÉ£san n koko
ğŸ¥‘	tavukat
ğŸ†	patenÇ§al
ğŸ¥”	baá¹­aá¹­a
ğŸ¥•	taáº“rudgat
ğŸŒ½	ageá¹­á¹­uc
ğŸŒ¶ï¸	ifelfel aqerá¸¥an
ğŸ«‘	ifelfel n leá¸¥lu
ğŸ¥’	ilekkel
ğŸ¥¬	Tidelt n iferrawen izegzawen
ğŸ¥¦	brukuli
ğŸ§„	tiskert
ğŸ§…	aáº“alim
ğŸ¥œ	kawkaw
ğŸ«˜	llubyan
ğŸŒ°	abelluá¸ n urumi
ğŸ	aÉ£rum
ğŸ¥	akarwasun
ğŸ¥–	tabagiá¸t n uÉ£rum
ğŸ«“	taá¸¥bult n uÉ£rum
ğŸ¥¨	bretzel
ğŸ¥¯	abinyi
ğŸ—	tamessaá¸t n uyaziá¸
ğŸ¥©	tacriá¸¥t n uksum
ğŸ¥ª	aá¹£undwic
ğŸ¥š	tamellalt
ğŸ³	tamellalt yewwan
ğŸ²	taqessult n tgella
ğŸ¥—	cclaá¸a tazegzawt
ğŸ¿	akbal icuffen
ğŸ§ˆ	udi
ğŸ§‚	tisent
ğŸš	rruáº“ yewwan
ğŸ	spagiti
ğŸ 	baá¹­aá¹­a taáº“idant ikenfen
ğŸ£	aá¹£uci
ğŸ¦€	tifiraqest
ğŸ¦	aqemrun
ğŸ¦ª	idway
ğŸ«	tabewwaá¸t n ccakula
ğŸ¬	taá¸¥lawat
ğŸ­	tameccaá¸¥t
ğŸ¯	tabellaá¹›t n tament
ğŸ¼	abibá¹›u
ğŸ¥›	lkas n uyefki
ğŸ«–	tabaqrajt n latay
ğŸµ	afenÇ§al n latay war afus
ğŸ·	lkas n ccá¹›ab
ğŸº	abuqal n tebyiá¹›t
ğŸ»	asÄenÄen n yibuqal n tebyiá¹›t
ğŸ¥‚	asÄenÄen n lkisan
ğŸ§Š	agris
ğŸ¥¢	tileqqaá¸in
ğŸ½ï¸	tafarciá¸t d lmus s uá¸ebsi
ğŸ´	tafarciá¸t d lmus
ğŸ¥„	tijÉ£elt
ğŸ”ª	tafruyt n usaÄÄet
ğŸ«™	tabellaá¹›t
ğŸº	tabuqalt
ğŸŒ	amtiweg turuft tafriqt
ğŸŒï¸	amtiweg timrikin
ğŸŒ	amtiweg asya ustralya
ğŸ—ºï¸	takará¸a n umaá¸al
ğŸ—¾	takará¸a n Japun
ğŸ§­	tabuá¹£ult
ğŸ”ï¸	adrar n udfel
â›°ï¸	adrar
ğŸŒ‹	avulkan
ğŸ—»	Taqacuct Fuji
ğŸ•ï¸	asdar
ğŸ–ï¸	taftisft d ssiwan
ğŸœï¸	aneáº“ruf
ğŸï¸	tigzirt taneáº“ruft
ğŸï¸	amá¹›aá¸¥ aÉ£elnaw
ğŸŸï¸	annar
ğŸ›ï¸	amedruz aklasikan
ğŸ—ï¸	bennu n uzadaÉ£
ğŸ§±	Tayajuá¹›t
ğŸª¨	ablaá¸
ğŸªµ	asÉ£ar
ğŸ›–	atemmu
ğŸ˜ï¸	ixxamen
ğŸšï¸	axxam yettwaá¸eggren
ğŸ ï¸	axxam
ğŸ¡	axxam s tmazirt
ğŸ¢	azadaÉ£Â n tnariyin
ğŸ£	tanazant tajapunit
ğŸ¤	tanarit n tnazant
ğŸ¥	Asegnaf
ğŸ¦	tabanka
ğŸ¨	asensu
ğŸ©	asensu n tayri
ğŸª	talzuzt
ğŸ«	aÉ£erbaz
ğŸ¬	taá¸¥anut meqqren
ğŸ­ï¸	taneÉ£raft
ğŸ¯	tiÉ£remt tajapunit
ğŸ°	tiÉ£remt
ğŸ’’	tissulya
ğŸ—¼	TiÉ£remt n Tokyo
ğŸ—½	asebdad n tlelli
â›ªï¸	tamezgida n yimasiá¸¥iyen
ğŸ•Œ	tamezgida n yinselmen
ğŸ›•	tamesgida handu
ğŸ•	tamezgida n wudayen
â›©ï¸	asebdad shrine
ğŸ•‹	lkaÉ›va
â›²ï¸	tala
â›ºï¸	aqiá¸un
ğŸŒ	agu
ğŸŒƒ	iá¸ s yitran
ğŸ™ï¸	tamdint
ğŸŒ„	alluy n yiá¹­ij É£ef yidurar
ğŸŒ…	alluy n yiá¹­ij
ğŸŒ‡	aÉ£elluy n yiá¹­ij
ğŸŒ‰	tiqená¹­ert deg yiá¸
â™¨ï¸	lá¸¥emmam
ğŸš‚	aqerru n tmacint
ğŸšƒ	abrid n tmacint
ğŸš‡ï¸	amitá¹›u
ğŸšˆ	amitru afess
ğŸš“	Takerrust n temsulta
ğŸš•	Ataksi
ğŸš—	Takerrust
ğŸ›¹	Avilu
ğŸš¨	Taftilt n tkerrust n tmsulta
âœˆï¸	asafag
ğŸ›©ï¸	asafag ameáº“yan
ğŸ’º	tasÉ£imt
ğŸš	talikuptirt
ğŸ›°ï¸	Aá¹£atilit
ğŸš€	tallunt
ğŸ›¸	taÉ£awsa tarussint yettafgen
âŒ›ï¸	tamrilt n ijdan
â³ï¸	tamrilt n ijdan yettmirin
âŒšï¸	tamrilt
â±ï¸	amesnakud
â²ï¸	Asakway
ğŸŒ¡ï¸	atirmumitr
â˜€ï¸	iá¹­ij
â˜ï¸	asigna
â›…ï¸	iá¹­ij deffir n usigna
ğŸŒ¤ï¸	asigna, iá¹­ij
ğŸŒ«ï¸	tagut
ğŸŒˆ	tislit n unáº“ar
ğŸŒ‚	ssiwan imedlen
â˜‚ï¸	ssiwan
â˜”ï¸	ssiwan s tmeqqwa n waman
â›±ï¸	ssiwan É£ef tmurt
âš¡ï¸	lebreq
â„ï¸	adfel
â˜ƒï¸	argaz n udfel
ğŸ”¥	times
ğŸ’§	timeqqit
ğŸŒŠ	lmuja n waman
ğŸƒ	taxsayt
ğŸ„	aseklu n nawel
ğŸ†	asfugel
ğŸ‡	ifá¹­iwej
ğŸ§¨	aá¸¥erbi
âœ¨	itran
ğŸˆ	asfugel
ğŸ§§	tabrat tazeggaÉ£t
ğŸ€	asfugel
ğŸ«	atiki
ğŸ–ï¸	cciÉ›a taserdasant
ğŸ†ï¸	arraz
ğŸ…	cciÉ›a n waddal
ğŸ¥‡	cciÉ›a n umá¸iq 1u
ğŸ¥ˆ	cciÉ›a n umá¸iq wis 2
ğŸ¥‰	cciÉ›a n umá¸iq wis 3
âš½ï¸	ddabex n uá¸ar
ğŸ“	ping pung
ğŸ¸	badminá¹­un
ğŸ”®	takurt n ukrisá¹­al
ğŸ®ï¸	urar n tvidyut
ğŸ€„ï¸	azeggaÉ£, mahjong, urar
ğŸ´	takará¸a, urar
ğŸ–¼ï¸	tugna s ukatar
ğŸª¡	tisegnit n lexyaá¸a
ğŸ§¶	takurt n lxiá¸
ğŸ‘“ï¸	tismaqqalin
ğŸ•¶ï¸	nnwaá¸er n yiá¹­ij
ğŸ¥½	nnwaá¸er n uá¸¥ader
ğŸ¥¼	tavluzt n ulabuá¹›atwar
ğŸ¦º	ajili n tÉ£ellist
ğŸ‘”	takravaá¸t
ğŸ‘•	amayut
ğŸ‘–	aserwal
ğŸ§£	akackul
ğŸ§¤	iqeffazen
ğŸ§¥	abaltu
ğŸ§¦	iqaciren
ğŸ‘—	taqendurt
ğŸ‘˜	akimunu
ğŸ¥»	asari
ğŸ©±	amayut n ucucef É£ef yiwen
ğŸ©²	takiluá¸t
ğŸ©³	abirmida
ğŸ‘™	abikini
ğŸ‘š	iceá¹­á¹­iá¸en n tlawin
ğŸ‘›	á¹£á¹£ak
ğŸ‘œ	taá¹£akuct
ğŸ‘	taxriá¸t
ğŸ›ï¸	aá¸ellaÉ›
ğŸ’	á¹£á¹£ak n waÉ›rur
ğŸ©´	taklakiá¸t
ğŸ‘	iá¹£ebbaá¸en n urgaz
ğŸ‘Ÿ	iá¹£ebbaá¸en n tazzla
ğŸ¥¾	iá¹£ebbaá¸en n tikli
ğŸ¥¿	tibelÉ£atin
ğŸ‘ 	asebbaá¸ n talu É£ezzifen
ğŸ‘¡	asundal n tlawin
ğŸ©°	isebbaá¸en n ccá¸eá¸¥
ğŸ‘¢	abutyu n tlawin
ğŸ‘‘	TaÉ›essabt n ugellid
ğŸ‘’	Timá¸elliwt n tmeá¹­á¹­ut
ğŸ©	acapun aÉ£ezfan
ğŸ“ï¸	takaskiá¸t n usdawan
ğŸ§¢	takaskiá¸t
ğŸª–	takaskiá¸t n userdas
â›‘ï¸	akaskiá¸ amidag amellal
ğŸ“¿	teá¹£biá¸¥
ğŸ’„	zzin aÎ³ec
ğŸ’	taxatemt
ğŸ’	aáº“ru É£layen
ğŸ”‡	asusam
ğŸ”ˆï¸	imesli meáº“áº“iyen
ğŸ”‰	imesli alemmas
ğŸ”Š	imesli meqqren
ğŸ“¢	imsemÉ£er n yimesli
ğŸ“£	amigafun
ğŸ“¯	ajewwaq ubrin
ğŸ””	aninay
ğŸ”•	aninay yegdel
ğŸ¼	tagrumma n tezmilin n uáº“awan
ğŸµ	tazmilt taáº“awant
ğŸ¶	tizmilin tiáº“awanin
ğŸ™ï¸	asawaá¸ n uxxam n usekles
ğŸšï¸	taá¸¥naccaá¸t n uswir
ğŸ›ï¸	tiqeffalin n uá¹£eggem
ğŸ¤	asawaá¸
ğŸ§ï¸	Ismazgaten
ğŸ“»ï¸	rradyu
ğŸ·	asaksufun
ğŸª—	akudiyun
ğŸ¸	snitra
ğŸ¹	anasiw amáº“awan
ğŸª•	abanju
ğŸ“±	tiliÉ£ri tazirazt
ğŸ“²	tiliÉ£ri tazirazt s uneccab
â˜ï¸	tiliÉ£ri
ğŸ“	imsuddes n tiliÉ£ri
ğŸ“ 	tamacint n unÉ£el
ğŸ”‹	aáº“ru
ğŸª«	aáº“ru yeÉ›yan
ğŸ’»ï¸	aselkim aziraz
ğŸ–¥ï¸	aselkim n tnarit
ğŸ–¨ï¸	tasaggazt
âŒ¨ï¸	anasiw
ğŸ–±ï¸	taÉ£erdayt n uselkim
ğŸ–²ï¸	aselkim
ğŸ’½	aá¸ebsi n uselkim
ğŸ’¾	adebá¹£i aleqqaq
ğŸ’¿ï¸	aá¸ebsi asekdan
ğŸ“€	dvd
ğŸ§®	abakus
ğŸ¥	takamiá¹›at n yisura
ğŸ“½ï¸	ameskan n yisura
ğŸ“ºï¸	tiliáº“ri
ğŸ“·ï¸	Takamiá¹›at
ğŸ•¯ï¸	tacemmuÎµt
ğŸ“”	imedlis s tduli icebá¸¥en
ğŸ“•	adlis imedlen
ğŸ“–	adlis yeldin
ğŸ“—	adlis azegzaw
ğŸ“˜	adlis amidadi
ğŸ“™	adlis aÄinawi
ğŸ“šï¸	idlisen
ğŸ““	imedlis
ğŸ“’	ambellez
ğŸ“ƒ	asebter yenná¸en
ğŸ“œ	adrurem
ğŸ“„	asebter
ğŸ“°	aÉ£mis
ğŸ—	aÉ£Ã¹is yenná¸en
ğŸ“‘	accaren n tecraá¸
ğŸ”–	tacreá¹­ n usebter
ğŸ·ï¸	tabzimt
ğŸ’°ï¸	sselfa
ğŸª™	aá¹£urdi
ğŸ’´	lkaÉ£eá¸ n yen
ğŸ’µ	lkaÉ£eá¸ n udular
ğŸ’¶	lkareá¸ n uru
ğŸ’·	lkaÉ£eá¸ n upawnd
ğŸ’¸	idrimen s yiferrawen
ğŸ’³ï¸	takará¸a n usmad
ğŸ§¾	awwaá¸
âœ‰ï¸	tajellabt
ğŸ“§	imayl
ğŸ“¨	izen ukcim
ğŸ“©	izen yettwazen
ğŸ“¤ï¸	tanaka n tuzna
ğŸ“¥ï¸	tanaka n urmas
ğŸ“¦ï¸	akemmus
ğŸ—³ï¸	asenduq
âœï¸	imru
âœ’ï¸	imru n tricet aberkan
ğŸ–‹ï¸	imru n lmidad
ğŸ–ï¸	akeryun
ğŸ’¼	aqrab
ğŸ“	akaram n ufaylu
ğŸ“‚	ldi akaram n ufaylu
ğŸ“…	awitay
ğŸ“†	awitay yettwakksen
ğŸ“‹ï¸	É£ef wafus
ğŸ”’ï¸	yemdel
ğŸ”“ï¸	yeldi
ğŸ”	yemdel s yimru
ğŸ”	yemdel s tsarut
ğŸ”‘	tasarut
ğŸ—ï¸	tasarut taqdimt
ğŸ”¨	tafá¸ist
ğŸª“	tacaqurt
â›ï¸	agelzim
âš’ï¸	afá¸is d ugelzim
ğŸ›¡ï¸	abeckiá¸
âš™ï¸	afecku
ğŸ”—	aseÉ£wen
â›“ï¸	snesla
ğŸ§¬	dna
ğŸ”¬	amikruskup
ğŸ”­	atiliskup
ğŸ’‰	tisegnit
ğŸ©¸	tiqiit n yidammen
ğŸ’Š	amejjay, amuá¸in, tujjya
ğŸšª	tabburt
ğŸ›ï¸	ameá¹­reá¸¥
ğŸª‘	akersi
ğŸ§¹	imeá¹£leá¸¥
ğŸ§º	taqecwalt
ğŸª£	abelyun
ğŸ§¼	á¹£á¹£abun
ğŸª¥	ccita n tuÉ£mas
ğŸ§¯	imsexsi
ğŸ›’	taqecwalt n tiÉ£in
ğŸš¬	ageá¹›á¹›u
âš°ï¸	nneÉ›c
ğŸª¦	ccahed
ğŸª¬	lxamsa
ğŸª§	tafilt
ğŸªª	takará¸a n timagit
ğŸ§	tamacint n tedrimt tawurmant
ğŸš®	tignit n yiá¸umman
ğŸš°	aman n tissit
â™¿ï¸	azamul n unekcum n umeÉ›duá¹›
ğŸš¹ï¸	taxxamt n urgaz
ğŸšºï¸	azamul n texxamt n tmeá¹­á¹­ut
ğŸš»	azamul n teslalayt
ğŸš¼ï¸	azamul n uá¹­ufan
ğŸš¾	taslalayt
ğŸ›‚	asenqed n umsineg
ğŸ›ƒ	tadewwant
ğŸ›„	asuter n dduzan
ğŸ›…	dduzan yettwattun
âš ï¸	aberri
ğŸš¸	abrid n yigerdan
â›”ï¸	aÉ›eddi yegdel
ğŸš«	yegdel
ğŸš³	avilu yegdel
ğŸš­ï¸	akeyyef yegdel
ğŸš¯	ur ttá¸eyyir ara iá¸umman
ğŸš±	maÄÄi d aman n tissit
ğŸš·	igdel i yimesá¸aá¹›en
ğŸ“µ	tiliÉ£ri n ufus tegdel
ğŸ”	yegdel ddaw n tmená¹­ac
â¬†ï¸	aneccab d asawen
â†—ï¸	aneccab asawen ayeffus
â¡ï¸	aneccab ayeffus
â†˜ï¸	aneccab d akesser uáº“áº“il
â¬‡ï¸	aneccab akesser
â†™ï¸	aneccab akesser ayeffus
â¬…ï¸	aneccab azelmaá¸
â†–ï¸	aneccab asawen azelmaá¸
â†•ï¸	aneccab asawen akesser
â†”ï¸	aneccab azelmaá¸ ayeffus
â†©ï¸	aneccab ayeffus yettin s azelmaá¸
â†ªï¸	aneccab azelmaá¸ yettin s ayeffus
â¤´ï¸	aneccab ayeffus yettin d asawen
â¤µï¸	aneccab ayeffus yettin d akesser
ğŸ”ƒ	ineccaben tanila n isegnan n temrilt
ğŸ”„	taqeffalt n ineccaben n tnila yettin n isegnan n temrilt
ğŸ”™	Aneccab n tuÉ£alin
ğŸ”š	Aneccab n taggara
ğŸ”›	urmid
ğŸ”œ	Aneccab Qrib
ğŸ”	aneccab n ufella
ğŸ›	amá¸iq n táº“allit
âš›ï¸	azamul n ubelkim
ğŸ•‰ï¸	om
âœ¡ï¸	itri n David
â˜¸ï¸	Rruda n dharma
â˜¯ï¸	yin yang
â˜ªï¸	aggur d yitri
â˜®ï¸	azamul n talwit
â™ˆï¸	Ikerri
â™‰ï¸	Aramul
â™Šï¸	Akniwen
â™‹ï¸	Afurray
â™Œï¸	Izem
â™ï¸	Taá¸¥bayrit
â™ï¸	Tacihant
â™ï¸	TiÉ£irdemt
â™ï¸	Amnaccab
â™‘ï¸	Aqelwac
â™’ï¸	Azfuf
â™“ï¸	Islem
â›	Aáº“udyak
ğŸ”€	Aneccab anmidag
ğŸ”	aneccab imdewweá¹›
â–¶	taqeffalt n tÉ£uri
â©	taqeffalt n uÉ£iwel É£er zdat
â­	taqeffalt tafuÉ£alt d-iteddun
â¯	taqeffalt taÉ£uri/araÇ§u
â—€	taqeffalt n tuÉ£alin
âª	taqeffalt n tuÉ£alin s uÉ£iwel
â®	taqeffalt tafuÉ£alt taneggarut
ğŸ”¼	taqeffalt d asawen
â«	taqeffalt n usÉ£iwel
ğŸ”½	taqeffalt d akesser
â¬	taqeffant n uá¹£ubbu s uÉ£iwel
â¸ï¸	taqeffalt n uraÇ§u
â¹ï¸	taqeffalt n useá¸¥bes
âºï¸	taqeffalt n usekles
âï¸	taqeffalt n tukksa
ğŸ¦	sinima
â™€ï¸	azamul n tewtemt
â™‚ï¸	azamul n uwtem
âš§ï¸	Azamul n bu snat n tewsatin
âœ–ï¸	asgat
â•	timerna
â–	asenÉ£es
â—	beá¹­á¹­u
ğŸŸ°	geddu
â™¾ï¸	war talast
â€¼ï¸	asÉ£al n ubhat uslig
â—ï¸	asÉ£al n ubhat azeggaÉ£
ğŸ’²	adulaá¹›, idrimen, tadrimt
#âƒ£	keycap, keycap: #
*âƒ£	keycap, keycap: *
0âƒ£	keycap, keycap: 0
1âƒ£	keycap, keycap: 1
2âƒ£	keycap, keycap: 2
3âƒ£	keycap, keycap: 3
4âƒ£	keycap, keycap: 4
5âƒ£	keycap, keycap: 5
6âƒ£	keycap, keycap: 6
7âƒ£	keycap, keycap: 7
8âƒ£	keycap, keycap: 8
9âƒ£	keycap, keycap: 9
ğŸ”Ÿ	keycap, keycap: 10
ğŸ†’	taqeffalt COOL
ğŸ†“	taqeffalt FREE
â„¹ï¸	talÉ£ut
ğŸ†”	taqeffalt ID
ğŸŸ£	tawinest tademdamt
ğŸŸ¥	amkuáº“ azeggaÉ£
ğŸŸ§	amkuáº“ aÄÄinawi
ğŸŸ¨	amkuáº“ awreÉ£
ğŸŸ©	amkuáº“ azegzaw
ğŸŸ¦	amkuáº“ amidadi
ğŸŸª	amkuáº“ ademdam
ğŸŸ«	amkuáº“ aqehwi
â¬›ï¸	amkuáº“ aberkan ameqqran
â¬œï¸	amkuáº“ amellal ameqqran
ğŸ	anay s texxamin
ğŸš©	anay azeggaÉ£
ğŸŒ	anayen ijapuniyen
ğŸ´	anay aberkan
ğŸ³ï¸	anay amellal
ğŸ³â€ğŸŒˆ	anay n teslit n unáº“ar
ğŸ³â€âš§	anay n urgaz meá¹­á¹­u
ğŸ´â€â˜ 	anay n yiflisen
ğŸ‡¦ğŸ‡¨	anay, anay: Tigzirt n Aá¹£unsyun
ğŸ‡¦ğŸ‡©	anay, anay: Undura
ğŸ‡¦ğŸ‡ª	anay, anay: Tigeldunin Yedduklen TaÉ›rabin
ğŸ‡¦ğŸ‡«	anay, anay: AfÉ£anistan
ğŸ‡¦ğŸ‡¬	anay, anay: Untiga d Barbuda
ğŸ‡¦ğŸ‡®	anay, anay: Ungiya
ğŸ‡¦ğŸ‡±	anay, anay: Lalbani
ğŸ‡¦ğŸ‡²	anay, anay: Arminya
ğŸ‡¦ğŸ‡´	anay, anay: Ungula
ğŸ‡¦ğŸ‡¶	anay, anay: Aná¹­arktik
ğŸ‡¦ğŸ‡·	anay, anay: Arjuntin
ğŸ‡¦ğŸ‡¸	anay, anay: Samwa Tamarikanit
ğŸ‡¦ğŸ‡¹	anay, anay: Ustriya
ğŸ‡¦ğŸ‡º	anay, anay: Ustrali
ğŸ‡¦ğŸ‡¼	anay, anay: Aruba
ğŸ‡¦ğŸ‡½	anay, anay: Tigzirin n Aland
ğŸ‡¦ğŸ‡¿	anay, anay: Azrabijan
ğŸ‡§ğŸ‡¦	anay, anay: Busna d Hersek
ğŸ‡§ğŸ‡§	anay, anay: Barbadus
ğŸ‡§ğŸ‡©	anay, anay: Bangladac
ğŸ‡§ğŸ‡ª	anay, anay: BelÇ§ik
ğŸ‡§ğŸ‡«	anay, anay: Burkina Fasu
ğŸ‡§ğŸ‡¬	anay, anay: Bulgari
ğŸ‡§ğŸ‡­	anay, anay: Baá¸¥rin
ğŸ‡§ğŸ‡®	anay, anay: Burandi
ğŸ‡§ğŸ‡¯	anay, anay: Binin
ğŸ‡§ğŸ‡±	anay, anay: Sant Baá¹›tilimi
ğŸ‡§ğŸ‡²	anay, anay: Bermuda
ğŸ‡§ğŸ‡³	anay, anay: Bruney
ğŸ‡§ğŸ‡´	anay, anay: Bulivi
ğŸ‡§ğŸ‡¶	anay, anay: Huland n Kaá¹›ayib
ğŸ‡§ğŸ‡·	anay, anay: Brizil
ğŸ‡§ğŸ‡¸	anay, anay: Bahamas
ğŸ‡§ğŸ‡¹	anay, anay: Bhutan
ğŸ‡§ğŸ‡»	anay, anay: Tigzirin n Buvet
ğŸ‡§ğŸ‡¼	anay, anay: Bustwana
ğŸ‡§ğŸ‡¾	anay, anay: Bilarus
ğŸ‡§ğŸ‡¿	anay, anay: Biliz
ğŸ‡¨ğŸ‡¦	anay, anay: Kanada
ğŸ‡¨ğŸ‡¨	anay, anay: Tigzirin n Kukus
ğŸ‡¨ğŸ‡©	anay, anay: Tigduda Tagdudant n Kungu
ğŸ‡¨ğŸ‡«	anay, anay: Tigduda n Tefriqt Talemmast
ğŸ‡¨ğŸ‡¬	anay, anay: Kungu
ğŸ‡¨ğŸ‡­	anay, anay: Swis
ğŸ‡¨ğŸ‡®	anay, anay: Kuá¹­ Divwar
ğŸ‡¨ğŸ‡°	anay, anay: Tigzirin n Kuk
ğŸ‡¨ğŸ‡±	anay, anay: Cili
ğŸ‡¨ğŸ‡²	anay, anay: Kamirun
ğŸ‡¨ğŸ‡³	anay, anay: Lacin
ğŸ‡¨ğŸ‡´	anay, anay: Kulumbi
ğŸ‡¨ğŸ‡µ	anay, anay: Tigzirt n Klipirá¹­un
ğŸ‡¨ğŸ‡·	anay, anay: Kusta Rika
ğŸ‡¨ğŸ‡º	anay, anay: Kuba
ğŸ‡¨ğŸ‡»	anay, anay: Tigzirin n yixef azegzaw
ğŸ‡¨ğŸ‡¼	anay, anay: Kurasaw
ğŸ‡¨ğŸ‡½	anay, anay: Tigzrin n Kristmaá¹£
ğŸ‡¨ğŸ‡¾	anay, anay: Cipr
ğŸ‡¨ğŸ‡¿	anay, anay: ÄŒÄek
ğŸ‡©ğŸ‡ª	anay, anay: Lalman
ğŸ‡©ğŸ‡¬	anay, anay: Dyigu Garsiya
ğŸ‡©ğŸ‡¯	anay, anay: Ç¦ibuti
ğŸ‡©ğŸ‡°	anay, anay: Denmark
ğŸ‡©ğŸ‡²	anay, anay: Duminik
ğŸ‡©ğŸ‡´	anay, anay: Tigduda Taduminikit
ğŸ‡©ğŸ‡¿	anay, anay: Lezzayer
ğŸ‡ªğŸ‡¦	anay, anay: Sebta d Melilla
ğŸ‡ªğŸ‡¨	anay, anay: Ikwaá¹­ur
ğŸ‡ªğŸ‡ª	anay, anay: Istunya
ğŸ‡ªğŸ‡¬	anay, anay: Maá¹£r
ğŸ‡ªğŸ‡­	anay, anay: Seá¸¥ra n umalu
ğŸ‡ªğŸ‡·	anay, anay: Iritiria
ğŸ‡ªğŸ‡¸	anay, anay: Spanya
ğŸ‡ªğŸ‡¹	anay, anay: Utyupi
ğŸ‡ªğŸ‡º	anay, anay: Tiddukla n Turuft
ğŸ‡«ğŸ‡®	anay, anay: Finlund
ğŸ‡«ğŸ‡¯	anay, anay: Fiji
ğŸ‡«ğŸ‡°	anay, anay: Tigzirin n Falkland
ğŸ‡«ğŸ‡²	anay, anay: Mikrunizya
ğŸ‡«ğŸ‡´	anay, anay: Tigzirin n Faá¹›wi
ğŸ‡«ğŸ‡·	anay, anay: Fransa
ğŸ‡¬ğŸ‡¦	anay, anay: Gabun
ğŸ‡¬ğŸ‡§	anay, anay: Tagelda Yedduklen
ğŸ‡¬ğŸ‡©	anay, anay: Grunad
ğŸ‡¬ğŸ‡ª	anay, anay: Jiyurji
ğŸ‡¬ğŸ‡«	anay, anay: Æ”ana tafransist
ğŸ‡¬ğŸ‡¬	anay, anay: Girnizi
ğŸ‡¬ğŸ‡­	anay, anay: Æ”ana
ğŸ‡¬ğŸ‡®	anay, anay: Jibraltar
ğŸ‡¬ğŸ‡±	anay, anay: Grunland
ğŸ‡¬ğŸ‡²	anay, anay: Gambya
ğŸ‡¬ğŸ‡³	anay, anay: Æ”inya
ğŸ‡¬ğŸ‡µ	anay, anay: Gwadalupi
ğŸ‡¬ğŸ‡¶	anay, anay: Æ”inya Tasebgast
ğŸ‡¬ğŸ‡·	anay, anay: Lagris
ğŸ‡¬ğŸ‡¸	anay, anay: Tigzirin n Jyuá¹›jya n Unáº“ul akked SandwiÄ n Unáº“ul
ğŸ‡¬ğŸ‡¹	anay, anay: Gwatimala
ğŸ‡¬ğŸ‡º	anay, anay: Gwam
ğŸ‡¬ğŸ‡¼	anay, anay: Æ”inya-Bisaw
ğŸ‡¬ğŸ‡¾	anay, anay: Guwana
ğŸ‡­ğŸ‡°	anay, anay: Tamnaá¹­ Taqbuá¹›t Tacinwat n Hung Kung
ğŸ‡­ğŸ‡²	anay, anay: Tigzirin n Hird d Makdunalt
ğŸ‡­ğŸ‡³	anay, anay: Hunduras
ğŸ‡­ğŸ‡·	anay, anay: Kerwasya
ğŸ‡­ğŸ‡¹	anay, anay: Hayti
ğŸ‡­ğŸ‡º	anay, anay: Hungri
ğŸ‡®ğŸ‡¨	anay, anay: Tigzirin Tikanaá¹›iyin
ğŸ‡®ğŸ‡©	anay, anay: Indunizi
ğŸ‡®ğŸ‡ª	anay, anay: Lirlund
ğŸ‡®ğŸ‡±	anay, anay: Izrayil
ğŸ‡®ğŸ‡²	anay, anay: Tigzirt n Man
ğŸ‡®ğŸ‡³	anay, anay: Lhend
ğŸ‡®ğŸ‡´	anay, anay: Akal Aglizi deg Ugaraw Ahendi
ğŸ‡®ğŸ‡¶	anay, anay: LÉ›iraq
ğŸ‡®ğŸ‡·	anay, anay: Iran
ğŸ‡®ğŸ‡¸	anay, anay: Island
ğŸ‡®ğŸ‡¹	anay, anay: á¹¬elyan
ğŸ‡¯ğŸ‡ª	anay, anay: Jirzi
ğŸ‡¯ğŸ‡²	anay, anay: Jamyika
ğŸ‡¯ğŸ‡´	anay, anay: Lajurdani
ğŸ‡¯ğŸ‡µ	anay, anay: Jappu
ğŸ‡°ğŸ‡ª	anay, anay: Kinya
ğŸ‡°ğŸ‡¬	anay, anay: Kirigistan
ğŸ‡°ğŸ‡­	anay, anay: Cambudya
ğŸ‡°ğŸ‡®	anay, anay: Kiribati
ğŸ‡°ğŸ‡²	anay, anay: Kumur
ğŸ‡°ğŸ‡³	anay, anay: San Kits d Nivis
ğŸ‡°ğŸ‡µ	anay, anay: Kurya, Ufella
ğŸ‡°ğŸ‡·	anay, anay: Kurya, Wadda
ğŸ‡°ğŸ‡¼	anay, anay: Kuwayt
ğŸ‡°ğŸ‡¾	anay, anay: Tigzirin n Kamyan
ğŸ‡°ğŸ‡¿	anay, anay: Kazaxistan
ğŸ‡±ğŸ‡¦	anay, anay: Laws
ğŸ‡±ğŸ‡§	anay, anay: Lubnan
ğŸ‡±ğŸ‡¨	anay, anay: San LuÄya
ğŸ‡±ğŸ‡®	anay, anay: Layctenstan
ğŸ‡±ğŸ‡°	anay, anay: Sri Lanka
ğŸ‡±ğŸ‡·	anay, anay: Libirya
ğŸ‡±ğŸ‡¸	anay, anay: Lizuá¹­u
ğŸ‡±ğŸ‡¹	anay, anay: Liá¹­wanya
ğŸ‡±ğŸ‡º	anay, anay: Luksamburg
ğŸ‡±ğŸ‡»	anay, anay: Latvia
ğŸ‡±ğŸ‡¾	anay, anay: Libya
ğŸ‡²ğŸ‡¦	anay, anay: Lmerruk
ğŸ‡²ğŸ‡¨	anay, anay: Munaku
ğŸ‡²ğŸ‡©	anay, anay: Muldabi
ğŸ‡²ğŸ‡ª	anay, anay: Muntinigru
ğŸ‡²ğŸ‡«	anay, anay: San Maá¹›tan
ğŸ‡²ğŸ‡¬	anay, anay: MadaÉ£ecqer
ğŸ‡²ğŸ‡­	anay, anay: Tigzirin n Marcal
ğŸ‡²ğŸ‡°	anay, anay: Masidunya n ugafa
ğŸ‡²ğŸ‡±	anay, anay: Mali
ğŸ‡²ğŸ‡²	anay, anay: Myanmar
ğŸ‡²ğŸ‡³	anay, anay: Mungulya
ğŸ‡²ğŸ‡´	anay, anay: Tamnaá¸t tudbilt tuzzigt tacinwat n Makaw
ğŸ‡²ğŸ‡µ	anay, anay: Tigzirin n Maryan Ufella
ğŸ‡²ğŸ‡¶	anay, anay: Martinik
ğŸ‡²ğŸ‡·	anay, anay: Muriá¹­anya
ğŸ‡²ğŸ‡¸	anay, anay: Munsirat
ğŸ‡²ğŸ‡¹	anay, anay: Malá¹­
ğŸ‡²ğŸ‡º	anay, anay: Muris
ğŸ‡²ğŸ‡»	anay, anay: Maldib
ğŸ‡²ğŸ‡¼	anay, anay: Malawi
ğŸ‡²ğŸ‡½	anay, anay: Meksik
ğŸ‡²ğŸ‡¾	anay, anay: Malizya
ğŸ‡²ğŸ‡¿	anay, anay: Muzembiq
ğŸ‡³ğŸ‡¦	anay, anay: Namibya
ğŸ‡³ğŸ‡¨	anay, anay: Kalidunya Tamaynut
ğŸ‡³ğŸ‡ª	anay, anay: Nijer
ğŸ‡³ğŸ‡«	anay, anay: Tigzirin Tinawfukin
ğŸ‡³ğŸ‡¬	anay, anay: Nijirya
ğŸ‡³ğŸ‡®	anay, anay: Nikaragwa
ğŸ‡³ğŸ‡±	anay, anay: Timura-Yessakesren
ğŸ‡³ğŸ‡´	anay, anay: Nurvij
ğŸ‡³ğŸ‡µ	anay, anay: Nipal
ğŸ‡³ğŸ‡·	anay, anay: Nuru
ğŸ‡³ğŸ‡º	anay, anay: Niwi
ğŸ‡³ğŸ‡¿	anay, anay: Ziland Tamaynut
ğŸ‡´ğŸ‡²	anay, anay: Æuman
ğŸ‡µğŸ‡¦	anay, anay: Panam
ğŸ‡µğŸ‡ª	anay, anay: Piru
ğŸ‡µğŸ‡«	anay, anay: Pulunizi tafransist
ğŸ‡µğŸ‡¬	anay, anay: Æ”inya Tamaynut Tapaput
ğŸ‡µğŸ‡­	anay, anay: Filipin
ğŸ‡µğŸ‡°	anay, anay: Pakistan
ğŸ‡µğŸ‡±	anay, anay: Pulund
ğŸ‡µğŸ‡²	anay, anay: San Pyar d Miklun
ğŸ‡µğŸ‡³	anay, anay: Pitkarin
ğŸ‡µğŸ‡·	anay, anay: Purtu Riku
ğŸ‡µğŸ‡¸	anay, anay: Falisá¹­in d Æ”ezza
ğŸ‡µğŸ‡¹	anay, anay: Purtugal
ğŸ‡µğŸ‡¼	anay, anay: Palu
ğŸ‡µğŸ‡¾	anay, anay: Paragway
ğŸ‡¶ğŸ‡¦	anay, anay: Qaá¹­ar
ğŸ‡·ğŸ‡ª	anay, anay: Timlilit
ğŸ‡·ğŸ‡´	anay, anay: Rumani
ğŸ‡·ğŸ‡¸	anay, anay: á¹¢irbya
ğŸ‡·ğŸ‡º	anay, anay: Rrus
ğŸ‡·ğŸ‡¼	anay, anay: Ruwanda
ğŸ‡¸ğŸ‡¦	anay, anay: SuÉ›udiya TaÉ›rabt
ğŸ‡¸ğŸ‡§	anay, anay: Tigzirin n Sulumun
ğŸ‡¸ğŸ‡¨	anay, anay: Seycel
ğŸ‡¸ğŸ‡©	anay, anay: Sudan
ğŸ‡¸ğŸ‡ª	anay, anay: Swid
ğŸ‡¸ğŸ‡¬	anay, anay: Singafur
ğŸ‡¸ğŸ‡­	anay, anay: Sant Ilina
ğŸ‡¸ğŸ‡®	anay, anay: Sluvinya
ğŸ‡¸ğŸ‡¯	anay, anay: Svalvard d Jan Mayen
ğŸ‡¸ğŸ‡°	anay, anay: Sluvakya
ğŸ‡¸ğŸ‡±	anay, anay: Sira Lyun
ğŸ‡¸ğŸ‡²	anay, anay: San Marinu
ğŸ‡¸ğŸ‡³	anay, anay: Sinigal
ğŸ‡¸ğŸ‡´	anay, anay: á¹¢umal
ğŸ‡¸ğŸ‡·	anay, anay: Surinam
ğŸ‡¸ğŸ‡¸	anay, anay: Sudan n unáº“ul
ğŸ‡¸ğŸ‡¹	anay, anay: Saw Tumi d Pransip
ğŸ‡¸ğŸ‡»	anay, anay: Salvadur
ğŸ‡¸ğŸ‡¾	anay, anay: Surya
ğŸ‡¸ğŸ‡¿	anay, anay: Swazilund
ğŸ‡¹ğŸ‡¦	anay, anay: Tristan da Kunha
ğŸ‡¹ğŸ‡¨	anay, anay: á¹¬urk d Tegzirin n Kaykus
ğŸ‡¹ğŸ‡©	anay, anay: ÄŒad
ğŸ‡¹ğŸ‡«	anay, anay: Timura tifransisin n unáº“ul
ğŸ‡¹ğŸ‡¬	anay, anay: á¹¬ugu
ğŸ‡¹ğŸ‡­	anay, anay: á¹¬ayland
ğŸ‡¹ğŸ‡¯	anay, anay: Tajikistan
ğŸ‡¹ğŸ‡°	anay, anay: á¹¬uklu
ğŸ‡¹ğŸ‡±	anay, anay: Tumur Asamar
ğŸ‡¹ğŸ‡²	anay, anay: á¹¬urkmanistan
ğŸ‡¹ğŸ‡³	anay, anay: Tunes
ğŸ‡¹ğŸ‡´	anay, anay: á¹¬unga
ğŸ‡¹ğŸ‡·	anay, anay: á¹¬urk
ğŸ‡¹ğŸ‡¹	anay, anay: á¹¬rindad d á¹¬ubagu
ğŸ‡¹ğŸ‡»	anay, anay: á¹¬uvalu
ğŸ‡¹ğŸ‡¼	anay, anay: á¹¬aywan
ğŸ‡¹ğŸ‡¿	anay, anay: á¹¬anzanya
ğŸ‡ºğŸ‡¦	anay, anay: Ukran
ğŸ‡ºğŸ‡¬	anay, anay: UÉ£anda
ğŸ‡ºğŸ‡²	anay, anay: Tigzirin ibeÉ›den n Marikan
ğŸ‡ºğŸ‡³	anay, anay: Timura Idduklen
ğŸ‡ºğŸ‡¸	anay, anay: WDM
ğŸ‡ºğŸ‡¾	anay, anay: Urugway
ğŸ‡ºğŸ‡¿	anay, anay: Uzbaxistan
ğŸ‡»ğŸ‡¦	anay, anay: Awanek n Vatikan
ğŸ‡»ğŸ‡¨	anay, anay: San Vansu d Grunadin
ğŸ‡»ğŸ‡ª	anay, anay: Venzwila
ğŸ‡»ğŸ‡¬	anay, anay: Tigzirin Tiverjiniyin Tigliziyin
ğŸ‡»ğŸ‡®	anay, anay: W.D. Tigzirin n Virginya
ğŸ‡»ğŸ‡³	anay, anay: Vyeá¹­nam
ğŸ‡»ğŸ‡º	anay, anay: Vanwatu
ğŸ‡¼ğŸ‡«	anay, anay: Wallis d Futuna
ğŸ‡¼ğŸ‡¸	anay, anay: Samwa
ğŸ‡½ğŸ‡°	anay, anay: Kuá¹£uvu
ğŸ‡¾ğŸ‡ª	anay, anay: Lyamen
ğŸ‡¾ğŸ‡¹	anay, anay: Mayuá¹­
ğŸ‡¿ğŸ‡¦	anay, anay: Tafriqt Wadda
ğŸ‡¿ğŸ‡²	anay, anay: Zambya
ğŸ‡¿ğŸ‡¼	anay, anay: Zimbabwi
Â¤	Tadrimt tarussint neÉ£ tarameÉ£tut
Ö	Adram Armini
Ø‹	AfÉ£ani AfÉ£an
à§³	Ataka n Bangladec
à¸¿	Abaht n Tayland
áŸ›	Ariyil n Kambuj
â‚¡	Akulun n Kusta Rika
â‚¦	Anayra Anijiri
â‚§	Apisetas n Spanya
â‚ª	Acikil amaynut n Izrayil
â‚«	Adung n Vyitnam
â‚­	Akip n Laws
â‚®	Atugrik n Mungulya
â‚²	Agarani n Paragway
â‚´	Ahrivnya n Ukran
â‚µ	Asidi n Æ”ana
â‚¸	Atunj n Kazaxistan
â‚º	Apund n á¹¬urk
â‚¼	Amanat Aziri
â‚¾	Alari n Jyurjya
ğŸ»	taglimt taceÉ›lalt
ğŸ¼	tagwlimt taceÉ›lalt talemmast
ğŸ½	taglimt talemmast
ğŸ¾	taglimt tubrikt talemmast
ğŸ¿	taglimt tubrikt
