ЁЯП╗	р░Ър░░р▒Нр░ор░В, р░Ър░░р▒Нр░ор░В р░Яр▒Лр░ир▒Н - 1-2, р░Яр▒Лр░ир▒Н, р░▓р▒Зр░д р░Ър░░р▒Нр░ор░кр▒Б р░░р░Вр░Чр▒Б
ЁЯП╝	р░Ър░░р▒Нр░ор░В, р░Ър░░р▒Нр░ор░В р░Яр▒Лр░ир▒Н -3, р░Яр▒Лр░ир▒Н, р░ор░зр▒Нр░пр░╕р▒Нр░ер░Вр░Чр░╛ р░▓р▒Зр░д р░Ър░░р▒Нр░ор░кр▒Б р░░р░Вр░Чр▒Б
ЁЯП╜	р░Ър░░р▒Нр░ор░В, р░Ър░░р▒Нр░ор░В р░Яр▒Лр░ир▒Н - 4, р░Яр▒Лр░ир▒Н, р░ор░зр▒Нр░пр░╕р▒Нр░е р░Ър░░р▒Нр░ор░кр▒Б р░░р░Вр░Чр▒Б
ЁЯП╛	р░Ър░░р▒Нр░ор░В, р░Ър░░р▒Нр░ор░В р░Яр▒Лр░ир▒Н- 5, р░Яр▒Лр░ир▒Н, р░ор░зр▒Нр░пр░╕р▒Нр░ер░Вр░Чр░╛ р░ор▒Бр░жр▒Бр░░р▒Б р░Ър░░р▒Нр░ор░кр▒Б р░░р░Вр░Чр▒Б
ЁЯП┐	р░Ър░░р▒Нр░ор░В, р░Ър░░р▒Нр░ор░В р░Яр▒Лр░ир▒Н - 6, р░Яр▒Лр░ир▒Н, р░ор▒Бр░жр▒Бр░░р▒Б р░Ър░░р▒Нр░ор░кр▒Б р░░р░Вр░Чр▒Б
ЁЯША	р░ир░╡р▒Нр░╡р▒Б, р░кр░│р▒Нр░▓р▒Б, р░кр░│р▒Нр░▓р▒Б р░Ър▒Вр░кр░┐р░╕р▒Нр░др▒В р░ир░╡р▒Нр░╡р▒Бр░др▒Бр░ир▒Нр░и р░ор▒Бр░Цр░В, р░ор▒Бр░Цр░В
ЁЯШБ	р░ир░╡р▒Нр░╡р▒Б, р░кр░│р▒Нр░▓р▒Б р░мр░пр░Яр░Хр▒Б р░кр▒Жр░Яр▒Нр░Яр░┐ р░ир░╡р▒Нр░╡р▒Бр░др▒Бр░ир▒Нр░и р░ор▒Бр░Цр░В, р░кр░│р▒Нр░▓р▒Б р░мр░пр░Яр░┐р░Хр░┐ р░кр▒Жр░Яр▒Нр░Яр░┐ р░Йр░Вр░бр░Яр░В, р░ор▒Бр░Цр░В
ЁЯШВ	р░Жр░ир░Вр░жр░мр░╛р░╖р▒Нр░кр░╛р░▓р▒Б, р░Жр░ир░Вр░жр░нр░╛р░╖р▒Нр░кр░╛р░▓р░др▒Л р░Йр░ир▒Нр░и р░ор▒Бр░Цр░В, р░ор▒Бр░Цр░В
ЁЯдг	р░Хр░┐р░Вр░жр░кр░бр░┐, р░Хр░┐р░Вр░жр░кр░бр░┐ р░жр▒Кр░░р▒Нр░▓р▒Бр░др▒В р░ир░╡р▒Нр░╡р░бр░В, р░жр▒Кр░░р▒Нр░▓р░бр░В, р░ир░╡р▒Нр░╡р▒Б, р░ор▒Бр░Цр░В
ЁЯШГ	р░ир░╡р▒Нр░╡р▒Б, р░ир▒Лр░░р▒Б, р░ир▒Лр░░р▒Б р░др▒Жр░░р░┐р░Ър░┐ р░ир░╡р▒Нр░╡р▒Бр░др▒Бр░ир▒Нр░и р░ор▒Бр░Цр░В, р░кр▒Жр░жр▒Нр░ж р░Хр░│р▒Нр░▓р░др▒Л р░ир▒Лр░░р▒Б р░др▒Жр░░р░┐р░Ър░┐ р░ир░╡р▒Нр░╡р▒Бр░др▒Бр░ир▒Нр░и р░ор▒Бр░Цр░В, р░ор▒Бр░Цр░В
ЁЯШД	р░ир░╡р▒Нр░╡р▒Б, р░ир▒Лр░░р▒Б, р░ир▒Лр░░р▒Б р░др▒Жр░░р░┐р░Ър░┐ р░╕р░Вр░др▒Лр░╖р░Вр░др▒Л р░ир░╡р▒Нр░╡р▒Бр░др▒Бр░ир▒Нр░и р░ор▒Бр░Цр░В, р░ор▒Бр░Цр░В, р░╕р░Вр░др▒Лр░╖р░В
ЁЯШЕ	р░Ър▒Жр░ор░Я, р░Ър▒Жр░ор░Яр░др▒Л р░ир▒Лр░░р▒Б р░др▒Жр░░р░┐р░Ър░┐ р░ир░╡р▒Нр░╡р▒Бр░др▒Бр░ир▒Нр░и р░ор▒Бр░Цр░В, р░ир░╡р▒Нр░╡р▒Б, р░ир▒Лр░░р▒Б, р░ор▒Бр░Цр░В
ЁЯШЖ	р░Хр░│р▒Нр░▓р▒Б, р░Хр░│р▒Нр░▓р▒Б р░ор▒Вр░╕р░┐ р░ир▒Лр░░р▒Б р░др▒Жр░░р░┐р░Ър░┐ р░ир░╡р▒Нр░╡р▒Бр░др▒Бр░ир▒Нр░и р░ор▒Бр░Цр░В, р░ир░╡р▒Нр░╡р▒Б, р░ир▒Лр░░р▒Б, р░ор▒Бр░Цр░В
ЁЯШЙ	р░Хр░ир▒Нр░ир▒Б, р░Хр░ир▒Нр░ир▒Б р░Хр▒Кр░бр▒Бр░др▒Бр░ир▒Нр░и р░ор▒Бр░Цр░В, р░ор▒Бр░Цр░В
ЁЯШК	р░ир░╡р▒Нр░╡р▒Б, р░ор▒Бр░Цр░В, р░╕р░Вр░др▒Лр░В, р░╕р░Вр░др▒Лр░╖р░Вр░др▒Л р░ир░╡р▒Нр░╡р▒Бр░др▒Бр░ир▒Нр░и р░ор▒Бр░Цр░В
ЁЯШЛ	р░Жр░╣р░╛р░░р░В, р░ор▒Бр░Цр░В, р░░р▒Бр░Ър░┐, р░░р▒Бр░Ър░┐р░Хр░░р░ор▒Ир░и р░Жр░╣р░╛р░░р░В р░др░┐р░ир▒Нр░и р░ор▒Бр░Цр░В
ЁЯШО	р░Хр░│р▒Нр░▓р░жр▒Нр░жр░╛р░▓р▒Б, р░Хр░│р▒Нр░▓р░жр▒Нр░жр░╛р░▓р▒Б р░кр▒Жр░Яр▒Нр░Яр▒Бр░Хр▒Бр░ир░┐ р░ир░╡р▒Нр░╡р▒Бр░др▒Бр░ир▒Нр░и р░ор▒Бр░Цр░В, р░Хр░│р▒Нр░▓р░жр▒Нр░жр░╛р░▓р▒Б р░кр▒Жр░Яр▒Нр░Яр▒Бр░Хр▒Бр░ир▒Нр░и р░ор▒Бр░Цр░В, р░ор▒Бр░Цр░В
ЁЯШН	р░кр▒Нр░░р▒Зр░о, р░кр▒Нр░░р▒Зр░ор░ир▒Б р░др▒Жр░▓р░┐р░кр▒З р░ор▒Бр░Цр░В, р░ор▒Бр░Цр░В
ЁЯШШ	р░ор▒Бр░Цр░В, р░ор▒Бр░жр▒Нр░жр▒Б, р░ор▒Бр░жр▒Нр░жр▒Бр░╡р░┐р░╕р▒Бр░░р▒Бр░др▒Бр░ир▒Нр░и р░ор▒Бр░Цр░В
ЁЯе░	3 р░╣р▒Гр░жр░пр░╛р░Хр░╛р░░р░╛р░▓р░др▒Л р░ир░╡р▒Нр░╡р▒Бр░др▒Бр░ир▒Нр░и р░ор▒Бр░Цр░В, р░Жр░░р░╛р░зр░┐р░Вр░Ър▒Б, р░Хр▒Нр░░р░╖р▒Н, р░кр▒Нр░░р▒Зр░о
ЁЯШЧ	р░ор▒Бр░Цр░В, р░ор▒Бр░жр▒Нр░жр▒Б, р░ор▒Бр░жр▒Нр░жр▒Б р░кр▒Жр░бр▒Бр░др▒Бр░ир▒Нр░и р░ор▒Бр░Цр░В
ЁЯШЩ	р░Хр░│р▒Нр░▓р▒Б, р░ир░╡р▒Нр░╡р▒Б р░ор▒Бр░жр▒Нр░жр▒Б, р░ир░╡р▒Нр░╡р▒Бр░др▒В р░ор▒Бр░жр▒Нр░жр▒Б р░кр▒Жр░бр▒Бр░др▒Бр░ир▒Нр░и р░ор▒Бр░Цр░В, р░ор▒Бр░Цр░В
ЁЯШЪ	р░Хр░│р▒Нр░▓р▒Б, р░Хр░│р▒Нр░▓р▒Б р░ор▒Вр░╕р░┐ р░ор▒Бр░жр▒Нр░жр▒Б р░кр▒Жр░бр▒Бр░др▒Бр░ир▒Нр░и р░ор▒Бр░Цр░В, р░ор▒Бр░Цр░В, р░ор▒Бр░жр▒Нр░жр▒Б
ЁЯЩВ	р░Ър░┐р░░р▒Бр░ир░╡р▒Нр░╡р▒Б р░ир░╡р▒Нр░╡р▒Бр░др▒Бр░ир▒Нр░и р░ор▒Бр░Цр░В, р░ир░╡р▒Нр░╡р▒Б, р░ор▒Бр░Цр░В
ЁЯдЧ	р░Хр▒Мр░Чр░┐р░▓р░┐, р░Хр▒Мр░Чр░┐р░▓р░┐р░Вр░Ър▒Бр░Хр▒Бр░ир▒Нр░и р░ор▒Бр░Цр░В, р░ор▒Бр░Цр░В
ЁЯдй	р░Хр░│р▒Нр░▓р▒Б, р░ир░Хр▒Нр░╖р░др▒Нр░░р░В, р░ор▒Бр░Ц р░Хр░╡р░│р░┐р░Х, р░ор▒Бр░Цр░В, р░╕р▒Нр░Яр░╛р░░р▒Н-р░╕р▒Нр░Яр▒Нр░░р░Хр▒Н
ЁЯдФ	р░Жр░▓р▒Лр░Ър░и, р░Жр░▓р▒Лр░Ър░┐р░╕р▒Нр░др▒Бр░ир▒Нр░и р░ор▒Бр░Цр░В, р░ор▒Бр░Цр░В
ЁЯди	р░Ер░кр░ир░ор▒Нр░ор░Хр░В, р░Хр░ир▒Бр░░р▒Жр░кр▒Нр░кр░▓р▒Б р░кр▒Ир░Хр░┐ р░Ор░др▒Нр░др░┐р░и р░ор▒Бр░Цр░В, р░╕р░Вр░жр▒Зр░╣р░┐
ЁЯШС	р░нр░╛р░╡р░В, р░нр░╛р░╡р░░р░╣р░┐р░д р░ор▒Бр░Цр░В, р░ор▒Бр░Цр░В
ЁЯШ╢	р░ир░┐р░╢р▒Нр░╢р░мр▒Нр░жр░В, р░ир░┐р░╢р▒Нр░╢р░мр▒Нр░жр░╛р░ир▒Нр░ир░┐ р░╕р▒Вр░Ър░┐р░Вр░Ър▒З р░ор▒Бр░Цр░В, р░ор▒Бр░Цр░В
ЁЯЩД	р░Хр░│р▒Нр░▓р▒Б, р░Хр░│р▒Нр░▓р▒Б р░др░┐р░кр▒Нр░кр▒Бр░др▒Бр░ир▒Нр░и р░ор▒Бр░Цр░В, р░ор▒Бр░Цр░В
ЁЯШП	р░ир░╡р▒Нр░╡р▒Б, р░ор▒Бр░Цр░В, р░╡р░┐р░Хр░╛р░░р░В, р░╡р░┐р░Хр░╛р░░р░Вр░Чр░╛ р░ир░╡р▒Нр░╡р▒Бр░др▒Бр░ир▒Нр░и р░ор▒Бр░Цр░В
ЁЯШг	р░Ер░╕р░╣р░╛р░пр░д, р░Ер░╕р░╣р░╛р░пр░д р░ор▒Бр░Цр░В, р░ор▒Бр░Цр░В
ЁЯШе	р░Йр░кр░╢р░ор░ир░В, р░ир░┐р░░р░╛р░╢, р░ир░┐р░░р░╛р░╢ р░Ър▒Жр░Вр░жр░┐р░ир░╛ р░Йр░кр░╢р░ор░┐р░╕р▒Нр░др▒Бр░ир▒Нр░и р░ор▒Бр░Цр░В, р░ор▒Бр░Цр░В
ЁЯШо	р░Жр░╢р▒Нр░Ър░░р▒Нр░пр░В, р░ир▒Лр░░р▒Б, р░ир▒Лр░░р▒Б р░др▒Жр░░р░┐р░Ър░┐ р░Йр░ир▒Нр░и р░ор▒Бр░Цр░В, р░ор▒Бр░Цр░В
ЁЯдР	р░ир▒Лр░░р▒Б, р░ир▒Лр░░р▒Б р░Хр░Яр▒Нр░Яр░┐ р░╡р▒Зр░╕р░┐р░и р░ор▒Бр░Цр░В, р░ор▒Бр░Цр░В
ЁЯШп	р░Жр░╢р▒Нр░Ър░░р▒Нр░пр░В, р░ир░┐р░╢р▒Нр░╢р░мр▒Нр░жр░В, р░ир░┐р░╢р▒Нр░╢р░мр▒Нр░жр░Вр░Чр░╛ р░Ър▒Вр░╕р▒Нр░др▒Бр░ир▒Нр░и р░ор▒Бр░Цр░В, р░ор▒Бр░Цр░В
ЁЯШк	р░ир░┐р░жр▒Нр░░, р░ир░┐р░жр▒Нр░░ р░Жр░╡р░╣р░┐р░Вр░Ър░┐р░и р░ор▒Бр░Цр░В, р░ор▒Бр░Цр░В
ЁЯШл	р░Ер░▓р░╕р░Я, р░Ер░▓р░┐р░╕р░┐р░кр▒Лр░пр░┐р░и р░ор▒Бр░Цр░В, р░ор▒Бр░Цр░В
ЁЯШ┤	р░ир░┐р░жр▒Нр░░, р░ир░┐р░жр▒Нр░░р░кр▒Лр░др▒Бр░ир▒Нр░и р░ор▒Бр░Цр░В, р░ор▒Бр░Цр░В
ЁЯШМ	р░Йр░кр░╢р░ор░ир░В, р░Йр░кр░╢р░ор░ир░В р░кр▒Кр░Вр░жр░┐р░и р░ор▒Бр░Цр░В, р░ор▒Бр░Цр░В
ЁЯШЫ	р░ир░╡р▒Нр░╡р▒Б, р░ир░╛р░▓р▒Бр░Х, р░ир░╛р░▓р▒Бр░Х р░мр░пр░Яр░кр▒Жр░Яр▒Нр░Яр░┐ р░ир░╡р▒Нр░╡р▒Бр░др▒Бр░ир▒Нр░и р░ор▒Бр░Цр░В, р░ор▒Бр░Цр░В
ЁЯШЬ	р░Хр░ир▒Нр░ир▒Б, р░ир░╡р▒Нр░╡р▒Б, р░ир░╛р░▓р▒Бр░Х, р░ир░╛р░▓р▒Бр░Х р░мр░пр░Яр░кр▒Жр░Яр▒Нр░Яр░┐ р░Хр░ир▒Нр░ир▒Б р░Хр▒Кр░бр▒Бр░др▒В р░ир░╡р▒Нр░╡р▒Бр░др▒Бр░ир▒Нр░и р░ор▒Бр░Цр░В, р░ор▒Бр░Цр░В
ЁЯШЭ	р░Хр░│р▒Нр░▓р▒Б, р░ир░╡р▒Нр░╡р▒Б, р░ир░╛р░▓р▒Бр░Х, р░ир░╛р░▓р▒Бр░Х р░мр░пр░Яр░кр▒Жр░Яр▒Нр░Яр░┐ р░Хр░│р▒Нр░▓р▒Б р░ор▒Вр░╕р▒Бр░Хр▒Кр░ир░┐ р░ир░╡р▒Нр░╡р▒Бр░др▒Бр░ир▒Нр░и р░ор▒Бр░Цр░В, р░ор▒Бр░Цр░В
ЁЯдд	р░Ър▒Кр░Вр░Чр░Хр░╛р░░р░бр░В, р░Ър▒Кр░Вр░Чр░Хр░╛р░░р▒Бр░др▒Бр░ир▒Нр░и р░ор▒Бр░Цр░В, р░ор▒Бр░Цр░В
ЁЯШТ	р░Ер░╕р░Вр░др▒Гр░кр▒Нр░др░┐, р░Ер░╕р░Вр░др▒Гр░кр▒Нр░др░┐ р░ор▒Бр░Цр░В, р░ор▒Бр░Цр░В
ЁЯШУ	р░Ер░▓р░╕р░Я, р░Ър▒Жр░ор░Я, р░Ър▒Жр░ор░Я р░кр░Яр▒Нр░Яр░┐р░и р░ор▒Бр░Цр░В, р░ор▒Бр░Цр░В
ЁЯШФ	р░Ър░┐р░Вр░д, р░Ър░┐р░Вр░др░┐р░╕р▒Нр░др▒Бр░ир▒Нр░и р░ор▒Бр░Цр░В, р░ор▒Бр░Цр░В
ЁЯШХ	р░Ер░░р▒Нр░ер░В, р░Чр░Вр░жр░░р░Чр▒Лр░│р░Вр░Чр░╛ р░Йр░ир▒Нр░и р░ор▒Бр░Цр░В, р░ор▒Бр░Цр░В
ЁЯЩГ	р░др░▓, р░др░▓р░Хр▒Нр░░р░┐р░Вр░жр▒Бр░▓р▒Бр░Чр░╛ р░Йр░ир▒Нр░и р░ор▒Бр░Цр░В, р░ор▒Бр░Цр░В
ЁЯдС	р░бр░мр▒Нр░мр▒Б, р░бр░мр▒Нр░мр▒Бр░др▒Л р░Хр░│р▒Нр░▓р▒Б, р░ир▒Лр░░р▒Б р░ор▒Вр░╕р▒Бр░Хр▒Бр░кр▒Лр░пр░┐р░и р░ор▒Бр░Цр░В, р░ир▒Лр░░р▒Б, р░ор▒Бр░Цр░В
ЁЯШ▓	р░Жр░╢р▒Нр░Ър░░р▒Нр░пр░В, р░Жр░╢р▒Нр░Ър░░р▒Нр░пр░Вр░др▒Л р░ир▒Лр░░р▒Б р░др▒Жр░░р░┐р░Ър░┐р░и р░ор▒Бр░Цр░В, р░ир▒Лр░░р▒Б, р░ор▒Бр░Цр░В
ЁЯЩБ	р░Хр▒Кр░Вр░Ър▒Ж р░Хр▒Лр░кр░В, р░Хр▒Кр░Вр░Ър▒Жр░В р░Хр▒Лр░кр░Вр░Чр░╛ р░Йр░ир▒Нр░и р░ор▒Бр░Цр░В, р░ор▒Бр░Цр░В
ЁЯШЦ	р░Ер░пр▒Лр░ор░пр░В, р░Ер░пр▒Лр░ор░пр░Вр░Чр░╛ р░Йр░ир▒Нр░и р░ор▒Бр░Цр░В, р░ор▒Бр░Цр░В
ЁЯШЮ	р░ир░┐р░░р░╛р░╢, р░ир░┐р░░р░╛р░╢ р░Ър▒Жр░Вр░жр░┐р░и р░ор▒Бр░Цр░В, р░ор▒Бр░Цр░В
ЁЯШЯ	р░жр░┐р░Чр▒Бр░▓р▒Б, р░жр░┐р░Чр▒Бр░▓р▒Бр░Чр░╛ р░Йр░ир▒Нр░и р░ор▒Бр░Цр░В, р░ор▒Бр░Цр░В
ЁЯШд	р░ир░┐р░Яр▒Нр░Яр▒Вр░░р▒Нр░Ър▒Бр░др▒Бр░ир▒Нр░и р░ор▒Бр░Цр░В, р░ир░┐р░Яр▒Нр░Яр▒Вр░░р▒Нр░кр▒Б, р░ор▒Бр░Цр░В
ЁЯШв	р░Пр░бр▒Бр░кр▒Б, р░Пр░бр▒Бр░╕р▒Нр░др▒Бр░ир▒Нр░и р░ор▒Бр░Цр░В, р░ор▒Бр░Цр░В
ЁЯШн	р░Пр░бр▒Бр░кр▒Б, р░Чр░Яр▒Нр░Яр░┐р░Чр░╛ р░Пр░бр▒Бр░╕р▒Нр░др▒Бр░ир▒Нр░и р░ор▒Бр░Цр░В, р░ор▒Бр░Цр░В
ЁЯШж	р░Хр▒Лр░кр░В, р░ир▒Лр░░р▒Б, р░ир▒Лр░░р▒Б р░др▒Жр░░р░┐р░Ър░┐ р░Хр▒Лр░кр░Вр░Чр░╛ р░Йр░ир▒Нр░и р░ор▒Бр░Цр░В, р░ор▒Бр░Цр░В
ЁЯШз	р░ир░┐р░░р▒Бр░др▒Нр░╕р░╛р░╣р░В, р░нр░пр░В, р░ор▒Бр░Цр░В, р░╡р▒Зр░жр░ир░др▒Л р░Йр░ир▒Нр░и р░ор▒Бр░Цр░В
ЁЯШи	р░нр░пр░В, р░нр░пр░Вр░др▒Л р░Йр░ир▒Нр░и р░ор▒Бр░Цр░В, р░ор▒Бр░Цр░В
ЁЯШй	р░ир░┐р░жр▒Нр░░, р░ир░┐р░жр▒Нр░░р░▓р▒Зр░ир░┐ р░ор▒Бр░Цр░В, р░ор▒Бр░Цр░В
ЁЯдп	р░Жр░╢р▒Нр░Ър░░р▒Нр░пр░кр▒Лр░пр░╛р░░р▒Б, р░др░▓ р░нр░╛р░░р░В
ЁЯШм	р░Хр▒Лр░кр░В, р░Хр▒Лр░кр░Вр░др▒Л р░кр░│р▒Нр░▓р▒Б р░Хр▒Кр░░р▒Бр░Хр▒Бр░др▒Бр░ир▒Нр░и р░ор▒Бр░Цр░В, р░кр░│р▒Нр░▓р▒Б, р░ор▒Бр░Цр░В
ЁЯШ░	р░Ър▒Жр░ор░Я, р░ир▒Лр░░р▒Б, р░ир▒Лр░░р▒Б р░др▒Жр░░р░┐р░Ър░┐ р░нр░пр░Вр░др▒Л р░Ър▒Жр░ор░Яр░▓р▒Б р░кр░бр▒Бр░др▒Бр░ир▒Нр░и р░ор▒Бр░Цр░В, р░нр░пр░В, р░ор▒Бр░Цр░В
ЁЯШ▒	р░нр░пр░В, р░нр░пр░Вр░др▒Л р░Ер░░р▒Бр░╕р▒Нр░др▒Бр░ир▒Нр░и р░ор▒Бр░Цр░В, р░ор▒Бр░Цр░В
ЁЯе╡	р░Ър▒Жр░ор░Яр░▓р▒Б, р░Ьр▒Нр░╡р░░р░В, р░╡р░бр░жр▒Жр░мр▒Нр░м, р░╡р▒Зр░бр░┐, р░╡р▒Зр░бр░┐р░др▒Л р░Ор░░р▒Нр░░р░мр░бр░┐р░и р░ор▒Бр░Цр░В
ЁЯе╢	р░Рр░╕р░┐р░Хр░┐р░▓р▒НтАМр░▓р▒Б, р░Чр░бр▒Нр░бр░Хр░Яр▒Нр░Яр▒Бр░Хр▒Бр░кр▒Лр░╡р░бр░В, р░Ър░▓р░┐, р░Ър░▓р▒Нр░▓р░мр░бр░┐р░и р░ор▒Бр░Цр░В, р░ир▒Ар░▓р░┐р░░р░Вр░Чр▒Б р░ор▒Бр░Цр░В, р░лр▒Нр░░р░╛р░╕р▒Нр░Яр▒Н-р░мр▒Ир░Яр▒Н
ЁЯШ│	р░Хр░▓р░╡р░░р░В, р░Хр░▓р░╡р░░р░кр░╛р░Яр▒Бр░Чр░╛ р░Йр░ир▒Нр░и р░ор▒Бр░Цр░В, р░ор▒Бр░Цр░В
ЁЯдк	р░Хр░│р▒Нр░▓р▒Б, р░Ър░┐р░ир▒Нр░и, р░кр▒Жр░жр▒Нр░ж, р░╡р▒Жр░░р▒Нр░░р░┐ р░ор▒Бр░Цр░В
ЁЯШ╡	р░др░▓, р░др░▓ р░др░┐р░░р░┐р░Чр░┐р░ир░Яр▒Нр░▓р▒Б р░Йр░Вр░бр▒З р░ор▒Бр░Цр░В, р░ор▒Бр░Цр░В
ЁЯШб	р░Ор░Хр▒Нр░Хр▒Бр░╡ р░Хр▒Лр░кр░Вр░др▒Л р░Ър▒Вр░╕р▒Нр░др▒Бр░ир▒Нр░и р░ор▒Бр░Цр░В, р░Хр▒Лр░кр░В, р░ор▒Бр░Цр░В
ЁЯШа	р░Хр▒Лр░кр░В, р░Хр▒Лр░кр░Вр░др▒Л р░Ър▒Вр░╕р▒Нр░др▒Бр░ир▒Нр░и р░ор▒Бр░Цр░В, р░ор▒Бр░Цр░В
ЁЯдм	р░ир▒Лр░Яр░┐р░кр▒И р░Ър░┐р░╣р▒Нр░ир░╛р░▓р░др▒Л р░ор▒Бр░Цр░В, р░кр▒Нр░░р░ор░╛р░гр░В р░Ър▒Зр░пр░бр░В
ЁЯШ╖	р░Жр░╕р▒Бр░кр░др▒Нр░░р░┐, р░Жр░╕р▒Бр░кр░др▒Нр░░р▒Бр░▓р▒Нр░▓р▒Л р░зр░░р░┐р░Вр░Ър▒З р░ор░╛р░╕р▒Нр░Хр▒НтАМр░др▒Л р░Йр░ир▒Нр░и р░ор▒Бр░Цр░В, р░ор░╛р░╕р▒Нр░Хр▒Н, р░ор▒Бр░Цр░В
ЁЯдТ	р░ер░░р▒Нр░ор░╛р░ор▒Ар░Яр░░р▒НтАМр░др▒Л р░Йр░ир▒Нр░и р░ор▒Бр░Цр░В, р░зр░░р▒Нр░ор░╛р░ор▒Ар░Яр░░р▒Н, р░зр░░р▒Нр░ор░╛р░ор▒Ар░Яр░░р▒НтАМр░др▒Л р░Йр░ир▒Нр░и р░ор▒Бр░Цр░В, р░ор▒Бр░Цр░В
ЁЯдХ	р░Хр░Яр▒Нр░Яр▒Б, р░др░▓, р░др░▓р░Хр▒Б р░Хр░Яр▒Нр░Яр▒Бр░др▒Л р░Йр░ир▒Нр░и р░ор▒Бр░Цр░В, р░ор▒Бр░Цр░В
ЁЯдв	р░ир▒Ар░░р░╕р░В, р░ор▒Бр░Цр░В, р░╡р░╛р░Вр░др░┐, р░╡р░┐р░Хр░╛р░░р░кр▒Б р░ор▒Бр░Цр░В
ЁЯдо	р░Ер░ир░╛р░░р▒Лр░Чр▒Нр░пр░В, р░╡р░╛р░Вр░др░┐, р░╡р░╛р░Вр░др░┐ р░Ър▒Зр░╕р▒Бр░Хр▒Бр░Вр░Яр▒Бр░ир▒Нр░и р░ор▒Бр░Цр░В
ЁЯдз	р░Ър▒Ар░жр▒Бр░Я, р░др▒Бр░ор▒Нр░ор▒Б, р░др▒Бр░ор▒Нр░ор▒Бр░др▒Бр░ир▒Нр░и р░ор▒Бр░Цр░В, р░ор▒Бр░Цр░В
ЁЯШЗ	р░Хр░╛р░Вр░др░┐, р░др░▓, р░др░▓р░кр▒И р░Хр░╛р░Вр░др░┐ р░╡р░▓р░пр░Вр░др▒Л р░ир░╡р▒Нр░╡р▒Бр░др▒Бр░ир▒Нр░и р░ор▒Бр░Цр░В, р░ир░╡р▒Нр░╡р▒Б, р░ор▒Бр░Цр░В, р░╡р░▓р░пр░В
ЁЯда	р░Хр▒Мр░Чр░░р▒Нр░▓р▒Н, р░Хр▒Мр░мр░╛р░пр▒Н, р░Хр▒Мр░мр░╛р░пр▒Н р░Яр▒Лр░кр▒А р░ор▒Бр░Цр░В, р░Яр▒Лр░кр▒А, р░ор▒Бр░Цр░В
ЁЯе│	р░Яр▒Лр░кр▒А, р░кр░╛р░░р▒Нр░Яр▒А, р░кр░╛р░░р▒Нр░Яр▒Ар░▓р▒Л р░╡р▒Жр░▓р░┐р░Чр░┐р░кр▒Лр░др▒Бр░ир▒Нр░и р░ор▒Бр░Цр░В, р░╡р▒Зр░бр▒Бр░Хр░▓р▒Б, р░╣р░╛р░░р▒Нр░ир▒Н
ЁЯе┤	р░Хр░│р▒Нр░▓р▒Б р░др▒Зр░▓р▒Зр░пр░бр░В, р░др░╛р░Чр░┐р░и р░ор░др▒Нр░др▒Б, р░ир░┐р░╖р░╛, р░ир▒Лр░Яр▒Нр░▓р▒Л р░Ьр░▓р▒Нр░▓р▒Б р░Хр░╛р░░р░бр░В, р░ор░др▒Нр░др▒Б, р░ор░др▒Нр░др▒Бр░Чр░╛ р░Йр░ир▒Нр░и р░ор▒Бр░Цр░В
ЁЯе║	р░Ер░Вр░жр░ор▒Ир░и р░Хр░│р▒Нр░▓р▒Б, р░Ер░нр▒Нр░пр░░р▒Нр░ер░и, р░Ер░нр▒Нр░пр░░р▒Нр░ер░ир░Чр░╛ р░ор▒Бр░Цр░В р░кр▒Жр░Яр▒Нр░Яр░бр░В, р░Хр░░р▒Бр░г
ЁЯде	р░Ер░мр░жр▒Нр░зр░В, р░Ер░мр░жр▒Нр░зр░ор░╛р░бр▒Бр░др▒Бр░ир▒Нр░и р░ор▒Бр░Цр░В, р░кр▒Ар░Хр░┐р░пр▒Л, р░ор▒Бр░Цр░В
ЁЯдл	р░ир░┐р░╢р▒Нр░╢р░мр▒Нр░ж р░Ър░┐р░╣р▒Нр░ир░В, р░ир░┐р░╢р▒Нр░╢р░мр▒Нр░ж р░Ър░┐р░╣р▒Нр░ир░Вр░др▒Л р░ор▒Бр░Цр░В, р░ир░┐р░╢р▒Нр░╢р░мр▒Нр░жр░В
ЁЯдн	р░Ер░пр▒Нр░пр▒Л, р░Ър▒Зр░др░┐р░др▒Л р░ир▒Лр░░р▒Б р░ор▒Вр░╕р▒Бр░Хр▒Бр░ир▒Нр░и р░ор▒Бр░Цр░В
ЁЯзР	р░Ър░┐р░░р░Ър░┐р░░р░▓р░╛р░бр░Яр░В, р░ор░╛р░ир░┐р░Хр░▓р▒Н р░кр▒Жр░Яр▒Нр░Яр▒Бр░Хр▒Бр░ир▒Нр░и р░ор▒Бр░Цр░В
ЁЯдУ	р░др░╛р░ир▒З р░ир░╡р▒Нр░╡р▒Бр░Хр▒Бр░Вр░Яр▒Бр░ир▒Нр░и р░ор▒Бр░Цр░В, р░ир░╡р▒Нр░╡р▒Б, р░ор▒Бр░Цр░В
ЁЯШИ	р░Хр▒Кр░ор▒Нр░ор▒Б, р░Хр▒Кр░ор▒Нр░ор▒Бр░▓р░др▒Л р░ир░╡р▒Нр░╡р▒Бр░др▒Бр░ир▒Нр░и р░ор▒Бр░Цр░В, р░ир░╡р▒Нр░╡р▒Б, р░ор▒Бр░Цр░В
ЁЯС┐	р░Хр▒Кр░ор▒Нр░ор▒Бр░▓р░др▒Л р░Хр▒Лр░кр░Вр░Чр░╛ р░Ър▒Вр░╕р▒Нр░др▒Бр░ир▒Нр░и р░ор▒Бр░Цр░В, р░жр▒Жр░пр▒Нр░пр░В, р░мр░╛р░з, р░мр░╛р░зр░┐р░Вр░Ър▒З р░жр▒Жр░пр▒Нр░пр░В
ЁЯдб	р░Ьр▒Лр░Хр░░р▒Н, р░Ьр▒Лр░Хр░░р▒Н р░ор▒Бр░Цр░В, р░ор▒Бр░Цр░В
ЁЯС╣	р░Ьр░кр░ир▒Ар░╕р▒Н р░Ур░Чр▒Нр░░р▒З, р░нр░пр░Вр░Хр░░р░ор▒Ир░и р░ор▒Бр░Цр░В
ЁЯС║	р░Ьр░кр░ир▒Ар░╕р▒Н р░Чр▒Лр░мр▒Нр░▓р░┐р░ир▒Н, р░нр░пр░Вр░Хр░░р░ор▒Ир░и р░ор▒Бр░Цр░В
ЁЯТА	р░кр▒Бр░░р▒Нр░░р▒Ж
ЁЯС╗	р░жр░пр▒Нр░пр░В, р░нр▒Вр░др░В
ЁЯС╛	р░Чр▒Нр░░р░╣р░╛р░Вр░др░░ р░░р░╛р░Хр▒Нр░╖р░╕р▒Бр░бр▒Б, р░Чр▒Нр░░р░╣р░╛р░Вр░др░░р░В, р░░р░╛р░Хр▒Нр░╖р░╕р▒Бр░бр▒Б
ЁЯдЦ	р░ор▒Бр░Цр░В, р░░р▒Лр░мр▒Л, р░░р▒Лр░мр▒Л р░ор▒Бр░Цр░В
ЁЯТй	р░Хр▒Бр░кр▒Нр░к, р░кр▒Жр░Вр░Я р░Хр▒Бр░кр▒Нр░к, р░кр▒Жр░Вр░Яр░Хр▒Бр░кр▒Нр░к, р░кр▒Зр░б
ЁЯШ║	р░ир░╡р▒Нр░╡р▒Б, р░ир▒Лр░░р▒Б, р░ир▒Лр░░р▒Б р░др▒Жр░░р░┐р░Ър░┐ р░ир░╡р▒Нр░╡р▒Бр░др▒Бр░ир▒Нр░и р░кр░┐р░▓р▒Нр░▓р░┐ р░ор▒Бр░Цр░В, р░кр░┐р░▓р▒Нр░▓р░┐, р░ор▒Бр░Цр░В
ЁЯШ╕	р░ир░╡р▒Нр░╡р▒Б, р░кр░┐р░▓р▒Нр░▓р░┐, р░кр▒Жр░жр▒Нр░жр░Чр░╛ р░ир░╡р▒Нр░╡р▒Бр░др▒Бр░ир▒Нр░и р░кр░┐р░▓р▒Нр░▓р░┐ р░ор▒Бр░Цр░В, р░ор▒Бр░Цр░В
ЁЯШ╣	р░Жр░ир░Вр░жр░мр░╛р░╖р▒Нр░кр░╛р░▓р▒Б, р░Жр░ир░Вр░жр░мр░╛р░╖р▒Нр░кр░╛р░▓р▒Б р░Хр░╛р░░р▒Нр░Ър▒Бр░др▒Бр░ир▒Нр░и р░кр░┐р░▓р▒Нр░▓р░┐ р░ор▒Бр░Цр░В, р░Жр░ир░Вр░жр░нр░╛р░╖р▒Нр░кр░╛р░▓р▒Б р░Хр░╛р░░р▒Нр░Ър▒Бр░др▒Бр░ир▒Нр░и р░кр░┐р░▓р▒Нр░▓р░┐ р░ор▒Бр░Цр░В, р░кр░┐р░▓р▒Нр░▓р░┐, р░ор▒Бр░Цр░В
ЁЯШ╗	р░Хр░│р▒Нр░▓р▒Б, р░ир░╡р▒Нр░╡р▒Б, р░кр░┐р░▓р▒Нр░▓р░┐, р░ор▒Бр░Цр░В, р░╣р▒Гр░жр░пр░В, р░╣р▒Гр░жр░пр░╛р░Хр░╛р░░ р░Хр░│р▒Нр░▓р░др▒Л р░ир░╡р▒Нр░╡р▒Бр░др▒Бр░ир▒Нр░и р░кр░┐р░▓р▒Нр░▓р░┐ р░ор▒Бр░Цр░В
ЁЯШ╝	р░ир░╡р▒Нр░╡р▒Б, р░кр░┐р░▓р▒Нр░▓р░┐, р░ор▒Бр░Цр░В, р░╡р▒Жр░Яр░Хр░╛р░░р░Вр░Чр░╛ р░ир░╡р▒Нр░╡р▒З р░кр░┐р░▓р▒Нр░▓р░┐ р░ор▒Бр░Цр░В
ЁЯШ╜	р░Хр░│р▒Нр░▓р▒Б, р░Хр░│р▒Нр░▓р▒Б р░ор▒Вр░╕р▒Бр░Хр▒Кр░ир░┐ р░ор▒Бр░жр▒Нр░жр▒Бр░кр▒Жр░бр▒Бр░др▒Бр░ир▒Нр░и р░кр░┐р░▓р▒Нр░▓р░┐ р░ор▒Бр░Цр░В, р░кр░┐р░▓р▒Нр░▓р░┐, р░ор▒Бр░Цр░В, р░ор▒Бр░жр▒Нр░жр▒Б
ЁЯЩА	р░ир░┐р░жр▒Нр░░, р░ир░┐р░жр▒Нр░░р░▓р▒Зр░ир░┐ р░кр░┐р░▓р▒Нр░▓р░┐ р░ор▒Бр░Цр░В, р░кр░┐р░▓р▒Нр░▓р░┐, р░ор▒Бр░Цр░В
ЁЯШ┐	р░Пр░бр▒Бр░кр▒Б, р░Пр░бр▒Бр░╕р▒Нр░др▒Бр░ир▒Нр░и р░кр░┐р░▓р▒Нр░▓р░┐ р░ор▒Бр░Цр░В, р░кр░┐р░▓р▒Нр░▓р░┐, р░ор▒Бр░Цр░В
ЁЯШ╛	р░Хр▒Лр░кр░В, р░Хр▒Лр░кр░Вр░др▒Л р░Ър▒Вр░╕р▒Нр░др▒Бр░ир▒Нр░и р░кр░┐р░▓р▒Нр░▓р░┐ р░ор▒Бр░Цр░В, р░кр░┐р░▓р▒Нр░▓р░┐, р░ор▒Бр░Цр░В
ЁЯЩИ	р░Хр▒Лр░др░┐, р░Ър▒Жр░бр▒Б, р░Ър▒Жр░бр▒Б р░Ър▒Вр░бр░Хр▒Б р░Ер░ир░┐ р░╕р▒Вр░Ър░┐р░Вр░Ър▒З р░Хр▒Лр░др░┐
ЁЯЩЙ	р░Хр▒Лр░др░┐, р░Ър▒Жр░бр▒Б, р░Ър▒Жр░бр▒Б р░╡р░┐р░ир░Хр▒Б р░Ер░ир░┐ р░╕р▒Вр░Ър░┐р░Вр░Ър▒З р░Хр▒Лр░др░┐
ЁЯЩК	р░Хр▒Лр░др░┐, р░Ър▒Жр░бр▒Б, р░Ър▒Жр░бр▒Б р░ор░╛р░Яр▒Нр░▓р░╛р░бр░Хр▒Б р░Ер░ир░┐ р░╕р▒Вр░Ър░┐р░Вр░Ър▒З р░Хр▒Лр░др░┐
ЁЯС╢	р░мр░┐р░бр▒Нр░б
ЁЯзТ	р░пр▒Бр░╡, р░▓р░┐р░Вр░Чр░В-р░др░Яр░╕р▒Нр░ер░В, р░╢р░┐р░╢р▒Бр░╡р▒Б
ЁЯСж	р░Ер░мр▒Нр░мр░╛р░пр░┐, р░кр▒Бр░░р▒Бр░╖р▒Бр░бр▒Б
ЁЯСз	р░Ер░ор▒Нр░ор░╛р░пр░┐, р░╕р▒Нр░др▒Нр░░р▒А
ЁЯзС	р░▓р░┐р░Вр░Чр░В-р░др░Яр░╕р▒Нр░ер░В, р░╡р░пр▒Лр░Ьр░ир▒Бр░бр▒Б
ЁЯС▒	р░Ьр▒Бр░Яр▒Нр░Яр▒Б, р░░р░╛р░Чр░┐, р░░р░╛р░Чр░┐ р░░р░Вр░Чр▒Б р░Ьр▒Бр░Яр▒Нр░Яр▒Б р░Чр░▓ р░╡р▒Нр░пр░Хр▒Нр░др░┐, р░╡р▒Нр░пр░Хр▒Нр░др░┐
ЁЯСи	р░кр▒Бр░░р▒Бр░╖р▒Бр░бр▒Б, р░ор░Чр░╛р░бр▒Б
ЁЯС▒тАНтЩВ	р░др▒Жр░▓р▒Нр░▓р░ир░┐ р░Ьр▒Бр░Яр▒Нр░Яр▒Б, р░др▒Жр░▓р▒Нр░▓р░ир░┐ р░Ьр▒Бр░Яр▒Нр░Яр▒Б р░Чр░▓ р░кр▒Бр░░р▒Бр░╖р▒Бр░бр▒Б, р░кр▒Бр░░р▒Бр░╖р▒Бр░бр▒Б, р░ор░Чр░╛р░бр▒Б
ЁЯзФ	р░Чр░бр▒Нр░бр░В, р░Чр░бр▒Нр░бр░В р░Чр░▓ р░╡р▒Нр░пр░Хр▒Нр░др░┐
ЁЯСй	р░Жр░бр░жр░┐, р░ор░╣р░┐р░│, р░╕р▒Нр░др▒Нр░░р▒А
ЁЯС▒тАНтЩА	р░др▒Жр░▓р▒Нр░▓р░ир░┐ р░Ьр▒Бр░Яр▒Нр░Яр▒Б, р░др▒Жр░▓р▒Нр░▓р░ир░┐ р░Ьр▒Бр░Яр▒Нр░Яр▒Б р░Чр░▓ р░╕р▒Нр░др▒Нр░░р▒А, р░ор░╣р░┐р░│, р░╕р▒Нр░др▒Нр░░р▒А
ЁЯзУ	р░▓р░┐р░Вр░Чр░В-р░др░Яр░╕р▒Нр░е, р░╡р▒Гр░жр▒Нр░з, р░╡р▒Гр░жр▒Нр░зр▒Бр░▓р▒Б
ЁЯС┤	р░др░╛р░др░пр▒Нр░п, р░ор▒Бр░╕р░▓р░╛р░пр░и, р░ор▒Бр░╕р░▓р░┐ р░╡р▒Нр░пр░Хр▒Нр░др░┐
ЁЯС╡	р░мр░╛р░ор▒Нр░о, р░ор▒Бр░╕р░▓р░╛р░╡р░┐р░б, р░ор▒Бр░╕р░▓р░┐ р░╕р▒Нр░др▒Нр░░р▒А
ЁЯСитАНтЪХ	р░Жр░░р▒Лр░Чр▒Нр░п р░╕р░Вр░░р░Хр▒Нр░╖р░г, р░Ър░┐р░Хр░┐р░др▒Нр░╕р░Хр▒Бр░бр▒Б, р░ир░░р▒Нр░╕р▒Н, р░кр▒Бр░░р▒Бр░╖р▒Бр░бр▒Б, р░ор░Чр░╛р░бр▒Б, р░╡р▒Ир░жр▒Нр░пр▒Бр░бр▒Б
ЁЯСйтАНтЪХ	р░Жр░░р▒Лр░Чр▒Нр░п р░╕р░Вр░░р░Хр▒Нр░╖р░г, р░Ър░┐р░Хр░┐р░др▒Нр░╕р░Хр▒Бр░░р░╛р░▓р▒Б, р░ир░░р▒Нр░╕р▒Н, р░ор░╣р░┐р░│, р░╡р▒Ир░жр▒Нр░пр▒Бр░░р░╛р░▓р▒Б, р░╡р▒Ир▒Ир░жр▒Нр░пр▒Бр░░р░╛р░▓р▒Б, р░╕р▒Нр░др▒Нр░░р▒А
ЁЯСитАНЁЯОУ	р░кр░Яр▒Нр░Яр░нр░жр▒Нр░░р▒Бр░бр▒Б, р░кр▒Бр░░р▒Бр░╖р▒Бр░бр▒Б, р░ор░Чр░╛р░бр▒Б, р░╡р░┐р░жр▒Нр░пр░╛р░░р▒Нр░ер░┐
ЁЯСйтАНЁЯОУ	р░кр░Яр▒Нр░Яр░нр░жр▒Нр░░р▒Бр░░р░╛р░▓р▒Б, р░ор░╣р░┐р░│, р░╡р░┐р░жр▒Нр░пр░╛р░░р▒Нр░ер░┐р░ир░┐, р░╕р▒Нр░др▒Нр░░р▒А
ЁЯСитАНЁЯПл	р░кр▒Бр░░р▒Бр░╖р▒Бр░бр▒Б, р░кр▒Нр░░р▒Кр░лр▒Жр░╕р░░р▒Н, р░мр▒Лр░зр░Хр▒Бр░бр▒Б, р░ор░Чр░╛р░бр▒Б, р░╢р░┐р░Хр▒Нр░╖р░Хр▒Бр░бр▒Б
ЁЯСйтАНЁЯПл	р░кр▒Нр░░р▒Кр░лр▒Жр░╕р░░р▒Н, р░мр▒Лр░зр░Хр▒Бр░░р░╛р░▓р▒Б, р░ор░╣р░┐р░│, р░╢р░┐р░Хр▒Нр░╖р░Хр▒Бр░░р░╛р░▓р▒Б, р░╕р▒Нр░др▒Нр░░р▒А
ЁЯСитАНтЪЦ	р░ир▒Нр░пр░╛р░пр░В, р░кр▒Бр░░р▒Бр░╖р▒Бр░бр▒Б, р░ор░Ч р░ир▒Нр░пр░╛р░пр░ор▒Вр░░р▒Нр░др░┐, р░ор░Чр░╛р░бр▒Б, р░╕р▒Нр░Хр▒Зр░▓р▒Нр░╕р▒Н
ЁЯСйтАНтЪЦ	р░Жр░б р░ир▒Нр░пр░╛р░пр░ор▒Вр░░р▒Нр░др░┐, р░ир▒Нр░пр░╛р░пр░ор▒Вр░░р▒Нр░др░┐, р░ор░╣р░┐р░│, р░╕р▒Нр░Хр▒Зр░▓р▒Нр░╕р▒Н, р░╕р▒Нр░др▒Нр░░р▒А
ЁЯСитАНЁЯМ╛	р░др▒Лр░Яр░ор░╛р░▓р░┐, р░кр▒Бр░░р▒Бр░╖р▒Бр░бр▒Б, р░ор░Ч р░др▒Лр░Я р░ор░ир░┐р░╖р░┐, р░ор░Ч р░░р▒Ир░др▒Б, р░ор░Чр░╛р░бр▒Б, р░░р▒Ир░др▒Б
ЁЯСйтАНЁЯМ╛	р░Жр░б р░др▒Лр░Яр░ор░╛р░▓р░┐, р░Жр░б р░░р▒Ир░др▒Б, р░ор░Ч р░др▒Лр░Я р░ор░ир░┐р░╖р░┐, р░ор░╣р░┐р░│, р░░р▒Ир░др▒Б, р░╕р▒Нр░др▒Нр░░р▒А
ЁЯСитАНЁЯН│	р░кр▒Бр░░р▒Бр░╖р▒Бр░бр▒Б, р░ор░Ч р░╡р░Вр░Яр░╡р░╛р░бр▒Б, р░ор░Чр░╛р░бр▒Б, р░╡р░Вр░Яр░╡р░╛р░бр▒Б
ЁЯСйтАНЁЯН│	р░Жр░б р░╡р░Вр░Я р░ор░ир░┐р░╖р░┐, р░ор░╣р░┐р░│, р░╡р░Вр░Я р░ор░ир░┐р░╖р░┐, р░╡р░Вр░Яр░╛р░╡р░┐р░б, р░╕р▒Нр░др▒Нр░░р▒А
ЁЯСитАНЁЯФз	р░Ор░▓р░Хр▒Нр░Яр▒Нр░░р▒Ар░╖р░┐р░пр░ир▒Н, р░кр▒Бр░░р▒Бр░╖р▒Бр░бр▒Б, р░кр▒Нр░▓р░Вр░мр░░р▒Н, р░ор░Ч р░ор▒Жр░Хр░╛р░ир░┐р░Хр▒Н, р░ор░Чр░╛р░бр▒Б, р░ор▒Жр░Хр░╛р░ир░┐р░Хр▒Н, р░╡р▒Нр░пр░╛р░кр░╛р░░р░╡р▒Зр░др▒Нр░д
ЁЯСйтАНЁЯФз	р░Жр░б р░ор▒Жр░Хр░╛р░ир░┐р░Хр▒Н, р░Ор░▓р░Хр▒Нр░Яр▒Нр░░р▒Ар░╖р░┐р░пр░ир▒Н, р░кр▒Нр░▓р░Вр░мр░░р▒Н, р░ор░╣р░┐р░│, р░ор▒Жр░Хр░╛р░ир░┐р░Хр▒Н, р░╡р▒Нр░пр░╛р░кр░╛р░░р░╡р▒Зр░др▒Нр░д, р░╕р▒Нр░др▒Нр░░р▒А
ЁЯСитАНЁЯПн	р░Ер░╕р▒Жр░Вр░мр▒Нр░▓р▒А, р░Хр░░р▒Нр░ор░╛р░Чр░╛р░░р░В, р░Хр░╛р░░р▒Нр░ор░┐р░Хр▒Бр░бр▒Б, р░кр░░р░┐р░╢р▒Нр░░р░о, р░кр▒Бр░░р▒Бр░╖р▒Бр░бр▒Б, р░ор░Чр░╛р░бр▒Б
ЁЯСйтАНЁЯПн	р░Ер░╕р▒Жр░Вр░мр▒Нр░▓р▒А, р░Хр░░р▒Нр░ор░╛р░Чр░╛р░░р░В, р░Хр░╛р░░р▒Нр░ор░┐р░Хр▒Бр░░р░╛р░▓р▒Б, р░кр░░р░┐р░╢р▒Нр░░р░о, р░ор░╣р░┐р░│, р░╕р▒Нр░др▒Нр░░р▒А
ЁЯСитАНЁЯТ╝	р░Жр░░р▒Нр░Хр░┐р░Яр▒Жр░Хр▒Нр░Яр▒Н, р░Йр░жр▒Нр░пр▒Лр░Чр░╕р▒Нр░ер▒Бр░бр▒Б, р░Хр░╛р░░р▒Нр░пр░╛р░▓р░пр░В, р░ир░┐р░░р▒Нр░╡р░╛р░╣р░Хр▒Бр░бр▒Б, р░кр▒Бр░░р▒Бр░╖р▒Бр░бр▒Б, р░кр▒Нр░░р░нр▒Бр░др▒Нр░╡ р░Йр░жр▒Нр░пр▒Лр░Чр▒Бр░▓р▒Б, р░ор░Чр░╛р░бр▒Б, р░╡р▒Нр░пр░╛р░кр░╛р░░р░В
ЁЯСйтАНЁЯТ╝	р░Жр░░р▒Нр░Хр░┐р░Яр▒Жр░Хр▒Нр░Яр▒Н, р░Йр░жр▒Нр░пр▒Лр░Чр░╕р▒Нр░ер▒Бр░░р░╛р░▓р▒Б, р░Хр░╛р░░р▒Нр░пр░╛р░▓р░пр░В, р░ир░┐р░░р▒Нр░╡р░╛р░╣р░Хр▒Бр░░р░╛р░▓р▒Б, р░кр▒Нр░░р░нр▒Бр░др▒Нр░╡ р░Йр░жр▒Нр░пр▒Лр░Чр▒Бр░▓р▒Б, р░ор░╣р░┐р░│, р░╡р▒Нр░пр░╛р░кр░╛р░░р░В, р░╕р▒Нр░др▒Нр░░р▒А
ЁЯСитАНЁЯФм	р░Зр░Вр░Ьр░┐р░ир▒Ар░░р▒Н, р░Хр▒Жр░ор░┐р░╕р▒Нр░Яр▒Н, р░Чр░гр░┐р░д р░╢р░╛р░╕р▒Нр░др▒Нр░░р░Ьр▒Нр░Юр▒Бр░бр▒Б, р░кр▒Бр░░р▒Бр░╖р▒Бр░бр▒Б, р░мр░пр░╛р░▓р░Ьр░┐р░╕р▒Нр░Яр▒Н, р░нр▒Мр░др░┐р░Х р░╢р░╛р░╕р▒Нр░др▒Нр░░р░╡р▒Зр░др▒Нр░д, р░ор░Чр░╛р░бр▒Б, р░╢р░╛р░╕р▒Нр░др▒Нр░░р░Ьр▒Нр░Юр▒Бр░бр▒Б
ЁЯСйтАНЁЯФм	р░Зр░Вр░Ьр░┐р░ир▒Ар░░р▒Н, р░Хр▒Жр░ор░┐р░╕р▒Нр░Яр▒Н, р░Чр░гр░┐р░д р░╢р░╛р░╕р▒Нр░др▒Нр░░р░Ьр▒Нр░Юр▒Бр░░р░╛р░▓р▒Б, р░мр░пр░╛р░▓р░Ьр░┐р░╕р▒Нр░Яр▒Н, р░нр▒Мр░др░┐р░Х р░╢р░╛р░╕р▒Нр░др▒Нр░░р░╡р▒Зр░др▒Нр░д, р░ор░╣р░┐р░│, р░╢р░╛р░╕р▒Нр░др▒Нр░░р░Ьр▒Нр░Юр▒Бр░░р░╛р░▓р▒Б, р░╕р▒Нр░др▒Нр░░р▒А
ЁЯСитАНЁЯТ╗	р░Хр▒Лр░бр▒Жр░░р▒Н, р░бр▒Жр░╡р░▓р░кр░░р▒Н, р░кр░░р░┐р░╢р▒Лр░зр░Хр▒Бр░бр▒Б, р░кр▒Бр░░р▒Бр░╖р▒Бр░бр▒Б, р░ор░Чр░╛р░бр▒Б, р░╕р░╛р░Вр░Хр▒Зр░др░┐р░Х р░ир░┐р░кр▒Бр░гр▒Бр░бр▒Б, р░╕р░╛р░лр▒Нр░Яр▒НтАМр░╡р▒Зр░░р▒Н
ЁЯСйтАНЁЯТ╗	р░Хр▒Лр░бр▒Жр░░р▒Н, р░бр▒Жр░╡р░▓р░кр░░р▒Н, р░кр░░р░┐р░╢р▒Лр░зр░Хр▒Бр░░р░╛р░▓р▒Б, р░ор░╣р░┐р░│, р░╕р░╛р░Вр░Хр▒Зр░др░┐р░Х р░ир░┐р░кр▒Бр░гр▒Бр░░р░╛р░▓р▒Б, р░╕р░╛р░лр▒Нр░Яр▒НтАМр░╡р▒Зр░░р▒Н, р░╕р▒Нр░др▒Нр░░р▒А
ЁЯСитАНЁЯОд	р░Чр░╛р░пр░Хр▒Бр░бр▒Б, р░кр▒Бр░░р▒Бр░╖р▒Бр░бр▒Б, р░кр▒Нр░░р░ор▒Бр░Цр▒Бр░бр▒Б, р░ор░Чр░╛р░бр▒Б, р░░р░╛р░Хр▒Н, р░╡р░┐р░ир▒Лр░жр░╛р░ир▒Нр░ир░┐ р░кр░Вр░Ър▒З р░╡р▒Нр░пр░Хр▒Нр░др░┐
ЁЯСйтАНЁЯОд	р░Чр░╛р░пр░Хр▒Бр░бр▒Б, р░Чр░╛р░пр░Хр▒Бр░░р░╛р░▓р▒Б, р░кр▒Нр░░р░ор▒Бр░Цр▒Бр░бр▒Б, р░ор░╣р░┐р░│, р░░р░╛р░Хр▒Н, р░╡р░┐р░ир▒Лр░жр░╛р░ир▒Нр░ир░┐ р░кр░Вр░Ър▒З р░╡р▒Нр░пр░Хр▒Нр░др░┐, р░╕р▒Нр░др▒Нр░░р▒А
ЁЯСитАНЁЯОи	р░Хр░│р░╛р░Хр░╛р░░р▒Бр░бр▒Б, р░кр▒Бр░░р▒Бр░╖р▒Бр░бр▒Б, р░ор░Чр░╛р░бр▒Б, р░░р░Вр░Чр▒Бр░▓ р░кр░│р▒Нр░│р▒Жр░В
ЁЯСйтАНЁЯОи	р░Хр░│р░╛р░Хр░╛р░░р░┐р░гр░┐, р░ор░╣р░┐р░│, р░░р░Вр░Чр▒Бр░▓ р░кр░│р▒Нр░│р▒Жр░В, р░╕р▒Нр░др▒Нр░░р▒А
ЁЯСитАНтЬИ	р░кр▒Бр░░р▒Бр░╖р▒Бр░бр▒Б, р░кр▒Ир░▓р▒Жр░Яр▒Н, р░ор░Ч р░кр▒Ир░▓р▒Жр░Яр▒Н, р░ор░Чр░╛р░бр▒Б, р░╡р░┐р░ор░╛р░ир░В
ЁЯСйтАНтЬИ	р░Жр░б р░кр▒Ир░▓р▒Жр░Яр▒Н, р░кр▒Ир░▓р▒Жр░Яр▒Н, р░ор░╣р░┐р░│, р░╡р░┐р░ор░╛р░ир░В, р░╕р▒Нр░др▒Нр░░р▒А
ЁЯСитАНЁЯЪА	р░Ер░Вр░др░░р░┐р░Хр▒Нр░╖ р░пр░╛р░др▒Нр░░р░┐р░Хр▒Бр░бр▒Б, р░кр▒Бр░░р▒Бр░╖р▒Бр░бр▒Б, р░ор░Чр░╛р░бр▒Б, р░░р░╛р░Хр▒Жр░Яр▒Н, р░░р▒Лр░жр░╕р▒А
ЁЯСйтАНЁЯЪА	р░Ер░Вр░др░░р░┐р░Хр▒Нр░╖ р░пр░╛р░др▒Нр░░р░┐р░Хр▒Бр░░р░╛р░▓р▒Б, р░ор░╣р░┐р░│, р░░р░╛р░Хр▒Жр░Яр▒Н, р░░р▒Лр░жр░╕р▒А, р░╕р▒Нр░др▒Нр░░р▒А
ЁЯСитАНЁЯЪТ	р░Ер░Чр▒Нр░ир░┐ р░ор░╛р░кр░Х р░жр░│ р░ир░┐р░кр▒Бр░гр▒Бр░бр▒Б, р░Ер░Чр▒Нр░ир░┐ р░ор░╛р░кр░Х р░жр░│ р░╡р░╛р░╣р░ир░В, р░кр▒Бр░░р▒Бр░╖р▒Бр░бр▒Б, р░ор░Чр░╛р░бр▒Б
ЁЯСйтАНЁЯЪТ	р░Ер░Чр▒Нр░ир░┐ р░ор░╛р░кр░Х р░жр░│ р░ир░┐р░кр▒Бр░гр▒Бр░░р░╛р░▓р▒Б, р░Ер░Чр▒Нр░ир░┐ р░ор░╛р░кр░Х р░жр░│ р░╡р░╛р░╣р░ир░В, р░ор░╣р░┐р░│
ЁЯСо	р░Ер░зр░┐р░Хр░╛р░░р░┐, р░кр▒Лр░▓р▒Ар░╕р▒Б, р░кр▒Лр░▓р▒Ар░╕р▒Б р░Ер░зр░┐р░Хр░╛р░░р░┐
ЁЯСотАНтЩВ	р░Ер░зр░┐р░Хр░╛р░░р░┐, р░кр▒Бр░░р▒Бр░╖р▒Бр░бр▒Б, р░кр▒Лр░▓р▒Ар░╕р▒Б, р░ор░Ч р░кр▒Лр░▓р▒Ар░╕р▒Н р░Жр░лр▒Ар░╕р░░р▒Н, р░ор░Чр░╛р░бр▒Б, р░░р░Хр▒Нр░╖р░Х р░нр░Яр▒Бр░бр▒Б
ЁЯСотАНтЩА	р░Ер░зр░┐р░Хр░╛р░░р░┐р░гр░┐, р░Жр░б р░кр▒Лр░▓р▒Ар░╕р▒Н р░Жр░лр▒Ар░╕р░░р▒Н, р░кр▒Лр░▓р▒Ар░╕р▒Б, р░ор░╣р░┐р░│, р░░р░Хр▒Нр░╖р░Хр▒Бр░░р░╛р░▓р▒Б, р░╕р▒Нр░др▒Нр░░р▒А
ЁЯХ╡тАНтЩВ	р░Ер░кр░░р░╛р░з р░кр░░р░┐р░╢р▒Лр░зр░Хр▒Бр░бр▒Б, р░Чр▒Вр░вр░Ър░╛р░░р░┐, р░ир▒Зр░░ р░кр░░р░┐р░╢р▒Лр░зр░Хр▒Бр░бр▒Б, р░кр▒Бр░░р▒Бр░╖р▒Бр░бр▒Б, р░ор░Чр░╛р░бр▒Б
ЁЯХ╡тАНтЩА	р░Ер░кр░░р░╛р░з р░кр░░р░┐р░╢р▒Лр░зр░Хр▒Бр░░р░╛р░▓р▒Б, р░Чр▒Вр░вр░Ър░╛р░░р░┐р░гр░┐, р░ир▒Зр░░ р░кр░░р░┐р░╢р▒Лр░зр░Хр▒Бр░░р░╛р░▓р▒Б, р░ор░╣р░┐р░│, р░╕р▒Нр░др▒Нр░░р▒А
ЁЯТВ	р░Хр░╛р░кр░▓р░╛р░жр░╛р░░р▒Бр░бр▒Б, р░╕р▒Ир░ир░┐р░Хр▒Бр░бр▒Б
ЁЯТВтАНтЩВ	р░кр▒Бр░░р▒Бр░╖р▒Бр░бр▒Б, р░ор░Чр░╛р░бр▒Б, р░╕р░Вр░░р░Хр▒Нр░╖р░Хр▒Бр░бр▒Б
ЁЯТВтАНтЩА	р░ор░╣р░┐р░│, р░╕р░Вр░░р░Хр▒Нр░╖р░Хр▒Бр░бр▒Б, р░╕р░Вр░░р░Хр▒Нр░╖р░Хр▒Бр░░р░╛р░▓р▒Б, р░╕р▒Нр░др▒Нр░░р▒А
ЁЯС╖	р░Хр░╛р░░р▒Нр░ор░┐р░Хр▒Бр░бр▒Б, р░ир░┐р░░р▒Нр░ор░╛р░г р░Хр░╛р░░р▒Нр░ор░┐р░Хр▒Бр░бр▒Б, р░ир░┐р░░р▒Нр░ор░╛р░гр░В
ЁЯС╖тАНтЩВ	р░Хр░╛р░░р▒Нр░ор░┐р░Хр▒Бр░бр▒Б, р░ир░┐р░░р▒Нр░ор░╛р░гр░В, р░кр▒Бр░░р▒Бр░╖р▒Бр░бр▒Б, р░нр░╡р░и р░ир░┐р░░р▒Нр░ор░╛р░г р░Хр░╛р░░р▒Нр░ор░┐р░Хр▒Бр░бр▒Б, р░ор░Чр░╛р░бр▒Б
ЁЯС╖тАНтЩА	р░Хр░╛р░░р▒Нр░ор░┐р░Хр▒Бр░░р░╛р░▓р▒Б, р░ир░┐р░░р▒Нр░ор░╛р░гр░В, р░нр░╡р░и р░ир░┐р░░р▒Нр░ор░╛р░г р░Хр░╛р░░р▒Нр░ор░┐р░Хр▒Бр░░р░╛р░▓р▒Б, р░ор░╣р░┐р░│, р░╕р▒Нр░др▒Нр░░р▒А
ЁЯд┤	р░пр▒Бр░╡р░░р░╛р░Ьр▒Б, р░░р░╛р░Хр▒Бр░ор░╛р░░р▒Бр░бр▒Б
ЁЯС╕	р░Хр░▓р▒Нр░кр░┐р░д р░Хр░е, р░Хр░╛р░▓р▒Нр░кр░ир░┐р░Хр░В, р░пр▒Бр░╡р░░р░╛р░гр░┐
ЁЯС│	р░Яр░░р▒Нр░мр░ир▒Н, р░др░▓р░кр░╛р░Ч р░зр░░р░┐р░Вр░Ър░┐р░и р░╡р▒Нр░пр░Хр▒Нр░др░┐, р░╡р▒Нр░пр░Хр▒Нр░др░┐
ЁЯС│тАНтЩВ	р░др░▓р░кр░╛р░Ч, р░др░▓р░кр░╛р░Чр░др▒Л р░кр▒Бр░░р▒Бр░╖р▒Бр░бр▒Б, р░кр▒Бр░░р▒Бр░╖р▒Бр░бр▒Б, р░ор░Чр░╛р░бр▒Б
ЁЯС│тАНтЩА	р░др░▓р░кр░╛р░Ч, р░др░▓р░кр░╛р░Чр░др▒Л р░╕р▒Нр░др▒Нр░░р▒А, р░ор░╣р░┐р░│, р░╕р▒Нр░др▒Нр░░р▒А
ЁЯС▓	р░Чр▒Бр░╡р░╛ р░кр▒А, р░Чр▒Бр░╡р░╛ р░кр▒А р░ор░╛р░╡р▒Л р░зр░░р░┐р░Вр░Ър░┐р░и р░╡р▒Нр░пр░Хр▒Нр░др░┐, р░╡р▒Нр░пр░Хр▒Нр░др░┐
ЁЯзХ	р░Яр░┐р░Ър▒Жр░▓р▒Н, р░др░▓р░Хр▒Б р░Хр░Яр▒Нр░Яр▒Бр░Хр▒Бр░ир▒З р░╕р▒Нр░Хр░╛р░░р▒Нр░лр▒Н, р░др░▓р░Хр▒Б р░╕р▒Нр░Хр░╛р░░р▒Нр░лр▒Н р░Хр░Яр▒Нр░Яр▒Бр░Хр▒Бр░ир▒Нр░и р░ор░╣р░┐р░│, р░ор░Вр░Яр░┐р░▓р▒Нр░▓р░╛, р░╣р░┐р░Ьр░╛р░мр▒Н
ЁЯд╡	р░Яр░Хр▒Нр░╕р░┐р░бр▒Л, р░Яр░Хр▒Нр░╕р░┐р░бр▒Лр░▓р▒Л р░Йр░ир▒Нр░и р░кр▒Бр░░р▒Бр░╖р▒Бр░бр▒Б, р░кр▒Бр░░р▒Бр░╖р▒Бр░бр▒Б, р░╡р░░р▒Бр░бр▒Б
ЁЯС░	р░Хр▒Бр░ор░╛р░░р▒Нр░др▒Ж, р░кр▒Жр░│р▒Нр░▓р░┐, р░ор▒Бр░╕р▒Бр░Чр▒Б, р░ор▒Бр░╕р▒Бр░Чр▒Бр░др▒Л р░кр▒Жр░│р▒Нр░▓р░┐ р░Хр▒Бр░ор░╛р░░р▒Нр░др▒Ж
ЁЯд░	р░Чр░░р▒Нр░нр░┐р░гр░┐, р░Чр░░р▒Нр░нр░┐р░гр░┐ р░╕р▒Нр░др▒Нр░░р▒А, р░╕р▒Нр░др▒Нр░░р▒А
ЁЯд▒	р░Ър░ир▒Бр░мр░╛р░▓р▒Б р░Зр░╡р▒Нр░╡р░бр░В, р░Ър░ир▒Бр░мр░╛р░▓р▒Б р░кр░Яр▒Нр░Яр░бр░В, р░мр░┐р░бр▒Нр░б, р░░р▒Кр░ор▒Нр░ор▒Б
ЁЯС╝	р░жр▒Зр░╡р░д, р░мр░┐р░бр▒Нр░б, р░мр░┐р░бр▒Нр░б р░░р▒Вр░кр░Вр░▓р▒Л р░жр▒Зр░╡р░д
ЁЯОЕ	р░Хр▒Нр░░р░┐р░╕р▒Нр░ор░╕р▒Н, р░лр░╛р░жр░░р▒Н р░Хр▒Нр░░р░┐р░╕р▒Нр░ор░╕р▒Н, р░╡р▒Зр░бр▒Бр░Х, р░╢р░╛р░Вр░Яр░╛, р░╢р░╛р░Вр░Яр░╛ р░Хр▒Нр░▓р░╛р░╕р▒Н
ЁЯд╢	р░Хр▒Нр░░р░┐р░╕р▒Нр░ор░╕р▒Н, р░др░▓р▒Нр░▓р░┐, р░ор░┐р░╕р▒Жр░╕р▒Н р░Хр▒Нр░▓р░╛р░Ьр▒Н, р░╢р▒Нр░░р▒Ар░ор░др░┐ р░╢р░╛р░Вр░Яр░╛
ЁЯж╕	р░ор░Вр░Ър░┐, р░╕р▒Вр░кр░░р▒НтАМр░кр░╡р░░р▒Н, р░╕р▒Вр░кр░░р▒НтАМр░╣р▒Ар░░р▒Л, р░╣р▒Ар░░р▒Л, р░╣р▒Ар░░р▒Лр░пр░┐р░ир▒Н
ЁЯж╕тАНтЩА	р░Йр░ор▒Жр░ир▒Н р░╕р▒Вр░кр░░р▒НтАМр░╣р▒Ар░░р▒Л, р░ор░Вр░Ър░┐, р░ор▒Нр░пр░╛р░ир▒Н, р░╕р▒Вр░кр░░р▒НтАМр░кр░╡р░░р▒Н, р░╣р▒Ар░░р▒Л
ЁЯж╕тАНтЩВ	р░ор░Вр░Ър░┐, р░ор▒Жр░ир▒Н р░╕р▒Вр░кр░░р▒НтАМр░╣р▒Ар░░р▒Л, р░ор▒Нр░пр░╛р░ир▒Н, р░╕р▒Вр░кр░░р▒НтАМр░кр░╡р░░р▒Н, р░╣р▒Ар░░р▒Л
ЁЯж╣	р░Хр▒Нр░░р░┐р░ор░┐р░ир░▓р▒Н, р░Ър▒Жр░бр▒Б, р░╡р░┐р░▓р░ир▒Н, р░╕р▒Вр░кр░░р▒НтАМр░кр░╡р░░р▒Н, р░╕р▒Вр░кр░░р▒НтАМр░╡р░┐р░▓р░ир▒Н
ЁЯж╣тАНтЩА	р░Йр░ор▒Жр░ир▒Н, р░Йр░ор▒Жр░ир▒Н р░╕р▒Вр░кр░░р▒НтАМр░╡р░┐р░▓р░ир▒Н, р░Хр▒Нр░░р░┐р░ор░┐р░ир░▓р▒Н, р░Ър▒Жр░бр▒Б, р░╡р░┐р░▓р░ир▒Н, р░╕р▒Вр░кр░░р▒НтАМр░кр░╡р░░р▒Н
ЁЯж╣тАНтЩВ	р░Хр▒Нр░░р░┐р░ор░┐р░ир░▓р▒Н, р░Ър▒Жр░бр▒Б, р░ор▒Нр░пр░╛р░ир▒Н, р░ор▒Нр░пр░╛р░ир▒Н р░╕р▒Вр░кр░░р▒НтАМр░╡р░┐р░▓р░ир▒Н, р░╡р░┐р░▓р░ир▒Н, р░╕р▒Вр░кр░░р▒НтАМр░кр░╡р░░р▒Н
ЁЯзЩ	р░Зр░Вр░жр▒Нр░░р░Ьр░╛р░▓р░┐р░Хр▒Бр░бр▒Б, р░Зр░Вр░жр▒Нр░░р░Ьр░╛р░▓р░┐р░Хр▒Бр░░р░╛р░▓р▒Б, р░ор░Вр░др▒Нр░░р░Чр░др▒Нр░др▒Ж, р░ор░╛р░Вр░др▒Нр░░р░┐р░Хр▒Бр░бр▒Б
ЁЯзЩтАНтЩА	р░Зр░Вр░жр▒Нр░░р░Ьр░╛р░▓р░┐р░Хр▒Бр░░р░╛р░▓р▒Б, р░ор░Вр░др▒Нр░░р░Чр░др▒Нр░др▒Ж
ЁЯзЩтАНтЩВ	р░Зр░Вр░жр▒Нр░░р░Ьр░╛р░▓р░┐р░Хр▒Бр░бр▒Б, р░ор░Вр░др▒Нр░░р░Чр░╛р░бр▒Б, р░ор░╛р░Вр░др▒Нр░░р░┐р░Хр▒Бр░бр▒Б
ЁЯзЪ	р░Ур░мр▒Жр░░р░╛р░ир▒Н, р░Ьр░╛р░ир░кр░ж р░кр░╛р░др▒Нр░░, р░Яр░┐р░Яр░╛р░ир░┐р░пр░╛, р░кр░Хр▒Н
ЁЯзЪтАНтЩА	р░Ьр░╛р░ир░кр░ж р░╕р░╛р░╣р░и р░ор░Вр░др▒Нр░░р░Чр░др▒Нр░др▒Ж, р░Яр░┐р░Яр░╛р░ир░┐р░пр░╛
ЁЯзЪтАНтЩВ	р░Ур░мр▒Жр░░р░╛р░ир▒Н, р░Ьр░╛р░ир░кр░ж р░╕р░╛р░╣р░и р░ор░╛р░Вр░др▒Нр░░р░┐р░Хр▒Бр░бр▒Б, р░кр░Хр▒Н
ЁЯзЫ	р░бр▒Нр░░р░╛р░Хр▒Нр░пр▒Бр░▓р░╛, р░ор░░р░гр░В р░▓р▒Зр░ир░┐р░жр░┐, р░░р░Хр▒Нр░др░кр░┐р░кр░╛р░╕р░┐
ЁЯзЫтАНтЩА	р░Жр░б р░░р░Хр▒Нр░др░кр░┐р░кр░╛р░╕р░┐, р░ор░░р░гр░В р░▓р▒Зр░ир░┐р░жр░┐
ЁЯзЫтАНтЩВ	р░бр▒Нр░░р░╛р░Хр▒Нр░пр▒Бр░▓р░╛, р░ор░Ч р░░р░Хр▒Нр░др░кр░┐р░кр░╛р░╕р░┐, р░ор░░р░гр░В р░▓р▒Зр░ир░┐р░жр░┐
ЁЯзЬ	р░Ьр░▓ р░╡р▒Нр░пр░Хр▒Нр░др░┐, р░Ьр░▓р░Хр░ир▒Нр░п, р░Ьр░▓р░кр▒Бр░░р▒Бр░╖р▒Бр░бр▒Б, р░Ьр░▓р░╕р▒Нр░др▒Нр░░р▒А
ЁЯзЬтАНтЩА	р░Ьр░▓р░Хр░ир▒Нр░п, р░Ьр░▓р░╕р▒Нр░др▒Нр░░р▒А
ЁЯзЬтАНтЩВ	р░Ьр░▓р░кр▒Бр░░р▒Бр░╖р▒Бр░бр▒Б, р░Яр▒Нр░░р░┐р░Яр░ир▒Н
ЁЯзЭ	р░Ор░▓р▒Нр░лр▒Н, р░ор░╛р░Вр░др▒Нр░░р░┐р░Х
ЁЯзЭтАНтЩА	р░ор░╛р░Вр░др▒Нр░░р░┐р░Х, р░ор░╛р░Вр░др▒Нр░░р░┐р░Хр▒Бр░░р░╛р░▓р▒Б
ЁЯзЭтАНтЩВ	р░ор░╛р░Вр░др▒Нр░░р░┐р░Х, р░ор░╛р░Вр░др▒Нр░░р░┐р░Хр▒Бр░бр▒Б
ЁЯзЮ	р░Ьр░┐р░ир▒А, р░Ьр░┐р░ир▒Н
ЁЯзЮтАНтЩА	р░Ьр░┐р░ир▒Н, р░╕р▒Нр░др▒Нр░░р▒А р░Ьр░┐р░ир▒А
ЁЯзЮтАНтЩВ	р░Ьр░┐р░ир▒Н, р░кр▒Бр░░р▒Бр░╖ р░Ьр░┐р░ир▒А
ЁЯзЯ	р░Ьр░╛р░Вр░мр▒А, р░ир░бр░┐р░Ър▒З р░╢р░╡р░В, р░ор░░р░гр░В р░▓р▒Зр░ир░┐р░жр░┐
ЁЯзЯтАНтЩА	р░ир░бр░┐р░Ър▒З р░╢р░╡р░В, р░ор░░р░гр░В р░▓р▒Зр░ир░┐р░жр░┐, р░╕р▒Нр░др▒Нр░░р▒А р░Ьр░╛р░Вр░мр▒А
ЁЯзЯтАНтЩВ	р░ир░бр░┐р░Ър▒З р░╢р░╡р░В, р░кр▒Бр░░р▒Бр░╖ р░Ьр░╛р░Вр░мр▒А, р░ор░░р░гр░В р░▓р▒Зр░ир░┐р░╡р░┐
ЁЯЩН	р░Хр▒Лр░кр░В, р░Хр▒Лр░кр░Вр░др▒Л р░др░▓ р░жр░┐р░Вр░Ър▒Бр░Хр▒Бр░ир▒Нр░и р░╡р▒Нр░пр░Хр▒Нр░др░┐, р░др░▓, р░╡р▒Нр░пр░Хр▒Нр░др░┐
ЁЯЩНтАНтЩВ	р░кр▒Бр░░р▒Бр░╖р▒Бр░бр▒Б, р░ор░Чр░╛р░бр▒Б, р░ор▒Бр░Цр░В р░Ър░┐р░Яр▒Нр░▓р░┐р░Вр░Ър░бр░В, р░ор▒Бр░Цр░В р░Ър░┐р░Яр▒Нр░▓р░┐р░Вр░Ър░┐р░и р░кр▒Бр░░р▒Бр░╖р▒Бр░бр▒Б, р░╕р░Вр░Ьр▒Нр░Ю
ЁЯЩНтАНтЩА	р░ор░╣р░┐р░│, р░ор▒Бр░Цр░В р░Ър░┐р░Яр▒Нр░▓р░┐р░Вр░Ър░бр░В, р░ор▒Бр░Цр░В р░Ър░┐р░Яр▒Нр░▓р░┐р░Вр░Ър░┐р░и р░╕р▒Нр░др▒Нр░░р▒А, р░╕р░Вр░Ьр▒Нр░Ю, р░╕р▒Нр░др▒Нр░░р▒А
ЁЯЩО	р░Ер░▓р░Х, р░Ер░▓р░┐р░Чр░┐р░и р░╡р▒Нр░пр░Хр▒Нр░др░┐, р░╡р▒Нр░пр░Хр▒Нр░др░┐
ЁЯЩОтАНтЩВ	р░кр▒Бр░░р▒Бр░╖р▒Бр░бр▒Б, р░ор░Чр░╛р░бр▒Б, р░ор▒Кр░╣р░В р░ор▒Бр░бр▒Бр░Ър▒Бр░Хр▒Бр░ир▒Нр░и р░кр▒Бр░░р▒Бр░╖р▒Бр░бр▒Б, р░ор▒Кр░╣р░В р░ор▒Бр░бр▒Бр░Ър▒Бр░Хр▒Лр░╡р░бр░В, р░╕р░Вр░Ьр▒Нр░Ю
ЁЯЩОтАНтЩА	р░ор░╣р░┐р░│, р░ор▒Кр░╣р░В р░ор▒Бр░бр▒Бр░Ър▒Бр░Хр▒Бр░ир▒Нр░и р░╕р▒Нр░др▒Нр░░р▒А, р░ор▒Кр░╣р░В р░ор▒Бр░бр▒Бр░Ър▒Бр░Хр▒Лр░╡р░бр░В, р░╕р░Вр░Ьр▒Нр░Ю, р░╕р▒Нр░др▒Нр░░р▒А
ЁЯЩЕ	р░ор▒Бр░Цр░В, р░╡р░жр▒Нр░жр▒Б р░Ер░ир░┐ р░╕р▒Вр░Ър░┐р░Вр░Ър▒З р░╡р▒Нр░пр░Хр▒Нр░др░┐ р░ор▒Бр░Цр░В, р░╡р▒Нр░пр░Хр▒Нр░др░┐
ЁЯЩЕтАНтЩВ	р░Ер░Вр░Чр▒Ар░Хр░░р░┐р░Вр░Ър░ир▒Б, р░Ер░Вр░Чр▒Ар░Хр░░р░┐р░Вр░Ър░ир▒Б р░Ер░ир░┐ р░Ър▒Жр░мр▒Бр░др▒Бр░ир▒Нр░и р░кр▒Бр░░р▒Бр░╖р▒Бр░бр▒Б, р░Ър▒Зр░пр░┐, р░ир░┐р░╖р░┐р░жр▒Нр░зр░В, р░ир░┐р░╖р▒Зр░зр░┐р░Вр░Ър░мр░бр░┐р░Вр░жр░┐, р░кр▒Бр░░р▒Бр░╖р▒Бр░бр▒Б, р░ор░Чр░╛р░бр▒Б, р░╡р░жр▒Нр░жр▒Б, р░╕р░Вр░Ьр▒Нр░Ю
ЁЯЩЕтАНтЩА	р░Ер░Вр░Чр▒Ар░Хр░░р░┐р░Вр░Ър░ир▒Б, р░Ер░Вр░Чр▒Ар░Хр░░р░┐р░Вр░Ър░ир▒Б р░Ер░ир░┐ р░Ър▒Жр░мр▒Бр░др▒Бр░ир▒Нр░и р░╕р▒Нр░др▒Нр░░р▒А, р░Ър▒Зр░пр░┐, р░ир░┐р░╖р░┐р░жр▒Нр░зр░В, р░ир░┐р░╖р▒Зр░зр░┐р░Вр░Ър░мр░бр░┐р░Вр░жр░┐, р░ор░╣р░┐р░│, р░╡р░жр▒Нр░жр▒Б, р░╕р░Вр░Ьр▒Нр░Ю, р░╕р▒Нр░др▒Нр░░р▒А
ЁЯЩЖ	р░ор▒Бр░Цр░В, р░╡р▒Нр░пр░Хр▒Нр░др░┐, р░╕р░░р▒З р░Ер░ир░┐ р░╕р▒Вр░Ър░┐р░Вр░Ър▒З р░╡р▒Нр░пр░Хр▒Нр░др░┐ р░ор▒Бр░Цр░В
ЁЯЩЖтАНтЩВ	р░Ер░Вр░Чр▒Ар░Хр░░р░┐р░╕р▒Нр░др▒Бр░ир▒Нр░ир░╛р░ир▒Б р░Ер░ир░┐ р░Ър▒Жр░мр▒Бр░др▒Бр░ир▒Нр░и р░кр▒Бр░░р▒Бр░╖р▒Бр░бр▒Б, р░Ър▒Зр░пр░┐, р░кр▒Бр░░р▒Бр░╖р▒Бр░бр▒Б, р░ор░Чр░╛р░бр▒Б, р░╕р░Вр░Ьр▒Нр░Ю, р░╕р░░р▒З
ЁЯЩЖтАНтЩА	р░Ер░Вр░Чр▒Ар░Хр░░р░┐р░╕р▒Нр░др▒Бр░ир▒Нр░ир░╛р░ир▒Б р░Ер░ир░┐ р░Ър▒Жр░мр▒Бр░др▒Бр░ир▒Нр░и р░╕р▒Нр░др▒Нр░░р▒А, р░Ър▒Зр░пр░┐, р░ор░╣р░┐р░│, р░╕р░Вр░Ьр▒Нр░Ю, р░╕р░░р▒З, р░╕р▒Нр░др▒Нр░░р▒А
ЁЯТБ	р░╡р▒Нр░пр░Хр▒Нр░др░┐, р░╕р░ор░╛р░Ър░╛р░░р░В, р░╕р░ор░╛р░Ър░╛р░░р░В р░Ер░Вр░жр░┐р░Вр░Ър▒З р░╡р▒Нр░пр░Хр▒Нр░др░┐
ЁЯТБтАНтЩВ	р░Ър▒Зр░др░┐р░ир░┐ р░╡р░Вр░Ър░бр░В, р░Ър▒Зр░др░┐р░ир░┐ р░╡р░Вр░Ър░┐р░и р░кр▒Бр░░р▒Бр░╖р▒Бр░бр▒Б, р░др▒Жр░▓р░┐р░╡р░┐р░Чр░╛, р░кр▒Бр░░р▒Бр░╖р▒Бр░бр▒Б, р░ор░Чр░╛р░бр▒Б
ЁЯТБтАНтЩА	р░Ър▒Зр░др░┐р░ир░┐ р░╡р░Вр░Ър░бр░В, р░Ър▒Зр░др░┐р░ир░┐ р░╡р░Вр░Ър░┐р░и р░╕р▒Нр░др▒Нр░░р▒А, р░др▒Жр░▓р░┐р░╡р░┐р░Чр░╛, р░ор░╣р░┐р░│, р░╕р▒Нр░др▒Нр░░р▒А
ЁЯЩЛ	р░Жр░ир░Вр░жр░В, р░Жр░ир░Вр░жр░Вр░др▒Л р░Тр░Х р░Ър▒Зр░др░┐р░ир░┐ р░кр▒Ир░Хр░┐ р░Ор░др▒Нр░др░┐р░и р░╡р▒Нр░пр░Хр▒Нр░др░┐, р░Ър▒Зр░пр░┐, р░╡р▒Нр░пр░Хр▒Нр░др░┐
ЁЯЩЛтАНтЩВ	р░Ър▒Зр░пр░┐ р░кр▒Ир░Хр░┐ р░Ор░др▒Нр░др░бр░В, р░Ър▒Зр░пр░┐ р░кр▒Ир░Хр░┐ р░Ор░др▒Нр░др░┐р░и р░кр▒Бр░░р▒Бр░╖р▒Бр░бр▒Б, р░кр▒Бр░░р▒Бр░╖р▒Бр░бр▒Б, р░ор░Чр░╛р░бр▒Б, р░╕р░Вр░Ьр▒Нр░Ю
ЁЯЩЛтАНтЩА	р░Ър▒Зр░пр░┐ р░кр▒Ир░Хр░┐ р░Ор░др▒Нр░др░бр░В, р░Ър▒Зр░пр░┐ р░кр▒Ир░Хр░┐ р░Ор░др▒Нр░др░┐р░и р░╕р▒Нр░др▒Нр░░р▒А, р░ор░╣р░┐р░│, р░╕р░Вр░Ьр▒Нр░Ю, р░╕р▒Нр░др▒Нр░░р▒А
ЁЯЩЗ	р░Хр▒Нр░╖р░ор░╛р░кр░г, р░Хр▒Нр░╖р░ор░╛р░кр░гр░▓р▒Б р░Хр▒Лр░░р▒Бр░др▒Бр░ир▒Нр░и р░╡р▒Нр░пр░Хр▒Нр░др░┐, р░╡р▒Нр░пр░Хр▒Нр░др░┐
ЁЯЩЗтАНтЩВ	р░Хр▒Нр░╖р░ор░╛р░кр░г, р░Хр▒Нр░╖р░ор░╛р░кр░гр░▓р▒Б р░Хр▒Лр░░р▒Бр░Хр▒Бр░ир▒Нр░и р░кр▒Бр░░р▒Бр░╖р▒Бр░бр▒Б, р░Хр▒Нр░╖р░ор░┐р░Вр░Ър░Вр░бр░┐, р░др░▓ р░╡р░Вр░Ър░бр░В, р░кр▒Бр░░р▒Бр░╖р▒Бр░бр▒Б, р░ор░Чр░╛р░бр▒Б, р░╕р░Вр░Ьр▒Нр░Ю, р░╕р░╣р░╛р░пр░В
ЁЯЩЗтАНтЩА	р░Хр▒Нр░╖р░ор░╛р░кр░г, р░Хр▒Нр░╖р░ор░╛р░кр░гр░▓р▒Б р░Хр▒Лр░░р▒Бр░Хр▒Бр░ир▒Нр░и р░╕р▒Нр░др▒Нр░░р▒А, р░Хр▒Нр░╖р░ор░┐р░Вр░Ър░Вр░бр░┐, р░др░▓ р░╡р░Вр░Ър░бр░В, р░ор░╣р░┐р░│, р░╕р░Вр░Ьр▒Нр░Ю, р░╕р░╣р░╛р░пр░В, р░╕р▒Нр░др▒Нр░░р▒А
ЁЯдж	р░Ер░кр░ир░ор▒Нр░ор░Хр░В, р░Ер░░р░┐р░Ър▒Зр░пр░┐, р░Йр░жр▒Нр░░р▒Зр░Хр░В, р░др░▓ р░Хр▒Кр░Яр▒Нр░Яр▒Бр░Хр▒Бр░Вр░Яр▒Бр░ир▒Нр░и р░╡р▒Нр░пр░Хр▒Нр░др░┐, р░ор▒Бр░Цр░В, р░ор▒Бр░Цр░Вр░кр▒И р░Ър▒Зр░пр░┐
ЁЯджтАНтЩВ	р░Ер░кр░ир░ор▒Нр░ор░Хр░В, р░др░▓ р░Хр▒Кр░Яр▒Нр░Яр▒Бр░Хр▒Бр░Вр░Яр▒Бр░ир▒Нр░и р░кр▒Бр░░р▒Бр░╖р▒Бр░бр▒Б, р░др░▓ р░Хр▒Кр░Яр▒Нр░Яр▒Бр░Хр▒Лр░╡р░бр░В, р░кр▒Бр░░р▒Бр░╖р▒Бр░бр▒Б, р░ор░Чр░╛р░бр▒Б, р░╡р▒Зр░зр░┐р░Вр░кр▒Б
ЁЯджтАНтЩА	р░Ер░кр░ир░ор▒Нр░ор░Хр░В, р░др░▓ р░Хр▒Кр░Яр▒Нр░Яр▒Бр░Хр▒Бр░Вр░Яр▒Бр░ир▒Нр░и р░╕р▒Нр░др▒Нр░░р▒А, р░др░▓ р░Хр▒Кр░Яр▒Нр░Яр▒Бр░Хр▒Лр░╡р░бр░В, р░ор░╣р░┐р░│, р░╡р▒Зр░зр░┐р░Вр░кр▒Б, р░╕р▒Нр░др▒Нр░░р▒А
ЁЯд╖	р░Ер░ир▒Бр░ор░╛р░ир░В, р░Йр░жр░╛р░╕р▒Ар░ир░д, р░др▒Жр░▓р░┐р░пр░жр░ир░┐ р░нр▒Бр░Ьр░╛р░▓р▒Б р░кр▒Ир░Хр▒Жр░др▒Нр░др▒Бр░Я, р░др▒Жр░▓р▒Ар░жр░ир░┐ р░Ър▒Жр░кр▒Нр░др▒Бр░ир▒Нр░и р░╡р▒Нр░пр░Хр▒Нр░др░┐, р░ир░┐р░░р▒Нр░▓р░Хр▒Нр░╖р▒Нр░пр░В, р░нр▒Бр░Ьр░╛р░▓р▒Б р░Ор░Чр░░р░╡р▒Зр░д
ЁЯд╖тАНтЩВ	р░Йр░кр▒Зр░Хр▒Нр░╖, р░др▒Жр░▓р░┐р░пр░жр░ир░┐ р░╕р▒Ир░Ч, р░др▒Жр░▓р░┐р░пр░жр░ир░┐ р░╕р▒Ир░Ч р░Ър▒Зр░╕р▒Нр░др▒Бр░ир▒Нр░и р░кр▒Бр░░р▒Бр░╖р▒Бр░бр▒Б, р░кр▒Бр░░р▒Бр░╖р▒Бр░бр▒Б, р░ор░Чр░╛р░бр▒Б, р░╡р░┐р░╕р▒Нр░ор░░р░г, р░╕р░Вр░жр▒Зр░╣р░В
ЁЯд╖тАНтЩА	р░Йр░кр▒Зр░Хр▒Нр░╖, р░др▒Жр░▓р░┐р░пр░жр░ир░┐ р░╕р▒Ир░Ч, р░др▒Жр░▓р░┐р░пр░жр░ир░┐ р░╕р▒Ир░Ч р░Ър▒Зр░╕р▒Нр░др▒Бр░ир▒Нр░и р░╕р▒Нр░др▒Нр░░р▒А, р░ор░╣р░┐р░│, р░╡р░┐р░╕р▒Нр░ор░░р░г, р░╕р░Вр░жр▒Зр░╣р░В, р░╕р▒Нр░др▒Нр░░р▒А
ЁЯТЖ	р░ор░╕р░╛р░Ьр▒Н, р░ор▒Бр░Цр░В, р░ор▒Бр░Цр░Вр░кр▒И р░ор░░р▒Нр░жр░ир░╛ р░Ър▒Зр░пр░┐р░Вр░Ър▒Бр░Хр▒Бр░Вр░Яр▒Бр░ир▒Нр░и р░╡р▒Нр░пр░Хр▒Нр░др░┐
ЁЯТЖтАНтЩВ	р░кр▒Бр░░р▒Бр░╖р▒Бр░бр▒Б, р░ор░Чр░╛р░бр▒Б, р░ор░░р▒Нр░жр░ир░╛, р░ор▒Бр░Цр░В, р░ор▒Бр░Цр░Вр░кр▒И р░ор░░р▒Нр░жр░ир░╛ р░Ър▒Зр░пр░┐р░Вр░Ър▒Бр░Хр▒Бр░Вр░Яр▒Бр░ир▒Нр░и р░кр▒Бр░░р▒Бр░╖р▒Бр░бр▒Б
ЁЯТЖтАНтЩА	р░ор░░р▒Нр░жр░ир░╛, р░ор░╣р░┐р░│, р░ор▒Бр░Цр░В, р░ор▒Бр░Цр░Вр░кр▒И р░ор░░р▒Нр░жр░ир░╛ р░Ър▒Зр░пр░┐р░Вр░Ър▒Бр░Хр▒Бр░Вр░Яр▒Бр░ир▒Нр░и р░╕р▒Нр░др▒Нр░░р▒А, р░╕р▒Нр░др▒Нр░░р▒А
ЁЯТЗ	р░Хр░др▒Нр░др▒Жр░░, р░Ьр▒Бр░Яр▒Нр░Яр▒Б, р░Ьр▒Бр░Яр▒Нр░Яр▒Б р░Хр░др▒Нр░др░┐р░░р░┐р░Вр░Ър▒Бр░Хр▒Бр░Вр░Яр▒Бр░ир▒Нр░и р░╡р▒Нр░пр░Хр▒Нр░др░┐
ЁЯТЗтАНтЩВ	р░Ьр▒Бр░Яр▒Нр░Яр▒Б р░Хр░др▒Нр░др░┐р░░р░┐р░Вр░Ър▒Бр░Хр▒Бр░Вр░Яр▒Бр░ир▒Нр░и р░кр▒Бр░░р▒Бр░╖р▒Бр░бр▒Б, р░Ьр▒Бр░Яр▒Нр░Яр▒Б р░Хр░др▒Нр░др░┐р░░р░┐р░Вр░Ър▒Бр░Хр▒Лр░╡р░бр░В, р░кр▒Бр░░р▒Бр░╖р▒Бр░бр▒Б, р░ор░Чр░╛р░бр▒Б
ЁЯТЗтАНтЩА	р░Ьр▒Бр░Яр▒Нр░Яр▒Б р░Хр░др▒Нр░др░┐р░░р░┐р░Вр░Ър▒Бр░Хр▒Бр░Вр░Яр▒Бр░ир▒Нр░и р░╕р▒Нр░др▒Нр░░р▒А, р░Ьр▒Бр░Яр▒Нр░Яр▒Б р░Хр░др▒Нр░др░┐р░░р░┐р░Вр░Ър▒Бр░Хр▒Лр░╡р░бр░В, р░ор░╣р░┐р░│, р░╕р▒Нр░др▒Нр░░р▒А
ЁЯЪ╢	р░ир░бр▒Бр░╕р▒Нр░др▒Бр░ир▒Нр░и р░╡р▒Нр░пр░Хр▒Нр░др░┐, р░кр░╛р░жр░Ър░╛р░░р▒Бр░▓р▒Б, р░кр░╛р░жр░Ър░╛р░░р▒Бр░▓р▒Б р░др░┐р░░р░┐р░Чр▒З р░кр▒Нр░░р░жр▒Зр░╢р░В
ЁЯЪ╢тАНтЩВ	р░ир░бр░Х, р░ир░бр░╡р░бр░В, р░ир░бр▒Бр░╕р▒Нр░др▒Бр░ир▒Нр░и р░кр▒Бр░░р▒Бр░╖р▒Бр░бр▒Б, р░кр▒Бр░░р▒Бр░╖р▒Бр░бр▒Б, р░ор░Чр░╛р░бр▒Б
ЁЯЪ╢тАНтЩА	р░ир░бр░Х, р░ир░бр░╡р░бр░В, р░ир░бр▒Бр░╕р▒Нр░др▒Бр░ир▒Нр░и р░╕р▒Нр░др▒Нр░░р▒А, р░ор░╣р░┐р░│, р░╕р▒Нр░др▒Нр░░р▒А
ЁЯПГ	р░Хр▒Нр░░р▒Ар░б, р░кр░░р░┐р░Чр▒Жр░бр▒Бр░др▒Бр░ир▒Нр░и р░╡р▒Нр░пр░Хр▒Нр░др░┐, р░░р░ир▒Нр░ир░░р▒Н, р░░р░ир▒Нр░ир░┐р░Вр░Чр▒Н
ЁЯПГтАНтЩВ	р░кр░░р░┐р░Чр▒Жр░бр▒Бр░др▒Бр░ир▒Нр░и р░кр▒Бр░░р▒Бр░╖р▒Бр░бр▒Б, р░кр░░р░┐р░Чр▒Жр░др▒Нр░др░бр░В, р░кр░░р▒Бр░Чр▒Б р░кр░Вр░жр▒Жр░В, р░кр▒Бр░░р▒Бр░╖р▒Бр░бр▒Б, р░ор░Чр░╛р░бр▒Б, р░ор░╛р░░р░ер░╛р░ир▒Н
ЁЯПГтАНтЩА	р░кр░░р░┐р░Чр▒Жр░бр▒Бр░др▒Бр░ир▒Нр░и р░╕р▒Нр░др▒Нр░░р▒А, р░кр░░р░┐р░Чр▒Жр░др▒Нр░др░бр░В, р░кр░░р▒Бр░Чр▒Б р░кр░Вр░жр▒Жр░В, р░ор░╣р░┐р░│, р░ор░╛р░░р░ер░╛р░ир▒Н, р░╕р▒Нр░др▒Нр░░р▒А
ЁЯТГ	р░Ър▒Зр░пр░бр░В, р░ир▒Гр░др▒Нр░пр░В, р░ир▒Гр░др▒Нр░пр░В р░Ър▒Зр░╕р▒Нр░др▒Бр░ир▒Нр░и р░╕р▒Нр░др▒Нр░░р▒А
ЁЯХ║	р░ир▒Гр░др▒Нр░пр░В, р░ир▒Гр░др▒Нр░пр░В р░Ър▒Зр░╕р▒Нр░др▒Бр░ир▒Нр░и р░кр▒Бр░░р▒Бр░╖р▒Бр░бр▒Б, р░кр▒Бр░░р▒Бр░╖р▒Бр░бр▒Б
ЁЯСп	р░Хр▒Бр░Вр░жр▒Зр░▓р▒Б, р░Хр▒Бр░Вр░жр▒Зр░▓р▒Б р░Ър▒Жр░╡р▒Бр░▓р▒Б р░Йр░ир▒Нр░и р░╡р▒Нр░пр░Хр▒Нр░др▒Бр░▓р▒Б, р░Ър▒Жр░╡р▒Бр░▓р▒Б, р░╕р▒Нр░др▒Нр░░р▒А
ЁЯСптАНтЩВ	р░Хр▒Бр░Вр░жр▒Зр░▓р▒Б р░Ър▒Жр░╡р▒Бр░▓р░др▒Л р░кр▒Бр░░р▒Бр░╖р▒Бр░▓р▒Б, р░Хр▒Бр░Вр░жр▒Зр░▓р▒Б р░Ър▒Жр░╡р▒Бр░▓р▒Б, р░ир▒Гр░др▒Нр░пр░Хр░╛р░░р▒Бр░бр▒Б, р░кр▒Бр░░р▒Бр░╖р▒Бр░бр▒Б, р░ор░Чр░╛р░бр▒Б, р░╡р▒Зр░бр▒Бр░Х р░Ьр░░р▒Бр░кр▒Бр░Хр▒Бр░Вр░Яр▒Бр░ир▒Нр░и р░кр▒Бр░░р▒Бр░╖р▒Бр░▓р▒Б, р░╡р▒Зр░бр▒Бр░Х р░Ьр░░р▒Бр░кр▒Бр░Хр▒Лр░╡р░бр░В
ЁЯСптАНтЩА	р░Хр▒Бр░Вр░жр▒Зр░▓р▒Б р░Ър▒Жр░╡р▒Бр░▓р░др▒Л р░╕р▒Нр░др▒Нр░░р▒Ар░▓р▒Б, р░Хр▒Бр░Вр░жр▒Зр░▓р▒Б р░Ър▒Жр░╡р▒Бр░▓р▒Б, р░ир▒Гр░др▒Нр░пр░Хр░╛р░░р░┐р░гр░┐, р░ор░╣р░┐р░│, р░╡р▒Зр░бр▒Бр░Х р░Ьр░░р▒Бр░кр▒Бр░Хр▒Бр░Вр░Яр▒Бр░ир▒Нр░и р░╕р▒Нр░др▒Нр░░р▒Ар░▓р▒Б, р░╡р▒Зр░бр▒Бр░Х р░Ьр░░р▒Бр░кр▒Бр░Хр▒Лр░╡р░бр░В, р░╕р▒Нр░др▒Нр░░р▒А
ЁЯзЦ	р░Жр░╡р░┐р░░р░┐ р░Чр░жр░┐, р░Жр░╡р░┐р░░р░┐ р░Чр░жр░┐р░▓р▒Лр░ир░┐ р░╡р▒Нр░пр░Хр▒Нр░др░┐, р░Жр░╡р░┐р░░р░┐ р░╕р▒Нр░ир░╛р░ир░В
ЁЯзЦтАНтЩА	р░Жр░╡р░┐р░░р░┐ р░Чр░жр░┐, р░Жр░╡р░┐р░░р░┐ р░Чр░жр░┐р░▓р▒Л р░ор░╣р░┐р░│, р░Жр░╡р░┐р░░р░┐ р░╕р▒Нр░ир░╛р░ир░В
ЁЯзЦтАНтЩВ	р░Жр░╡р░┐р░░р░┐ р░Чр░жр░┐, р░Жр░╡р░┐р░░р░┐ р░Чр░жр░┐р░▓р▒Лр░ир░┐ р░кр▒Бр░░р▒Бр░╖р▒Бр░бр▒Б, р░Жр░╡р░┐р░░р░┐ р░╕р▒Нр░ир░╛р░ир░В
ЁЯзЧ	р░Ор░Хр▒Нр░Хр▒Бр░др▒Бр░ир▒Нр░и р░╡р▒Нр░пр░Хр▒Нр░др░┐
ЁЯзЧтАНтЩА	р░Ор░Хр▒Нр░Хр▒Бр░др▒Бр░ир▒Нр░и р░ор░╣р░┐р░│, р░Ор░Хр▒Нр░Хр▒Бр░др▒Бр░ир▒Нр░и р░╡р▒Нр░пр░Хр▒Нр░др░┐
ЁЯзЧтАНтЩВ	р░Ор░Хр▒Нр░Хр▒Бр░др▒Бр░ир▒Нр░и р░кр▒Бр░░р▒Бр░╖р▒Бр░бр▒Б, р░Ор░Хр▒Нр░Хр▒Бр░др▒Бр░ир▒Нр░и р░╡р▒Нр░пр░Хр▒Нр░др░┐
ЁЯзШ	р░зр▒Нр░пр░╛р░ир░В, р░кр░жр▒Нр░ор░В р░нр░Вр░Чр░┐р░ор░▓р▒Л р░╡р▒Нр░пр░Хр▒Нр░др░┐, р░пр▒Лр░╛р░Чр░╛
ЁЯзШтАНтЩА	р░зр▒Нр░пр░╛р░ир░В, р░кр░жр▒Нр░╢р░В р░нр░Вр░Чр░┐р░ор░▓р▒Л р░ор░╣р░┐р░│, р░пр▒Лр░Чр░╛
ЁЯзШтАНтЩВ	р░зр▒Нр░пр░╛р░ир░В, р░кр░жр▒Нр░ор░В р░нр░Вр░Чр░┐р░ор░▓р▒Л р░кр▒Бр░░р▒Бр░╖р▒Бр░бр▒Б, р░пр▒Лр░Чр░╛
ЁЯЫА	р░╡р▒Нр░пр░Хр▒Нр░др░┐, р░╕р▒Нр░ир░╛р░ир░В, р░╕р▒Нр░ир░╛р░ир░В р░Ър▒Зр░╕р▒Нр░др▒Бр░ир▒Нр░и р░╡р▒Нр░пр░Хр▒Нр░др░┐
ЁЯЫМ	р░кр░░р▒Бр░кр▒Б, р░кр░░р▒Бр░кр▒Б р░ор▒Ар░ж р░Йр░ир▒Нр░и р░╡р▒Нр░пр░Хр▒Нр░др░┐, р░╡р▒Нр░пр░Хр▒Нр░др░┐
ЁЯСд	р░ир░бр▒Бр░ор▒Б, р░ир░бр▒Бр░ор▒Б р░кр▒Ир░нр░╛р░Чр░Вр░▓р▒Лр░ир░┐ р░╡р▒Нр░пр░Хр▒Нр░др░┐ р░ир▒Ар░б, р░ир▒Ар░б, р░╡р▒Нр░пр░Хр▒Нр░др░┐
ЁЯСе	р░ир░бр▒Бр░ор▒Б, р░ир░бр▒Бр░ор▒Б р░кр▒Ир░нр░╛р░Чр░Вр░▓р▒Лр░ир░┐ р░╡р▒Нр░пр░Хр▒Нр░др▒Бр░▓ р░ир▒Ар░бр░▓р▒Б, р░ир▒Ар░б, р░╡р▒Нр░пр░Хр▒Нр░др░┐
ЁЯд║	р░Хр░др▒Нр░др░┐, р░Хр░др▒Нр░др░┐р░╕р░╛р░ор▒Б р░Ър▒Зр░╕р▒Нр░др▒Бр░ир▒Нр░и р░╡р▒Нр░пр░Хр▒Нр░др░┐, р░Хр░др▒Нр░др░┐р░╕р░╛р░ор▒Бр░др▒Л р░Йр░ир▒Нр░и р░╡р▒Нр░пр░Хр▒Нр░др░┐, р░Хр▒Нр░░р▒Ар░б, р░лр▒Жр░ир▒Нр░╕р░░р▒Н, р░лр▒Жр░ир▒Нр░╕р░┐р░Вр░Чр▒Н, р░╡р▒Нр░пр░Хр▒Нр░др░┐
ЁЯПЗ	р░Хр▒Нр░░р▒Ар░б, р░Чр▒Бр░░р▒Нр░░р░В, р░Чр▒Бр░░р▒Нр░░р░кр▒Б р░кр░Вр░жр▒Жр░В, р░Ьр░╛р░Хр▒А, р░░р▒Зр░╕р░┐р░Вр░Чр▒Н, р░░р▒Зр░╕р▒Б р░Чр▒Бр░░р▒Нр░░р░В
ЁЯПМтАНтЩВ	р░Чр▒Лр░▓р▒Нр░лр▒Н, р░Чр▒Лр░▓р▒Нр░лр▒Н р░Жр░бр▒Бр░др▒Бр░ир▒Нр░и р░кр▒Бр░░р▒Бр░╖р▒Бр░бр▒Б, р░кр▒Бр░░р▒Бр░╖р▒Бр░бр▒Б, р░ор░Чр░╛р░бр▒Б
ЁЯПМтАНтЩА	р░Чр▒Лр░▓р▒Нр░лр▒Н, р░Чр▒Лр░▓р▒Нр░лр▒Н р░Жр░бр▒Бр░др▒Бр░ир▒Нр░и р░╕р▒Нр░др▒Нр░░р▒А, р░ор░╣р░┐р░│, р░╕р▒Нр░др▒Нр░░р▒А
ЁЯПДтАНтЩВ	р░кр▒Бр░░р▒Бр░╖р▒Бр░бр▒Б, р░ор░Чр░╛р░бр▒Б, р░╕р░░р▒Нр░лр░┐р░Вр░Чр▒Н, р░╕р░░р▒Нр░лр▒Н р░Ър▒Зр░╕р▒Нр░др▒Бр░ир▒Нр░и р░кр▒Бр░░р▒Бр░╖р▒Бр░бр▒Б
ЁЯПДтАНтЩА	р░ор░╣р░┐р░│, р░╕р░░р▒Нр░лр░┐р░Вр░Чр▒Н, р░╕р░░р▒Нр░лр▒Н р░Ър▒Зр░╕р▒Нр░др▒Бр░ир▒Нр░и р░╕р▒Нр░др▒Нр░░р▒А, р░╕р▒Нр░др▒Нр░░р▒А
ЁЯЪг	р░др▒Жр░бр▒Нр░бр▒Б, р░др▒Жр░бр▒Нр░бр▒Б р░╡р▒Зр░╕р▒Нр░др▒Бр░ир▒Нр░и р░╡р▒Нр░пр░Хр▒Нр░др░┐, р░кр░бр░╡
ЁЯЪгтАНтЩВ	р░др▒Жр░бр▒Нр░бр▒Б р░╡р▒Зр░╕р▒Нр░др▒Бр░ир▒Нр░и р░кр▒Бр░░р▒Бр░╖р▒Бр░бр▒Б, р░кр░бр░╡, р░кр▒Бр░░р▒Бр░╖р▒Бр░бр▒Б, р░ор░Чр░╛р░бр▒Б, р░░р▒Лр░мр▒Лр░Яр▒Н
ЁЯЪгтАНтЩА	р░др▒Жр░бр▒Нр░бр▒Б р░╡р▒Зр░╕р▒Нр░др▒Бр░ир▒Нр░и р░╕р▒Нр░др▒Нр░░р▒А, р░кр░бр░╡, р░ор░╣р░┐р░│, р░░р▒Лр░мр▒Лр░Яр▒Н, р░╕р▒Нр░др▒Нр░░р▒А
ЁЯПКтАНтЩВ	р░Ир░д, р░Ир░д р░Хр▒Кр░бр▒Бр░др▒Бр░ир▒Нр░и р░кр▒Бр░░р▒Бр░╖р▒Бр░бр▒Б, р░кр▒Бр░░р▒Бр░╖р▒Бр░бр▒Б, р░ор░Чр░╛р░бр▒Б
ЁЯПКтАНтЩА	р░Ир░д, р░Ир░д р░Хр▒Кр░бр▒Бр░др▒Бр░ир▒Нр░и р░╕р▒Нр░др▒Нр░░р▒А, р░ор░╣р░┐р░│, р░╕р▒Нр░др▒Нр░░р▒А
тЫ╣тАНтЩВ	р░кр▒Бр░░р▒Бр░╖р▒Бр░бр▒Б, р░мр░Вр░др░┐, р░мр░Вр░др░┐р░др▒Л р░Жр░бр▒Бр░др▒Бр░ир▒Нр░и р░кр▒Бр░░р▒Бр░╖р▒Бр░бр▒Б, р░ор░Чр░╛р░бр▒Б
тЫ╣тАНтЩА	р░мр░Вр░др░┐, р░мр░Вр░др░┐р░др▒Л р░Жр░бр▒Бр░др▒Бр░ир▒Нр░и р░╕р▒Нр░др▒Нр░░р▒А, р░ор░╣р░┐р░│, р░╕р▒Нр░др▒Нр░░р▒А
ЁЯПЛтАНтЩВ	р░кр▒Бр░░р▒Бр░╖р▒Бр░бр▒Б, р░мр░░р▒Бр░╡р▒Б р░Ор░др▒Нр░др▒З р░кр▒Бр░░р▒Бр░╖р▒Бр░бр▒Б, р░мр░░р▒Бр░╡р▒Бр░▓р▒Б р░Ор░др▒Нр░др▒Бр░др▒Бр░ир▒Нр░и р░кр▒Бр░░р▒Бр░╖р▒Бр░бр▒Б, р░ор░Чр░╛р░бр▒Б
ЁЯПЛтАНтЩА	р░мр░░р▒Бр░╡р▒Б р░Ор░др▒Нр░др▒З р░╕р▒Нр░др▒Нр░░р▒А, р░мр░░р▒Бр░╡р▒Бр░▓р▒Б р░Ор░др▒Нр░др▒Бр░др▒Бр░ир▒Нр░и р░╕р▒Нр░др▒Нр░░р▒А, р░ор░╣р░┐р░│, р░╕р▒Нр░др▒Нр░░р▒А
ЁЯЪ┤	р░мр▒Ир░Хр▒Н, р░╕р▒Ир░Хр░┐р░▓р▒Н, р░╕р▒Ир░Хр░┐р░▓р▒Н р░др▒Кр░Хр▒Нр░Хр▒З р░╡р▒Нр░пр░Хр▒Нр░др░┐
ЁЯЪ┤тАНтЩВ	р░кр▒Бр░░р▒Бр░╖р▒Бр░бр▒Б, р░ор░Чр░╛р░бр▒Б, р░╕р▒Ир░Хр░┐р░▓р▒Н, р░╕р▒Ир░Хр░┐р░▓р▒Н р░др▒Кр░Хр▒Нр░Хр░бр░В, р░╕р▒Ир░Хр░┐р░▓р▒Н р░др▒Кр░Хр▒Нр░Хр▒Бр░др▒Бр░ир▒Нр░и р░кр▒Бр░░р▒Бр░╖р▒Бр░бр▒Б, р░╕р▒Ир░Хр░┐р░▓р▒Н р░др▒Кр░Хр▒Нр░Хр▒Зр░╡р░╛р░░р▒Б
ЁЯЪ┤тАНтЩА	р░ор░╣р░┐р░│, р░╕р▒Ир░Хр░┐р░▓р▒Н, р░╕р▒Ир░Хр░┐р░▓р▒Н р░др▒Кр░Хр▒Нр░Хр░бр░В, р░╕р▒Ир░Хр░┐р░▓р▒Н р░др▒Кр░Хр▒Нр░Хр▒Бр░др▒Бр░ир▒Нр░и р░╕р▒Нр░др▒Нр░░р▒А, р░╕р▒Ир░Хр░┐р░▓р▒Н р░др▒Кр░Хр▒Нр░Хр▒Зр░╡р░╛р░░р▒Б, р░╕р▒Нр░др▒Нр░░р▒А
ЁЯЪ╡	р░кр░░р▒Нр░╡р░др░╛р░▓р░кр▒И р░╕р▒Ир░Хр░┐р░▓р▒Н р░др▒Кр░Хр▒Нр░Хр▒З р░╡р▒Нр░пр░Хр▒Нр░др░┐, р░кр░░р▒Нр░╡р░др░╛р░▓р▒Б, р░мр▒Ир░Хр▒Н, р░╕р▒Ир░Хр░┐р░▓р▒Н, р░╕р▒Ир░Хр░┐р░▓р▒Н р░др▒Кр░Хр▒Нр░Хр▒З р░╡р▒Нр░пр░Хр▒Нр░др░┐
ЁЯЪ╡тАНтЩВ	р░Хр▒Кр░Вр░бр░кр▒Ир░Хр░┐ р░╕р▒Ир░Хр░┐р░▓р▒Н р░др▒Кр░Хр▒Нр░Хр▒Бр░др▒Бр░ир▒Нр░и р░кр▒Бр░░р▒Бр░╖р▒Бр░бр▒Б, р░кр░░р▒Нр░╡р░др░В, р░кр▒Бр░░р▒Бр░╖р▒Бр░бр▒Б, р░ор░Чр░╛р░бр▒Б, р░╕р▒Ир░Хр░┐р░▓р▒Н, р░╕р▒Ир░Хр░┐р░▓р▒Н р░др▒Кр░Хр▒Нр░Хр░бр░В, р░╕р▒Ир░Хр░┐р░▓р▒Н р░др▒Кр░Хр▒Нр░Хр▒Зр░╡р░╛р░░р▒Б
ЁЯЪ╡тАНтЩА	р░Хр▒Кр░Вр░бр░кр▒Ир░Хр░┐ р░╕р▒Ир░Хр░┐р░▓р▒Н р░др▒Кр░Хр▒Нр░Хр▒Бр░др▒Бр░ир▒Нр░и р░╕р▒Нр░др▒Нр░░р▒А, р░кр░░р▒Нр░╡р░др░В, р░ор░╣р░┐р░│, р░╕р▒Ир░Хр░┐р░▓р▒Н, р░╕р▒Ир░Хр░┐р░▓р▒Н р░др▒Кр░Хр▒Нр░Хр░бр░В, р░╕р▒Ир░Хр░┐р░▓р▒Н р░др▒Кр░Хр▒Нр░Хр▒Зр░╡р░╛р░░р▒Б, р░╕р▒Нр░др▒Нр░░р▒А
ЁЯд╕	р░Хр░╛р░░р▒Нр░Яр▒НтАМр░╡р▒Ар░▓р▒Н, р░Хр▒Нр░░р▒Ар░б, р░Ьр░┐р░ор▒Нр░ир░╛р░╕р▒Нр░Яр░┐р░Хр▒Нр░╕р▒Н, р░╡р▒Нр░пр░Хр▒Нр░др░┐
ЁЯд╕тАНтЩВ	р░Хр░╛р░░р▒Нр░Яр▒НтАМр░╡р▒Ар░▓р▒Н р░Ър▒Зр░╕р▒Нр░др▒Бр░ир▒Нр░и р░кр▒Бр░░р▒Бр░╖р▒Бр░бр▒Б, р░Хр▒Нр░░р▒Ар░б, р░Ьр░┐р░ор▒Нр░ир░╛р░╕р▒Нр░Яр░┐р░Хр▒Нр░╕р▒Н, р░кр▒Бр░░р▒Бр░╖р▒Бр░бр▒Б, р░ор░Чр░╛р░бр▒Б, р░ор▒Кр░Чр▒Нр░Чр░▓р▒Б р░╡р▒Зр░╕р▒Нр░др▒Бр░ир▒Нр░и р░кр▒Бр░░р▒Бр░╖р▒Бр░бр▒Б, р░╡р▒Нр░пр░Хр▒Нр░др░┐
ЁЯд╕тАНтЩА	р░Хр░╛р░░р▒Нр░Яр▒НтАМр░╡р▒Ар░▓р▒Н р░Ър▒Зр░╕р▒Нр░др▒Бр░ир▒Нр░и р░╕р▒Нр░др▒Нр░░р▒А, р░Хр▒Нр░░р▒Ар░б, р░Ьр░┐р░ор▒Нр░ир░╛р░╕р▒Нр░Яр░┐р░Хр▒Нр░╕р▒Н, р░ор░╣р░┐р░│, р░ор▒Кр░Чр▒Нр░Чр░▓р▒Б р░╡р▒Зр░╕р▒Нр░др▒Бр░ир▒Нр░и р░╕р▒Нр░др▒Нр░░р▒А, р░╡р▒Нр░пр░Хр▒Нр░др░┐, р░╕р▒Нр░др▒Нр░░р▒А
ЁЯд╝	р░Хр▒Нр░░р▒Ар░б, р░░р▒Жр░Ьр░┐р░▓р▒Н, р░░р▒Жр░Ьр▒Нр░▓р░░р▒Н, р░░р▒Жр░Ьр▒Нр░▓р░░р▒НтАМр░▓р▒Б, р░╡р▒Нр░пр░Хр▒Нр░др░┐
ЁЯд╝тАНтЩВ	р░Хр▒Бр░╕р▒Нр░др▒А, р░Хр▒Бр░╕р▒Нр░др▒А р░кр░бр▒Бр░др▒Бр░ир▒Нр░и р░кр▒Бр░░р▒Бр░╖р▒Бр░бр▒Б, р░Хр▒Нр░░р▒Ар░б, р░кр▒Бр░░р▒Бр░╖р▒Бр░бр▒Б, р░ор░Чр░╛р░бр▒Б, р░╡р▒Нр░пр░Хр▒Нр░др░┐
ЁЯд╝тАНтЩА	р░Хр▒Бр░╕р▒Нр░др▒А, р░Хр▒Бр░╕р▒Нр░др▒А р░кр░бр▒Бр░др▒Бр░ир▒Нр░и р░╕р▒Нр░др▒Нр░░р▒А, р░Хр▒Нр░░р▒Ар░б, р░ор░╣р░┐р░│, р░╡р▒Нр░пр░Хр▒Нр░др░┐, р░╕р▒Нр░др▒Нр░░р▒А
ЁЯд╜	р░Хр▒Нр░░р▒Ар░б, р░кр▒Лр░▓р▒Л, р░╡р░╛р░Яр░░р▒Н, р░╡р░╛р░Яр░░р▒Н р░кр▒Лр░▓р▒Л р░Жр░бр▒Бр░др▒Бр░ир▒Нр░и р░╡р▒Нр░пр░Хр▒Нр░др░┐, р░╡р▒Нр░пр░Хр▒Нр░др░┐
ЁЯд╜тАНтЩВ	р░Хр▒Нр░░р▒Ар░б, р░кр▒Бр░░р▒Бр░╖р▒Бр░бр▒Б, р░ор░Чр░╛р░бр▒Б, р░╡р░╛р░Яр░░р▒Н р░кр▒Лр░▓р▒Л, р░╡р░╛р░Яр░░р▒Н р░кр▒Лр░▓р▒Л р░Жр░бр▒Бр░др▒Бр░ир▒Нр░и р░кр▒Бр░░р▒Бр░╖р▒Бр░бр▒Б
ЁЯд╜тАНтЩА	р░Хр▒Нр░░р▒Ар░б, р░ор░╣р░┐р░│, р░╡р░╛р░Яр░░р▒Н р░кр▒Лр░▓р▒Л, р░╡р░╛р░Яр░░р▒Н р░кр▒Лр░▓р▒Л р░Жр░бр▒Бр░др▒Бр░ир▒Нр░и р░╕р▒Нр░др▒Нр░░р▒А, р░╕р▒Нр░др▒Нр░░р▒А
ЁЯд╛	р░Хр▒Нр░░р▒Ар░б, р░мр░╛р░▓р▒Н, р░╡р▒Нр░пр░Хр▒Нр░др░┐, р░╣р▒Нр░пр░╛р░Вр░бр▒НтАМр░мр░╛р░▓р▒Н, р░╣р▒Нр░пр░╛р░Вр░бр▒НтАМр░мр░╛р░▓р▒Н р░Жр░бр▒Бр░др▒Бр░ир▒Нр░и р░╡р▒Нр░пр░Хр▒Нр░др░┐
ЁЯд╛тАНтЩВ	р░Хр▒Нр░░р▒Ар░б, р░кр▒Бр░░р▒Бр░╖р▒Бр░бр▒Б, р░ор░Чр░╛р░бр▒Б, р░╣р▒Нр░пр░╛р░Вр░бр▒НтАМр░мр░╛р░▓р▒Н, р░╣р▒Нр░пр░╛р░Вр░бр▒НтАМр░мр░╛р░▓р▒Н р░Жр░бр▒Бр░др▒Бр░ир▒Нр░и р░кр▒Бр░░р▒Бр░╖р▒Бр░бр▒Б
ЁЯд╛тАНтЩА	р░Хр▒Нр░░р▒Ар░б, р░ор░╣р░┐р░│, р░╕р▒Нр░др▒Нр░░р▒А, р░╣р▒Нр░пр░╛р░Вр░бр▒НтАМр░мр░╛р░▓р▒Н, р░╣р▒Нр░пр░╛р░Вр░бр▒НтАМр░мр░╛р░▓р▒Н р░Жр░бр▒Бр░др▒Бр░ир▒Нр░и р░╕р▒Нр░др▒Нр░░р▒А
ЁЯд╣	р░Чр░╛р░░р░бр▒А р░Ър▒Зр░╕р▒Нр░др▒Бр░ир▒Нр░и р░╡р▒Нр░пр░Хр▒Нр░др░┐, р░Ьр░Чр▒Бр░▓р▒Н, р░ир▒Ир░кр▒Бр░гр▒Нр░пр░В, р░мр░╣р▒Бр░│р░Хр░╛р░░р▒Нр░п, р░╕р░ор░др▒Бр░▓р▒Нр░пр░д
ЁЯд╣тАНтЩВ	р░Чр░╛р░░р░бр▒А, р░Чр░╛р░░р░бр▒А р░Ър▒Зр░╕р▒Нр░др▒Бр░ир▒Нр░и р░кр▒Бр░░р▒Бр░╖р▒Бр░бр▒Б, р░кр▒Бр░░р▒Бр░╖р▒Бр░бр▒Б, р░мр░╣р▒Бр░│ р░╡р░┐р░зр░┐, р░ор░Чр░╛р░бр▒Б
ЁЯд╣тАНтЩА	р░Чр░╛р░░р░бр▒А, р░Чр░╛р░░р░бр▒А р░Ър▒Зр░╕р▒Нр░др▒Бр░ир▒Нр░и р░╕р▒Нр░др▒Нр░░р▒А, р░мр░╣р▒Бр░│ р░╡р░┐р░зр░┐, р░ор░╣р░┐р░│, р░╕р▒Нр░др▒Нр░░р▒А
ЁЯСл	р░Ър▒Зр░др▒Бр░▓р▒Б, р░Ър▒Зр░др▒Бр░▓р▒Б р░кр░Яр▒Нр░Яр▒Бр░Хр▒Бр░ир░┐ р░Йр░ир▒Нр░и р░Ьр░Вр░Я, р░Ьр░Вр░Я
ЁЯСм	р░Ър▒Зр░др▒Бр░▓р▒Б, р░Ър▒Зр░др▒Бр░▓р▒Б р░кр░Яр▒Нр░Яр▒Бр░Хр▒Бр░ир░┐ р░Йр░ир▒Нр░и р░Зр░жр▒Нр░жр░░р▒Б р░кр▒Бр░░р▒Бр░╖р▒Бр░▓р▒Б, р░кр▒Бр░░р▒Бр░╖р▒Бр░▓р▒Б
ЁЯСн	р░Ър▒Зр░др▒Бр░▓р▒Б, р░Ър▒Зр░др▒Бр░▓р▒Б р░кр░Яр▒Нр░Яр▒Бр░Хр▒Бр░ир░┐ р░Йр░ир▒Нр░и р░Зр░жр▒Нр░жр░░р▒Б р░╕р▒Нр░др▒Нр░░р▒Ар░▓р▒Б, р░╕р▒Нр░др▒Нр░░р▒Ар░▓р▒Б
ЁЯТП	р░ор▒Бр░жр▒Нр░жр▒Б, р░╢р▒Гр░Вр░Чр░╛р░░р░В
ЁЯТС	р░Ьр░Вр░Я, р░Ьр░Вр░Я р░ор░зр▒Нр░п р░кр▒Нр░░р▒Зр░о р░Ър░┐р░╣р▒Нр░ир░В, р░кр▒Нр░░р▒Зр░о
ЁЯд│	р░Хр▒Жр░ор▒Жр░░р░╛, р░лр▒Лр░ир▒Н, р░╕р▒Жр░▓р▒Нр░лр▒А
ЁЯТк	р░Хр░Вр░бр░▓р▒Б, р░жр▒Гр░вр░др▒Нр░╡р░В, р░мр░▓р░┐р░╖р▒Нр░Яр░ор▒Ир░и р░Ър▒Зр░пр░┐
ЁЯж╡	р░Ер░╡р░пр░╡р░В, р░Хр░╛р░▓р▒Б, р░др░ир▒Нр░ир░бр░В
ЁЯж╢	р░др░ир▒Нр░ир▒Б, р░ир░бр░╡р░бр░В, р░кр░╛р░жр░В
ЁЯЦХ	р░Ър▒Зр░пр░┐, р░ор░зр▒Нр░п р░╡р▒Зр░▓р▒Б р░Ър▒Вр░кр▒Бр░Я, р░╡р▒Зр░▓р▒Б
ЁЯдЮ	р░Ер░жр▒Гр░╖р▒Нр░Яр░В, р░Хр▒Нр░░р░╛р░╕р▒Н, р░Хр▒Нр░░р░╛р░╕р▒Н р░Ър▒Зр░╕р░┐р░и р░╡р▒Зр░│р▒Нр░▓р▒Б, р░Ър▒Зр░пр░┐, р░╡р▒Зр░│р▒Нр░▓р▒Б
ЁЯЦЦ	р░Жр░пр▒Бр░░р░╛р░░р▒Лр░Чр▒Нр░п р░Рр░╢р▒Нр░╡р░░р▒Нр░п р░кр▒Нр░░р░╛р░кр▒Нр░др░┐р░░р░╕р▒Нр░др▒Б, р░Жр░пр▒Бр░╡р▒Б, р░Жр░░р▒Лр░Чр▒Нр░пр░В, р░Рр░╢р▒Нр░╡р░░р▒Нр░пр░В р░кр▒Кр░Вр░жр░╛р░▓р░ир▒З р░Жр░Хр░╛р░Вр░Хр▒Нр░╖ р░╕р░Вр░Хр▒Зр░др░В
ЁЯдШ	р░Хр▒Кр░ор▒Нр░ор▒Б, р░Хр▒Кр░ор▒Нр░ор▒Бр░▓р▒Б р░╕р▒Вр░Ър░┐р░Вр░Ър▒З р░Чр▒Бр░░р▒Нр░др▒Б, р░Чр▒Бр░░р▒Нр░др▒Б
ЁЯдЩ	р░Хр░╛р░▓р▒Н, р░Хр░╛р░▓р▒Н р░Ър▒Зр░пр░┐ р░Ер░ир░┐ р░╕р▒Вр░Ър░┐р░Вр░Ър▒З р░Ър▒Зр░пр░┐, р░Ър▒Зр░пр░┐
тЬЛ	р░Ер░нр░п р░╣р░╕р▒Нр░др░В, р░Ер░░р░Ър▒Зр░пр░┐, р░Жр░Чр▒Бр░ор▒Б р░Ър░┐р░╣р▒Нр░ир░В, р░Ор░др▒Нр░др░┐р░и р░Ър▒Зр░пр░┐
ЁЯСМ	р░Чр▒Бр░░р▒Нр░др▒Б, р░╕р░ор▒Нр░ор░др░┐, р░╕р░ор▒Нр░ор░др░┐ р░Чр▒Бр░░р▒Нр░др▒Б
тЬК	р░Рр░Хр▒Нр░пр░д, р░кр░┐р░бр░┐р░Хр░┐р░▓р░┐
ЁЯСК	р░кр░┐р░бр░┐р░Хр░┐р░▓р░┐ р░Чр▒Бр░░р▒Нр░др▒Б, р░кр░┐р░бр░┐р░Хр░┐р░▓р░┐ р░мр░┐р░Чр░┐р░Вр░Ър░┐р░и р░Чр▒Бр░░р▒Нр░др▒Б
ЁЯдЫ	р░Ор░бр░ор░╡р▒Ир░кр▒Б, р░Ор░бр░ор░╡р▒Ир░кр▒Б р░кр░┐р░бр░┐р░Хр░┐р░▓р░┐, р░кр░┐р░бр░┐р░Хр░┐р░▓р░┐
ЁЯдЬ	р░Хр▒Бр░бр░┐р░╡р▒Ир░кр▒Б, р░Хр▒Бр░бр░┐р░╡р▒Ир░кр▒Б р░кр░┐р░бр░┐р░Хр░┐р░▓р░┐, р░кр░┐р░бр░┐р░Хр░┐р░▓р░┐
ЁЯдЪ	р░Ър▒Зр░др░┐ р░╡р▒Жр░ир▒Бр░Хр░╡р▒Ир░кр▒Б, р░кр▒Ир░Хр▒Жр░др▒Нр░др░бр░В, р░кр▒Ир░Хр▒Жр░др▒Нр░др░┐ р░Ър▒Вр░кр░┐р░╕р▒Нр░др▒Бр░ир▒Нр░и р░Ър▒Зр░др░┐ р░╡р▒Жр░ир▒Бр░Хр░╡р▒Ир░кр▒Б
ЁЯСЛ	р░Кр░кр░бр░В, р░Ър▒Зр░пр░┐, р░Ър▒Зр░пр░┐ р░Кр░кр░бр░В
ЁЯдЯ	р░Ър▒Зр░пр░┐, р░ир░┐р░ир▒Нр░ир▒Б р░кр▒Нр░░р▒Зр░ор░┐р░╕р▒Нр░др▒Бр░ир▒Нр░ир░╛р░ир▒Б, р░ир░┐р░ир▒Нр░ир▒Б р░кр▒Нр░░р▒Зр░ор░┐р░╕р▒Нр░др▒Бр░ир▒Нр░ир░╛р░ир▒Б р░Ер░ир▒З р░╕р░Вр░Ьр▒Нр░Ю
ЁЯСП	р░Хр▒Кр░Яр▒Нр░Яр░бр░В, р░Ър░кр▒Нр░кр░Яр▒Нр░▓р▒Б, р░Ър░кр▒Нр░кр░Яр▒Нр░▓р▒Б р░Хр▒Кр░Яр▒Нр░Яр░бр░В
ЁЯСР	р░Йр░др▒Нр░д р░Ър▒Зр░др▒Бр░▓ р░Чр▒Бр░░р▒Нр░др▒Б, р░Йр░др▒Нр░д р░Ър▒Зр░др▒Бр░▓р▒Б, р░╕р░Вр░мр░░р░╛р░▓р▒Нр░▓р▒Л р░Ър▒Зр░др▒Бр░▓р▒Б р░кр▒Ир░Хр░┐ р░Ор░др▒Нр░др░┐ р░Жр░бр░┐р░кр░╛р░бр▒З р░Чр▒Бр░░р▒Нр░др▒Б
ЁЯЩМ	р░Ър▒Зр░др▒Бр░▓р▒Б, р░░р▒Жр░Вр░бр▒Б р░Ър▒Зр░др▒Бр░▓р▒Б р░кр▒Ир░Хр░┐ р░Ор░др▒Нр░др░┐р░и р░╡р▒Нр░пр░Хр▒Нр░др░┐, р░╡р▒Нр░пр░Хр▒Нр░др░┐
ЁЯд▓	р░Тр░Хр░жр░╛р░ир░┐р░др▒Л р░Тр░Хр░Яр░┐ р░ор▒Бр░бр░┐р░╡р▒Зр░╕р░┐р░и р░Ер░░р░Ър▒Зр░др▒Бр░▓р▒Б, р░кр▒Нр░░р░╛р░░р▒Нр░ер░и
ЁЯЩП	р░Ър▒Зр░др▒Бр░▓р▒Б, р░Ър▒Зр░др▒Бр░▓р▒Б р░ор▒Бр░бр▒Бр░Ър▒Бр░Хр▒Бр░ир▒Нр░и р░╡р▒Нр░пр░Хр▒Нр░др░┐, р░╡р▒Нр░пр░Хр▒Нр░др░┐
ЁЯдЭ	р░Тр░кр▒Нр░кр░Вр░жр░В, р░Хр░░р░Ър░╛р░▓р░ир░В, р░Ър░╛р░▓р░ир░В, р░Ър▒Зр░пр░┐, р░╕р░ор░╛р░╡р▒Зр░╢р░В
ЁЯТЕ	р░Чр▒Лр░░р▒Нр░▓ р░░р░Вр░Чр▒Б, р░Чр▒Лр░│р▒Нр░▓р▒Б, р░░р░Вр░Чр▒Б
ЁЯСГ	р░ор▒Бр░Хр▒Нр░Хр▒Б, р░ор▒Бр░Цр░В, р░╢р░░р▒Ар░░р░В
ЁЯСг	р░Ер░бр▒Бр░Чр▒Бр░▓р▒Б, р░Хр░╛р░▓р░┐ р░ор▒Бр░жр▒Нр░░р░▓р▒Б, р░Хр░╛р░▓р░┐р░ор▒Бр░жр▒Нр░░р░▓р▒Б
ЁЯСА	р░Хр░│р▒Нр░▓р▒Б, р░ор▒Бр░Цр░В
ЁЯСБтАНЁЯЧи	р░Хр░ир▒Нр░ир▒Б, р░кр▒Нр░░р░╕р░Вр░Ч р░мр░бр▒Бр░Ч, р░кр▒Нр░░р░╕р░Вр░Ч р░мр▒Бр░бр▒Бр░Чр░▓р▒Л р░Хр░ир▒Нр░ир▒Б, р░╕р░╛р░Хр▒Нр░╖р░┐
ЁЯза	р░ор▒Жр░жр░бр▒Б, р░ор▒Зр░зр░╛р░╡р░┐
ЁЯж┤	р░Ер░╕р▒Нр░др░┐р░кр░Вр░Ьр░░р░В, р░Ор░ор▒Бр░Х
ЁЯж╖	р░жр░Вр░др░╡р▒Ир░жр▒Нр░пр▒Бр░▓р▒Б, р░кр░ир▒Нр░ир▒Б
ЁЯСЕ	р░ир░╛р░▓р▒Бр░Х, р░ор▒Бр░Цр░В, р░╢р░░р▒Ар░░р░В
ЁЯСД	р░ир▒Лр░░р▒Б, р░кр▒Жр░жр░╡р▒Бр░▓р▒Б, р░ор▒Бр░Цр░В, р░╢р░░р▒Ар░░р░В
ЁЯж░	р░Ер░▓р▒Нр░▓р░Вр░░р░Вр░Чр▒Б, р░Ор░░р▒Нр░░р░Ьр▒Бр░Яр▒Нр░Яр▒Б р░Йр░ир▒Нр░и р░др░▓, р░Ор░░р▒Нр░░р░Яр░┐ р░Ьр▒Бр░Яр▒Нр░Яр▒Б
ЁЯж▒	р░Жр░лр▒Нр░░р▒Л, р░Йр░Вр░Чр░░р░╛р░▓ р░Ьр▒Бр░Яр▒Нр░Яр▒Б, р░Йр░Вр░Чр░░р░╛р░▓р▒Б, р░░р░┐р░Вр░Чр▒Бр░▓ р░Ьр▒Бр░Яр▒Нр░Яр▒Б
ЁЯж│	р░Ьр▒Бр░Яр▒Нр░Яр▒Б, р░др▒Жр░▓р▒Бр░кр▒Б, р░др▒Жр░▓р▒Нр░▓р░Ьр▒Бр░Яр▒Нр░Яр▒Б, р░ир▒Жр░░р░┐р░╕р░┐р░кр▒Лр░╡р░бр░В, р░ор▒Бр░╕р░▓р░┐р░др░ир░В
ЁЯж▓	р░Хр▒Ар░ор▒Лр░ер▒Жр░░р░кр▒А, р░Ьр▒Бр░Яр▒Нр░Яр▒Б р░░р░╛р░▓р░┐р░кр▒Лр░╡р░бр░В, р░Ьр▒Бр░Яр▒Нр░Яр▒Б р░▓р▒Зр░жр▒Б, р░мр░Яр▒Нр░Яр░др░▓, р░мр▒Лр░бр░┐ р░Ър▒Зр░╕р░╛р░░р▒Б
ЁЯТЛ	р░Чр▒Бр░░р▒Нр░др▒Б, р░ор▒Бр░жр▒Нр░жр▒Б, р░ор▒Бр░жр▒Нр░жр▒Б р░Чр▒Бр░░р▒Нр░др▒Б
ЁЯТШ	р░мр░╛р░гр░В, р░╣р▒Гр░жр░пр░В, р░╣р▒Гр░жр░пр░╛р░Хр░╛р░░р░Вр░▓р▒Л р░мр░╛р░гр░В
ЁЯТЭ	р░░р░┐р░мр▒Нр░мр░ир▒Н, р░░р░┐р░мр▒Нр░мр░ир▒НтАМр░др▒Л р░Йр░ир▒Нр░и р░╣р▒Гр░жр░пр░В, р░╣р▒Гр░жр░пр░В
ЁЯТЦ	р░ор▒Жр░░р▒Бр░кр▒Б, р░ор▒Жр░░р▒Бр░╕р▒Нр░др▒Бр░ир▒Нр░и р░╣р▒Гр░жр░пр░В, р░╣р▒Гр░жр░пр░В
ЁЯТЧ	р░кр▒Жр░░р▒Бр░Чр▒Б, р░╕р▒Нр░кр░Вр░жр░┐р░╕р▒Нр░др▒Бр░ир▒Нр░и р░╣р▒Гр░жр░пр░В, р░╣р▒Гр░жр░пр░В
ЁЯТУ	р░╕р▒Нр░кр░Вр░жр░┐р░Вр░Ър░бр░В, р░╕р▒Нр░кр░Вр░жр░┐р░Вр░Ър▒З р░╣р▒Гр░жр░пр░В, р░╣р▒Гр░жр░пр░В
ЁЯТЮ	р░др░┐р░░р▒Бр░Чр▒Б, р░др░┐р░░р▒Бр░Чр▒Бр░др▒Бр░ир▒Нр░и р░╣р▒Гр░жр░пр░╛р░▓р▒Б, р░╣р▒Гр░жр░пр░В
ЁЯТХ	р░░р▒Жр░Вр░бр▒Б, р░░р▒Жр░Вр░бр▒Б р░╣р▒Гр░жр░пр░╛р░▓р▒Б, р░╣р▒Гр░жр░пр░В
ЁЯТМ	р░кр▒Нр░░р▒Зр░о, р░кр▒Нр░░р▒Зр░о р░▓р▒Зр░Ц, р░▓р▒Зр░Ц
ЁЯТФ	р░Чр░╛р░пр░В, р░Чр░╛р░пр░кр░бр░┐р░и р░╣р▒Гр░жр░пр░В, р░╣р▒Гр░жр░пр░В
ЁЯзб	р░Жр░░р▒Жр░Вр░Ьр▒Н, р░ир░╛р░░р░┐р░Вр░Ь р░░р░Вр░Чр▒Б р░╣р▒Гр░жр░пр░В
ЁЯТЫ	р░кр░╕р▒Бр░кр▒Б р░кр░Ър▒Нр░Ъ, р░кр░╕р▒Бр░кр▒Б р░кр░Ър▒Нр░Ъ р░░р░Вр░Чр▒Б р░╣р▒Гр░жр░пр░В, р░╣р▒Гр░жр░пр░В
ЁЯТЪ	р░Жр░Хр▒Бр░кр░Ър▒Нр░Ъ, р░Жр░Хр▒Бр░кр░Ър▒Нр░Ъ р░░р░Вр░Чр▒Б р░╣р▒Гр░жр░пр░В, р░╣р▒Гр░жр░пр░В
ЁЯТЩ	р░ир▒Ар░▓р░В, р░ир▒Ар░▓р░В р░░р░Вр░Чр▒Б р░╣р▒Гр░жр░пр░В, р░╣р▒Гр░жр░пр░В
ЁЯТЬ	р░Кр░жр░╛, р░Кр░жр░╛ р░░р░Вр░Чр▒Б р░╣р▒Гр░жр░пр░В, р░╣р▒Гр░жр░пр░В
ЁЯЦд	р░Ър▒Жр░бр▒Б, р░ир░▓р▒Бр░кр▒Б, р░ир░▓р▒Бр░кр▒Б р░░р░Вр░Чр▒Б р░╣р▒Гр░жр░пр░В, р░ор▒Лр░╕р░кр▒Вр░░р░┐р░д, р░╣р▒Гр░жр░пр░В
ЁЯТЯ	р░Ер░▓р░Вр░Хр░░р░г, р░╣р▒Гр░жр░п р░Ер░▓р░Вр░Хр░░р░г, р░╣р▒Гр░жр░пр░В
ЁЯТд	р░Чр▒Бр░░р░Х, р░Чр▒Бр░░р░Х р░Чр▒Бр░░р▒Нр░др▒Б, р░Чр▒Бр░░р▒Нр░др▒Б
ЁЯТв	р░Хр▒Лр░кр░В, р░Хр▒Лр░кр░╛р░ир░┐р░Хр░┐ р░Ър░┐р░╣р▒Нр░ир░В
ЁЯТе	р░Хр░╛р░ор░┐р░Хр▒Н, р░вр▒Ар░Хр▒Кр░ир░бр░В, р░кр▒Зр░▓р░бр░В
ЁЯТж	р░╕р▒Нр░╡р▒Зр░жр░В, р░╕р▒Нр░╡р▒Зр░жр░В р░Хр░╛р░░р▒Бр░др▒Бр░ир▒Нр░и р░Ър░┐р░╣р▒Нр░ир░В
ЁЯТи	р░кр░░р▒Бр░Чр▒Б, р░╡р▒Зр░Чр░В, р░╡р▒Зр░Чр░Вр░Чр░╛ р░кр░░р░┐р░Чр▒Жр░др▒Нр░др░бр░В
ЁЯТл	р░Хр░│р▒Нр░▓р▒Б р░др░┐р░░р░Чр░бр░В, р░Ър▒Вр░бр░Яр░В, р░ир░Хр▒Нр░╖р░др▒Нр░░р░В, р░ир░Хр▒Нр░╖р░др▒Нр░░р░╛р░▓р░ир▒Б р░Ър▒Вр░бр░Яр░В
ЁЯТм	р░бр▒Ир░▓р░╛р░Чр▒Н, р░бр▒Ир░▓р░╛р░Чр▒Н р░мр▒Бр░бр░Ч, р░мр▒Бр░бр░Ч
ЁЯТн	р░Жр░▓р▒Лр░Ър░и, р░Жр░▓р▒Лр░Ър░и р░мр▒Бр░бр░Ч, р░мр▒Бр░бр░Ч
ЁЯе╜	р░Ир░д, р░Хр░Вр░Яр░┐ р░░р░Хр▒Нр░╖р░г, р░Чр░╛р░Чр▒Бр░▓р▒Нр░╕р▒Н, р░╡р▒Жр░▓р▒Нр░бр░┐р░Вр░Чр▒Н
ЁЯе╝	р░кр▒Нр░░р░пр▒Лр░Чр░В, р░▓р▒Нр░пр░╛р░мр▒Н р░Хр▒Лр░Яр▒Б, р░╡р▒Ир░жр▒Нр░пр▒Бр░▓р▒Б, р░╢р░╛р░╕р▒Нр░др▒Нр░░р░╡р▒Зр░др▒Нр░д
ЁЯСФ	р░Яр▒И, р░ир▒Жр░Хр▒Н, р░ир▒Жр░Хр▒Н р░Яр▒И
ЁЯСХ	р░Ър▒Кр░Хр▒Нр░Хр░╛, р░Яр▒А р░╖р░░р▒Нр░Яр▒Н
ЁЯСЦ	р░Ьр▒Ар░ир▒Нр░╕р▒Н, р░Ьр▒Ар░ир▒Нр░╕р▒Н р░кр▒Нр░пр░╛р░Вр░Яр▒Н, р░кр▒Нр░пр░╛р░Вр░Яр▒Н
ЁЯзг	р░ор▒Жр░б, р░ор▒Жр░бр░Хр▒Б р░Хр░Яр▒Нр░Яр▒Бр░Хр▒Бр░ир▒З р░╡р░╕р▒Нр░др▒Нр░░р░В
ЁЯзд	р░Ър▒Зр░др░┐, р░Ър▒Зр░др░┐ р░др▒Кр░бр▒Бр░Чр▒Бр░▓р▒Б
ЁЯзе	р░Хр▒Лр░Яр▒Б, р░Ьр░╛р░Хр▒Жр░Яр▒Н
ЁЯзж	р░ор▒Зр░Ьр▒Лр░бр▒Б, р░╕р░╛р░Хр▒Нр░╕р▒Н
ЁЯСЧ	р░жр▒Бр░╕р▒Нр░др▒Бр░▓р▒Б
ЁЯСШ	р░Ьр░кр░╛р░ир▒Н, р░Ьр░кр░╛р░ир▒Н р░жр▒Зр░╢р▒Ар░пр▒Бр░▓р▒Б р░Йр░кр░пр▒Лр░Чр░┐р░Вр░Ър▒З р░жр▒Бр░╕р▒Нр░др▒Бр░▓р▒Б, р░жр▒Бр░╕р▒Нр░др▒Бр░▓р▒Б
ЁЯСЩ	р░Ир░д, р░Ир░д р░жр▒Бр░╕р▒Нр░др▒Бр░▓р▒Б, р░жр▒Бр░╕р▒Нр░др▒Бр░▓р▒Б
ЁЯСЪ	р░Жр░бр░╡р░╛р░│р▒Нр░▓ р░жр▒Бр░╕р▒Нр░др▒Бр░▓р▒Б, р░Жр░бр░╡р░╛р░│р▒Нр░▓р▒Б, р░жр▒Бр░╕р▒Нр░др▒Бр░▓р▒Б
ЁЯСЫ	р░Жр░бр░╡р░╛р░│р▒Нр░▓ р░кр░░р▒Нр░╕р▒Б, р░Жр░бр░╡р░╛р░│р▒Нр░▓р▒Б, р░кр░░р▒Нр░╕р▒Б
ЁЯСЬ	р░Жр░бр░╡р░╛р░│р▒Нр░▓ р░╣р▒Нр░пр░╛р░Вр░бр▒Н р░мр▒Нр░пр░╛р░Чр▒Н, р░Жр░бр░╡р░╛р░│р▒Нр░▓р▒Б, р░мр▒Нр░пр░╛р░Чр▒Н
ЁЯСЭ	р░кр▒Мр░Ър▒Н, р░мр▒Нр░пр░╛р░Чр▒Н, р░ор░Чр░╡р░╛р░│р▒Нр░▓ р░кр░░р▒Нр░╕р▒Б
ЁЯОТ	р░мр▒Нр░пр░╛р░Чр▒Н, р░╕р▒Нр░Хр▒Вр░▓р▒Н, р░╕р▒Нр░Хр▒Вр░▓р▒Н р░мр▒Нр░пр░╛р░Чр▒Н
ЁЯСЮ	р░кр▒Бр░░р▒Бр░╖р▒Бр░бр▒Б, р░ор░Чр░╡р░╛р░│р▒Нр░▓ р░мр▒Вр░Яр▒Нр░▓р▒Б, р░╖р▒В
ЁЯСЯ	р░Хр▒Нр░░р▒Ар░бр░╛, р░Хр▒Нр░░р▒Ар░бр░╛р░Хр░╛р░░р▒Бр░▓ р░мр▒Вр░Яр▒Нр░▓р▒Б, р░╖р▒В
ЁЯе╛	р░Хр▒Нр░пр░╛р░Вр░кр░┐р░Вр░Чр▒Н, р░мр▒Вр░Яр▒Нр░▓р▒Б, р░мр▒Нр░пр░╛р░Чр▒НтАМр░кр▒Нр░пр░╛р░Хр▒Н, р░╣р▒Ир░Хр░┐р░Вр░Чр▒Н, р░╣р▒Ир░Хр░┐р░Вр░Чр▒Н р░мр▒Вр░Яр▒Нр░▓р▒Б
ЁЯе┐	р░лр▒Нр░▓р░╛р░Яр▒Н р░╖р▒В, р░мр▒Нр░пр░╛р░▓р▒Жр░Яр▒Н р░лр▒Нр░▓р░╛р░Яр▒Н, р░╕р▒Нр░▓р░┐р░кр▒Н-р░Жр░ир▒Н, р░╕р▒Нр░▓р░┐р░кр▒Нр░кр░░р▒Н
ЁЯСа	р░Ър▒Жр░кр▒Нр░кр▒Бр░▓р▒Б, р░╕р▒Нр░др▒Нр░░р▒А, р░╕р▒Нр░др▒Нр░░р▒Ар░▓ р░Ор░др▒Нр░др▒Б р░Ър▒Жр░кр▒Нр░кр▒Бр░▓р▒Б
ЁЯСб	р░Ър▒Жр░кр▒Нр░кр▒Бр░▓р▒Б, р░╕р▒Нр░др▒Нр░░р▒А, р░╕р▒Нр░др▒Нр░░р▒Ар░▓ р░Ър▒Жр░кр▒Нр░кр▒Бр░▓р▒Б
ЁЯСв	р░мр▒Вр░Яр▒Нр░▓р▒Б, р░╕р▒Нр░др▒Нр░░р▒А, р░╕р▒Нр░др▒Нр░░р▒Ар░▓ р░мр▒Вр░Яр▒Нр░▓р▒Б
ЁЯСС	р░Хр░┐р░░р▒Ар░Яр░В, р░жр▒Бр░╕р▒Нр░др▒Бр░▓р▒Б, р░░р░╛р░Ьр▒Б, р░░р░╛р░гр░┐
ЁЯСТ	р░Жр░бр░╡р░╛р░│р▒Нр░▓ р░Яр▒Лр░кр▒А, р░Жр░бр░╡р░╛р░│р▒Нр░▓р▒Б, р░Яр▒Лр░кр▒А
ЁЯОй	р░Зр░Вр░жр▒Нр░░р░Ьр░╛р░▓р░В, р░Зр░Вр░жр▒Нр░░р░Ьр░╛р░▓р░┐р░Хр▒Бр░ир░┐ р░Яр▒Лр░кр▒А, р░Яр▒Лр░кр▒А
ЁЯзв	р░мр░┐р░▓р▒Жр░бр▒Н р░Яр▒Лр░кр▒А, р░мр▒Зр░╕р▒НтАМр░мр░╛р░▓р▒Н р░Хр▒Нр░пр░╛р░кр▒Н
ЁЯУ┐	р░Ьр░кр░ор░╛р░▓, р░Ьр░кр░ор░╛р░▓ р░кр▒Вр░╕р░▓р▒Б, р░кр▒Вр░╕
ЁЯТД	р░Ер░▓р░Вр░Хр░░р░г, р░Хр░╛р░╕р▒Нр░ор▒Лр░Яр░┐р░Хр▒Нр░╕р▒Н, р░▓р░┐р░кр▒НтАМр░╕р▒Нр░Яр░┐р░Хр▒Н
ЁЯТН	р░Ер░Вр░Чр▒Бр░│р▒Ар░Хр░В, р░Йр░Вр░Чр░░р░В
ЁЯТО	р░░р░╛р░пр░┐, р░╡р░Ьр▒Нр░░р░В
ЁЯР╡	р░Хр▒Лр░др░┐, р░Хр▒Лр░др░┐ р░ор▒Бр░Цр░В, р░ор▒Бр░Цр░В
ЁЯРТ	р░Хр▒Лр░др░┐, р░Ьр░Вр░др▒Бр░╡р▒Б
ЁЯжН	р░Чр▒Кр░░р░┐р░▓р▒Нр░▓р░╛, р░Ьр░Вр░др▒Бр░╡р▒Б
ЁЯР╢	р░Хр▒Бр░Хр▒Нр░Х, р░Хр▒Бр░Хр▒Нр░Х р░ор▒Бр░Цр░В, р░ор▒Бр░Цр░В
ЁЯРй	р░Хр▒Бр░Хр▒Нр░Х, р░кр▒Вр░бр░┐р░▓р▒Н, р░кр▒Вр░бр░┐р░▓р▒Н р░Хр▒Бр░Хр▒Нр░Х
ЁЯР║	р░др▒Лр░бр▒Зр░▓р▒Б, р░др▒Лр░бр▒Зр░▓р▒Б р░ор▒Бр░Цр░В, р░ор▒Бр░Цр░В
ЁЯжК	р░Ьр░Вр░др▒Бр░╡р▒Б, р░ир░Хр▒Нр░Х, р░ир░Хр▒Нр░Х р░ор▒Бр░Цр░В, р░ор▒Бр░Цр░В
ЁЯжЭ	р░Йр░др▒Нр░╕р▒Бр░Хр░д, р░Хр▒Бр░пр▒Бр░Хр▒Нр░др░┐, р░░р░Хр▒Нр░Хр▒Вр░ир▒Н
ЁЯР▒	р░кр░┐р░▓р▒Нр░▓р░┐, р░кр░┐р░▓р▒Нр░▓р░┐ р░ор▒Бр░Цр░В, р░ор▒Бр░Цр░В
ЁЯжБ	р░ор▒Бр░Цр░В, р░╕р░┐р░Вр░╣р░В, р░╕р░┐р░Вр░╣р░В р░ор▒Бр░Цр░В
ЁЯРп	р░кр▒Бр░▓р░┐, р░кр▒Бр░▓р░┐ р░ор▒Бр░Цр░В, р░ор▒Бр░Цр░В
ЁЯРЕ	р░Ьр░Вр░др▒Бр░╡р▒Б, р░кр▒Бр░▓р░┐
ЁЯРЖ	р░Ър░┐р░░р▒Бр░др░кр▒Бр░▓р░┐, р░Ьр░Вр░др▒Бр░╡р▒Б
ЁЯР┤	р░Чр▒Бр░░р▒Нр░░р░В, р░Чр▒Бр░░р▒Нр░░р░В р░ор▒Бр░Цр░В, р░ор▒Бр░Цр░В
ЁЯРО	р░Чр▒Бр░░р▒Нр░░р░В, р░Ьр░Вр░др▒Бр░╡р▒Б
ЁЯжД	р░Тр░Вр░Яр░┐ р░Хр▒Кр░ор▒Нр░ор▒Б, р░Тр░Вр░Яр░┐ р░Хр▒Кр░ор▒Нр░ор▒Б р░Чр▒Бр░░р▒Нр░░р░В р░ор▒Бр░Цр░В, р░Чр▒Бр░░р▒Нр░░р░В, р░ор▒Бр░Цр░В
ЁЯжУ	р░Ър░╛р░░р░▓р░Чр▒Бр░░р▒Нр░░р░В, р░Ър░╛р░░р░▓р▒Б
ЁЯжМ	р░Ьр░Вр░др▒Бр░╡р▒Б, р░Ьр░┐р░Вр░Х
ЁЯРо	р░Жр░╡р▒Б, р░Жр░╡р▒Б р░ор▒Бр░Цр░В, р░ор▒Бр░Цр░В
ЁЯРВ	р░Ор░жр▒Нр░жр▒Б, р░Ьр░Вр░др▒Бр░╡р▒Б
ЁЯРГ	р░Чр▒Зр░жр▒Ж, р░ир▒Ар░Яр░┐ р░Чр▒Зр░жр▒Ж, р░ир▒Ар░░р▒Б
ЁЯРД	р░Жр░╡р▒Б, р░Ьр░Вр░др▒Бр░╡р▒Б
ЁЯР╖	р░кр░Вр░жр░┐, р░кр░Вр░жр░┐ р░ор▒Бр░Цр░В, р░ор▒Бр░Цр░В
ЁЯРЦ	р░Ьр░Вр░др▒Бр░╡р▒Б, р░кр░Вр░жр░┐
ЁЯРЧ	р░Ьр░Вр░др▒Бр░╡р▒Б, р░ор░Ч р░кр░Вр░жр░┐
ЁЯР╜	р░кр░Вр░жр░┐, р░кр░Вр░жр░┐ р░ор▒Бр░Хр▒Нр░Хр▒Б, р░ор▒Бр░Хр▒Нр░Хр▒Б
ЁЯРП	р░Ьр░Вр░др▒Бр░╡р▒Б, р░кр▒Кр░Яр▒Нр░Яр▒Зр░▓р▒Б
ЁЯРС	р░Чр▒Кр░░р▒Нр░░р▒Ж, р░Ьр░Вр░др▒Бр░╡р▒Б
ЁЯРР	р░Ьр░Вр░др▒Бр░╡р▒Б, р░ор▒Зр░Х
ЁЯРк	р░Тр░Вр░Яр▒Ж, р░Тр░Х р░ор▒Вр░кр▒Бр░░р░В р░Йр░Вр░бр▒З р░Тр░Вр░Яр▒Ж, р░Ьр░Вр░др▒Бр░╡р▒Б, р░мр▒Зр░Чр░┐р░░р░╛р░╡р▒Б, р░ор▒Вр░кр▒Бр░░р░В
ЁЯРл	р░Тр░Вр░Яр▒Ж, р░Ьр░Вр░др▒Бр░╡р▒Б, р░мр▒Нр░пр░╛р░Хр▒Нр░Яр▒Нр░░р░┐р░пр░ир▒Н, р░ор▒Вр░кр▒Бр░░р░В, р░░р▒Жр░Вр░бр▒Б р░ор▒Вр░кр▒Бр░░р░╛р░▓р▒Б р░Йр░Вр░бр▒З р░Тр░Вр░Яр▒Ж
ЁЯжЩ	р░Жр░▓р▒Нр░кр░╛р░Хр░╛, р░Йр░ир▒Нр░ир░┐, р░Кр░▓р▒Б, р░Чр▒Нр░╡р░╛р░ир░Хр▒Л, р░▓р░╛р░ор░╛
ЁЯжТ	р░Ър▒Бр░Хр▒Нр░Хр░▓р▒Б, р░Ьр░┐р░░р░╛р░лр▒А
ЁЯРШ	р░Пр░ир▒Бр░Чр▒Б, р░Ьр░Вр░др▒Бр░╡р▒Б
ЁЯжП	р░Цр░бр▒Нр░Чр░ор▒Гр░Чр░В, р░Ьр░Вр░др▒Бр░╡р▒Б
ЁЯжЫ	р░╣р░┐р░кр▒Нр░кр▒Л, р░╣р░┐р░кр▒Нр░кр▒Лр░кр▒Кр░Яр░╛р░ор░╕р▒Н
ЁЯРн	р░Ор░▓р▒Бр░Х, р░Ор░▓р▒Бр░Х р░ор▒Бр░Цр░В, р░ор▒Бр░Цр░В
ЁЯРБ	р░Ър▒Бр░Вр░Ър▒Жр░▓р▒Бр░Х, р░Ьр░Вр░др▒Бр░╡р▒Б
ЁЯРА	р░Ор░▓р▒Бр░Х, р░Ьр░Вр░др▒Бр░╡р▒Б
ЁЯР╣	р░Ър░┐р░Яр▒Нр░Яр▒Жр░▓р▒Бр░Х, р░Ър░┐р░Яр▒Нр░Яр▒Жр░▓р▒Бр░Х р░ор▒Бр░Цр░В, р░ор▒Бр░Цр░В
ЁЯР░	р░Хр▒Бр░Вр░жр▒Зр░▓р▒Б, р░Хр▒Бр░Вр░жр▒Зр░▓р▒Б р░ор▒Бр░Цр░В, р░ор▒Бр░Цр░В
ЁЯРЗ	р░Хр▒Бр░Вр░жр▒Зр░▓р▒Б, р░Хр▒Бр░Вр░жр▒Зр░▓р▒Б р░кр░┐р░▓р▒Нр░▓, р░Ьр░Вр░др▒Бр░╡р▒Б
ЁЯжФ	р░ор▒Бр░Вр░бр▒Нр░▓р░кр░Вр░жр░┐, р░╕р▒Нр░кр▒Ир░ир▒А
ЁЯжЗ	р░Чр░мр▒Нр░мр░┐р░▓р░В, р░Ьр░Вр░др▒Бр░╡р▒Б, р░╡р░╛р░Вр░кр▒Ир░░р▒Н
ЁЯР╗	р░Ор░▓р▒Бр░Чр▒Бр░мр░Вр░Яр░┐, р░Ор░▓р▒Бр░Чр▒Бр░мр░Вр░Яр░┐ р░ор▒Бр░Цр░В, р░ор▒Бр░Цр░В
ЁЯРи	р░Хр▒Лр░▓р░╛, р░Хр▒Лр░▓р░╛ р░Ор░▓р▒Бр░Чр▒Бр░мр░Вр░Яр░┐, р░Ьр░Вр░др▒Бр░╡р▒Б
ЁЯР╝	р░кр░╛р░Вр░бр░╛, р░кр░╛р░Вр░бр░╛ р░ор▒Бр░Цр░В, р░ор▒Бр░Цр░В
ЁЯжШ	р░Жр░╕р▒Нр░Яр▒Нр░░р▒Зр░▓р░┐р░пр░╛, р░Хр░Вр░Чр░╛р░░р▒В, р░Хр░бр▒Бр░кр▒Бр░╕р░Вр░Ър░┐р░▓р▒Л р░кр░┐р░▓р▒Нр░▓р░▓р░ир▒Б р░кр▒Жр░Яр▒Нр░Яр▒Бр░Хр▒Бр░ир▒З р░Ьр▒Ар░╡р░┐, р░Чр▒Жр░Вр░др░бр░В, р░Ьр▒Лр░пр▒Н
ЁЯжб	р░кр▒Жр░╕р▒Нр░Яр░░р▒Н, р░мр▒Нр░пр░╛р░бр▒Нр░Ьр░░р▒Н, р░╣р░ир▒А р░мр▒Нр░пр░╛р░бр▒Нр░Ьр░░р▒Н
ЁЯР╛	р░кр░Вр░Ьр░╛, р░кр░Вр░Ьр░╛ р░ор▒Бр░жр▒Нр░░р░▓р▒Б, р░ор▒Бр░жр▒Нр░░
ЁЯжГ	р░Яр░░р▒Нр░Хр▒А, р░Яр░░р▒Нр░Хр▒А р░Хр▒Лр░бр░┐, р░кр░Хр▒Нр░╖р░┐
ЁЯРФ	р░Хр▒Лр░бр░┐р░кр░┐р░▓р▒Нр░▓, р░Хр▒Лр░бр░┐р░кр▒Жр░Яр▒Нр░Я, р░Ьр░Вр░др▒Бр░╡р▒Б
ЁЯРУ	р░Хр▒Лр░бр░┐р░кр▒Бр░Вр░Ьр▒Б, р░Ьр░Вр░др▒Бр░╡р▒Б
ЁЯРг	р░Хр▒Лр░бр░┐р░кр░┐р░▓р▒Нр░▓, р░Чр▒Бр░бр▒Нр░бр▒Б, р░Чр▒Бр░бр▒Нр░бр▒Б р░ир▒Бр░Вр░бр░┐ р░кр▒Кр░жр░Чр░мр░бр░┐р░и р░Хр▒Лр░бр░┐р░кр░┐р░▓р▒Нр░▓, р░кр▒Кр░жр░Чр░бр░В
ЁЯРд	р░Хр▒Лр░бр░┐ р░кр░┐р░▓р▒Нр░▓, р░Хр▒Лр░бр░┐р░кр░┐р░▓р▒Нр░▓, р░Ьр░Вр░др▒Бр░╡р▒Б
ЁЯРе	р░Хр▒Лр░бр░┐р░кр░┐р░▓р▒Нр░▓, р░ор▒Бр░Цр░В, р░ор▒Бр░Цр░В р░Хр░ир░┐р░кр░┐р░Вр░Ър▒З р░Хр▒Лр░бр░┐р░кр░┐р░▓р▒Нр░▓
ЁЯРз	р░Ьр░Вр░др▒Бр░╡р▒Б, р░кр▒Жр░Вр░Чр▒Нр░╡р░┐р░ир▒Н
ЁЯжЕ	р░Чр░жр▒Нр░ж, р░кр░Хр▒Нр░╖р░┐
ЁЯжЖ	р░кр░Хр▒Нр░╖р░┐, р░мр░╛р░др▒Б
ЁЯжв	р░Ер░Чр▒Нр░▓р▒А р░бр░Хр▒Нр░▓р░┐р░Вр░Чр▒Н, р░кр░Хр▒Нр░╖р░┐, р░╕р░┐р░Чр▒Нр░ир▒Жр░Яр▒Н, р░╣р░Вр░╕
ЁЯжЙ	р░Чр▒Бр░бр▒Нр░▓р░Чр▒Вр░м, р░др▒Жр░▓р░┐р░╡р▒Ир░и, р░кр░Хр▒Нр░╖р░┐
ЁЯжЪ	р░Чр░░р▒Нр░╡р░В, р░бр░╛р░мр▒Бр░╕р░░р░┐, р░ир▒Жр░ор░▓р░┐, р░кр░Хр▒Нр░╖р░┐, р░кр▒Ар░╣р▒Жр░ир▒Н
ЁЯжЬ	р░Ър░┐р░▓р▒Бр░Х, р░кр░Хр▒Нр░╖р░┐, р░кр▒Ир░░р▒Зр░Яр▒Н, р░ор░╛р░Яр░▓р▒Б
ЁЯР╕	р░Хр░кр▒Нр░к, р░Хр░кр▒Нр░к р░ор▒Бр░Цр░В, р░ор▒Бр░Цр░В
ЁЯРК	р░Ьр░Вр░др▒Бр░╡р▒Б, р░ор▒Кр░╕р░▓р░┐
ЁЯРв	р░Ьр░Вр░др▒Бр░╡р▒Б, р░др░╛р░мр▒Зр░▓р▒Б
ЁЯжО	р░мр░▓р▒Нр░▓р░┐, р░╕р░░р▒Ар░╕р▒Гр░кр░В
ЁЯРН	р░Ьр░Вр░др▒Бр░╡р▒Б, р░кр░╛р░ор▒Б, р░╕р░░р▒Нр░кр░В
ЁЯР▓	р░ор▒Бр░Цр░В, р░░р▒Жр░Хр▒Нр░Хр░▓р▒Б, р░░р▒Жр░Хр▒Нр░Хр░▓р▒Б р░Чр░▓ р░нр░пр░Вр░Хр░░ р░╕р░░р▒Нр░к р░ор▒Бр░Цр░В, р░╕р░░р▒Нр░кр░В
ЁЯРЙ	р░░р▒Жр░Хр▒Нр░Хр░▓р▒Б, р░░р▒Жр░Хр▒Нр░Хр░▓р▒Б р░Чр░▓ р░нр░пр░Вр░Хр░░ р░╕р░░р▒Нр░кр░В, р░╕р░░р▒Нр░кр░В
ЁЯжХ	р░бр░┐р░кр▒Нр░▓р▒Лр░бр▒Лр░Хр░╕р▒Н, р░мр▒Нр░░р░╛р░Вр░Ър▒Ар░пр▒Лр░╕р░╛р░░р░╕р▒Н, р░мр▒Нр░░р▒Лр░Вр░Яр▒Лр░╕р░╛р░░р░╕р▒Н, р░╕р░╛р░░р░кр░╛р░бр▒Н, р░╕р▒Мр░░р▒Лр░кр▒Лр░бр░╛
ЁЯжЦ	р░Яр░┐-р░░р▒Жр░Хр▒Нр░╕р▒Н, р░Яр▒Ир░░р░╛р░ир▒Лр░╕р░╛р░░р░╕р▒Н р░░р▒Жр░Хр▒Нр░╕р▒Н
ЁЯР│	р░ир▒Ар░│р▒Нр░▓р▒Б, р░ир▒Ар░│р▒Нр░▓р▒Б р░Ор░Чр░Ьр░┐р░ор▒Нр░ор▒З р░др░┐р░ор░┐р░Вр░Чр░▓р░В, р░ор▒Бр░Цр░В
ЁЯРЛ	р░Ьр░Вр░др▒Бр░╡р▒Б, р░др░┐р░ор░┐р░Вр░Чр░▓р░В, р░др░┐р░ор░┐р░Вр░Чр░│р░В
ЁЯРм	р░Ьр░Вр░др▒Бр░╡р▒Б, р░бр░╛р░▓р▒Нр░лр░┐р░ир▒Н
ЁЯРа	р░Ер░пр░ир░╡р▒Гр░др▒Нр░др▒Ар░п р░Ър▒Зр░к, р░Ер░пр░ир░╡р▒Гр░др▒Нр░др▒Ар░пр░В, р░Ър▒Зр░к
ЁЯРб	р░Ър▒Зр░к, р░Ьр░Вр░др▒Бр░╡р▒Б, р░ор▒Бр░│р▒Нр░▓р░Ър▒Зр░к
ЁЯжИ	р░Ър▒Зр░к, р░╕р▒Кр░░р░Ър▒Зр░к
ЁЯРЩ	р░Жр░Хр▒Нр░Яр▒Лр░кр░╕р▒Н, р░Ор░ир░┐р░ор░┐р░жр░┐ р░Хр░╛р░│р▒Нр░▓ р░╕р░ор▒Бр░жр▒Нр░░ р░Ьр░Вр░др▒Бр░╡р▒Б, р░Ьр░Вр░др▒Бр░╡р▒Б
ЁЯРЪ	р░Чр▒Бр░▓р▒Нр░▓, р░Ьр░Вр░др▒Бр░╡р▒Б, р░╢р░Вр░Цр░╛р░Хр▒Гр░др░┐ р░Чр░╡р▒Нр░╡, р░╢р░Вр░Цр░╛р░Хр▒Гр░др░┐ р░Чр▒Бр░▓р▒Нр░▓
ЁЯжА	р░Ор░Вр░бр▒Нр░░р░Хр░╛р░п, р░Хр░░р▒Нр░Хр░╛р░Яр░Хр░В, р░кр▒Ар░д, р░░р░╛р░╢р░┐
ЁЯжЮ	р░Чр▒Лр░│р▒Нр░▓р▒Б, р░мр░┐р░╕р▒Нр░Хр▒Н, р░▓р░╛р░мр▒НтАМр░╕р▒Нр░Яр░░р▒Н, р░╕р░ор▒Бр░жр▒Нр░░р░кр▒Б р░Жр░╣р░╛р░░р░В
ЁЯжР	р░Жр░╣р░╛р░░р░В, р░Ър░┐р░ир▒Нр░и, р░░р▒Кр░пр▒Нр░п, р░╖р▒Жр░▓р▒НтАМр░лр░┐р░╖р▒Н
ЁЯжС	р░Жр░╣р░╛р░░р░В, р░╖р▒Жр░▓р▒НтАМр░лр░┐р░╖р▒Н, р░╕р▒Нр░Хр▒Нр░╡р░┐р░бр▒Н
ЁЯРМ	р░Ьр░Вр░др▒Бр░╡р▒Б, р░ир░др▒Нр░д
ЁЯжЛ	р░Ер░Вр░жр░В, р░Хр▒Ар░Яр░Хр░В, р░╕р▒Ар░др░╛р░Хр▒Лр░Хр░Ър░┐р░▓р▒Бр░Х
ЁЯРЫ	р░Хр░╛р░│р▒Нр░▓р░Ьр░░р▒Нр░░р░┐, р░Чр▒Кр░Вр░Чр░│р░┐ р░кр▒Бр░░р▒Бр░Чр▒Б, р░Ьр░Вр░др▒Бр░╡р▒Б, р░ир░▓р▒Нр░▓р░┐
ЁЯРЬ	р░Ър▒Ар░о, р░Ьр░Вр░др▒Бр░╡р▒Б
ЁЯРЭ	р░Ьр░Вр░др▒Бр░╡р▒Б, р░др▒Бр░ор▒Нр░ор▒Жр░ж, р░др▒Зр░ир▒Жр░Яр▒Ар░Ч
ЁЯРЮ	р░Ьр░Вр░др▒Бр░╡р▒Б, р░кр▒Зр░бр░кр▒Бр░░р▒Бр░Чр▒Б
ЁЯжЧ	р░Ър░┐р░ор▒Нр░ор░Я, р░ор░┐р░бр░д
ЁЯжВ	р░др▒Зр░▓р▒Б, р░░р░╛р░╢р░┐, р░╡р▒Гр░╢р▒Нр░Ър░┐р░Хр░░р░╛р░╢р░┐
ЁЯжЯ	р░Хр▒Ар░Яр░Хр░В, р░Ьр▒Нр░╡р░░р░В, р░жр▒Лр░о, р░ор░▓р▒Зр░░р░┐р░пр░╛, р░╡р▒Ир░░р░╕р▒Н, р░╡р▒Нр░пр░╛р░зр░┐
ЁЯжа	р░Ер░ор▒Ар░мр░╛, р░мр▒Нр░пр░╛р░Хр▒Нр░Яр▒Ар░░р░┐р░пр░╛, р░╡р▒Ир░░р░╕р▒Н, р░╕р▒Вр░Хр▒Нр░╖р▒Нр░ор░Хр▒Нр░░р░┐р░ор░┐
ЁЯТР	р░Чр▒Бр░др▒Нр░др░┐, р░кр▒Вр░▓р░Чр▒Бр░др▒Нр░др░┐, р░кр▒Вр░▓р▒Б
ЁЯМ╕	р░Ър▒Жр░░р▒Нр░░р▒А, р░Ър▒Жр░░р▒Нр░░р▒А р░кр▒Бр░╡р▒Нр░╡р▒Б, р░кр▒Бр░╡р▒Нр░╡р▒Б
ЁЯТо	р░др▒Жр░▓р▒Бр░кр▒Б, р░др▒Жр░▓р▒Нр░▓р░ир░┐ р░кр▒Бр░╖р▒Нр░кр░В, р░кр▒Бр░╡р▒Нр░╡р▒Б
ЁЯМ╣	р░Чр▒Бр░▓р░╛р░мр░┐ р░кр▒Бр░╡р▒Нр░╡р▒Б, р░кр▒Бр░╡р▒Нр░╡р▒Б, р░ор▒Кр░Хр▒Нр░Х, р░░р▒Лр░Ьр░╛ р░кр▒Бр░╡р▒Нр░╡р▒Б
ЁЯеА	р░кр▒Бр░╡р▒Нр░╡р▒Б, р░╡р░╛р░▓р░┐р░кр▒Лр░пр░┐р░и, р░╡р░╛р░▓р░┐р░кр▒Лр░пр░┐р░и р░кр▒Бр░╡р▒Нр░╡р▒Б
ЁЯМ║	р░Ор░░р▒Нр░░ р░░р░Вр░Чр▒Б р░кр▒Бр░╡р▒Нр░╡р▒Б, р░Хр░╕р▒Нр░др▒Вр░░р░┐р░мр▒Жр░Вр░бр▒Б, р░ор░Вр░жр░╛р░░р░В, р░ор▒Кр░Хр▒Нр░Х, р░▓р░др░╛р░Хр░╕р▒Нр░др▒Вр░░р░┐р░Х
ЁЯМ╗	р░кр▒Бр░╡р▒Нр░╡р▒Б, р░кр▒Кр░жр▒Нр░жр▒Б р░др░┐р░░р▒Бр░Чр▒Бр░бр▒Б, р░кр▒Кр░жр▒Нр░жр▒Б р░др░┐р░░р▒Бр░Чр▒Бр░бр▒Б р░кр▒Бр░╡р▒Нр░╡р▒Б, р░ор▒Кр░Хр▒Нр░Х, р░╕р▒Вр░░р▒Нр░пр░Хр░╛р░Вр░др░В р░кр▒Бр░╡р▒Нр░╡р▒Б, р░╕р▒Вр░░р▒Нр░пр▒Бр░бр▒Б
ЁЯМ╝	р░кр▒Бр░╡р▒Нр░╡р▒Б, р░кр▒Бр░╖р▒Нр░кр░В, р░ор▒Кр░Хр▒Нр░Х, р░ор▒Кр░Чр▒Нр░Ч
ЁЯМ╖	р░Ър░┐р░др▒Нр░░р░╡р░░р▒Нр░гр░В, р░Ър░┐р░др▒Нр░░р░╡р░░р▒Нр░гр░╛р░▓р▒Б р░Чр░▓ р░кр▒Бр░╖р▒Нр░кр░В, р░кр▒Бр░╖р▒Нр░кр░В
ЁЯМ▒	р░Ер░Вр░Хр▒Бр░░р░ор▒Б, р░ир░╛р░░р▒Бр░ор▒Кр░Хр▒Нр░Х, р░ор▒Кр░▓р░Х, р░▓р▒Зр░д р░Ър▒Жр░Яр▒Нр░Яр▒Б
ЁЯМ▓	р░Жр░Хр▒Бр░▓р▒Б р░░р░╛р░▓р░Хр▒Бр░Вр░бр▒З р░кр░Ър▒Нр░Ър░Чр░╛ р░Йр░Вр░бр▒З р░Ър▒Жр░Яр▒Нр░Яр▒Б, р░Ор░кр▒Нр░кр▒Бр░бр▒В р░кр░Ър▒Нр░Ър░Чр░╛ р░Йр░Вр░бр▒З р░Ър▒Жр░Яр▒Нр░Яр▒Б, р░╕р░др░др░╣р░░р░┐р░д р░Ър▒Жр░Яр▒Нр░Яр▒Б, р░╕р░др░др░╣р░░р░┐р░др░В
ЁЯМ│	р░Жр░Хр▒Бр░░р░╛р░▓р▒З р░Ър▒Жр░Яр▒Нр░Яр▒Б, р░Жр░Хр▒Бр░▓р▒Б р░░р░╛р░▓р▒З р░Ер░бр░╡р░┐ р░ор▒Кр░Хр▒Нр░Х, р░Жр░Хр▒Бр░▓р▒Б р░░р░╛р░▓р▒З р░Ър▒Жр░Яр▒Нр░Яр▒Б
ЁЯМ┤	р░Ър▒Жр░Яр▒Нр░Яр▒Б, р░др░╛р░Яр░┐ р░Ър▒Жр░Яр▒Нр░Яр▒Б, р░ор▒Кр░Хр▒Нр░Х
ЁЯМ╡	р░ир░╛р░Чр░жр░╛р░│р░┐ р░Ър▒Жр░Яр▒Нр░Яр▒Б, р░мр▒Нр░░р░╣р▒Нр░ор░Ьр▒Жр░ор▒Бр░бр▒Б, р░ор▒Бр░│р▒Нр░▓ р░Ър▒Жр░Яр▒Нр░Яр▒Б, р░ор▒Кр░Хр▒Нр░Х
ЁЯМ╛	р░╡р░░р░┐ р░кр░и, р░╡р░░р░┐ р░ор▒Кр░Хр▒Нр░Х
ЁЯМ┐	р░Ур░╖р░зр░┐, р░Чр▒Бр░▓р▒Нр░ор░В, р░ор▒Вр░▓р░┐р░Х
ЁЯНА	р░Ер░жр▒Гр░╖р▒Нр░Я р░Жр░Хр▒Б, р░ир░╛р░▓р▒Бр░Чр▒Б р░░р▒Зр░Хр▒Бр░▓ р░Жр░Хр▒Б
ЁЯНБ	р░Чр░Вр░Чр░░р▒Зр░Чр▒Б р░Жр░Хр▒Б, р░ор░╛р░кр▒Бр░▓р▒Н, р░ор░╛р░кр▒Бр░▓р▒Н р░Жр░Хр▒Б
ЁЯНВ	р░Жр░Хр▒Б, р░Жр░Хр▒Бр░▓р▒Б, р░Жр░Хр▒Бр░▓р▒Б р░░р░╛р░▓р░бр░В, р░░р░╛р░▓р░┐р░и р░Жр░Хр▒Б, р░░р░╛р░▓р▒З р░Жр░Хр▒Бр░▓р▒Б
ЁЯНГ	р░Чр░╛р░▓р░┐, р░Чр░╛р░▓р░┐р░Хр░┐ р░╡р░гр░┐р░Хр▒З р░Жр░Хр▒Б, р░Чр░╛р░▓р░┐р░▓р▒Л р░Жр░Хр▒Б, р░Чр░╛р░▓р░┐р░▓р▒Л р░др▒Зр░▓р░бр░В, р░Чр░╛р░▓р░┐р░▓р▒Л р░др▒Зр░▓р▒З р░Жр░Хр▒Бр░▓р▒Б
ЁЯНЗ	р░жр▒Нр░░р░╛р░Хр▒Нр░╖ р░кр░│р▒Нр░▓р▒Б, р░жр▒Нр░░р░╛р░Хр▒Нр░╖р░кр░│р▒Нр░▓р▒Б, р░кр░Вр░бр▒Б
ЁЯНИ	р░Хр░░ р░кр▒Бр░Ър▒Нр░Ър░Хр░╛р░п, р░Хр░░р▒Нр░мр▒Вр░Ьр░╛, р░Цр░░р▒Нр░мр▒Вр░Ьр░╛ р░кр░Вр░бр▒Б, р░Цр░░р▒Нр░мр▒Вр░Ьр░╛р░кр░Вр░бр▒Б, р░кр░Вр░бр▒Б
ЁЯНЙ	р░кр░Вр░бр▒Б, р░кр▒Бр░Ър▒Нр░Ър░Хр░╛р░п
ЁЯНК	р░Хр░ор░▓р░╛ р░кр░Вр░бр▒Б, р░Хр░ор░▓р░╛р░кр░Вр░бр▒Б, р░Хр░┐р░Ър▒Нр░Ър░┐р░▓р░┐ р░кр░Вр░бр▒Б, р░ир░╛р░░р░┐р░Вр░Ь, р░кр░Вр░бр▒Б
ЁЯНЛ	р░ир░┐р░ор▒Нр░ор░Хр░╛р░п, р░ир░┐р░ор▒Нр░ор░кр░Вр░бр▒Б, р░кр░Вр░бр▒Б, р░кр░╕р▒Бр░кр▒Б р░░р░Вр░Чр▒Б р░кр░Вр░бр▒Б
ЁЯНМ	р░Ер░░р░Яр░┐, р░Ер░░р░Яр░┐р░кр░Вр░бр▒Б, р░кр░Вр░бр▒Б
ЁЯНН	р░Ер░ир░╛р░╕р░кр░Вр░бр▒Б, р░кр░Вр░бр▒Б, р░кр▒Ир░ир░╛р░кр░┐р░▓р▒Н
ЁЯен	р░Яр▒Нр░░р░╛р░кр░┐р░Хр░▓р▒Н, р░кр░Вр░бр▒Б, р░ор░╛р░ор░┐р░бр░┐
ЁЯНО	р░Ор░░р▒Бр░кр▒Б р░пр░╛р░кр░┐р░▓р▒Н, р░Ор░░р▒Нр░░р░ир░┐ р░кр░Вр░бр▒Б, р░Ор░░р▒Нр░░р░ир░┐ р░пр░╛р░кр░┐р░▓р▒Н, р░кр░Вр░бр▒Б, р░пр░╛р░кр░┐р░▓р▒Н
ЁЯНП	р░Жр░Хр▒Бр░кр░Ър▒Нр░Ъ, р░кр░Вр░бр▒Б, р░кр░Ър▒Нр░Ър░ир░┐ р░пр░╛р░кр░┐р░▓р▒Н, р░пр░╛р░кр░┐р░▓р▒Н
ЁЯНР	р░кр░Вр░бр▒Б, р░мр▒Зр░░р▒А р░кр░Вр░бр▒Б, р░мр▒Зр░░р▒Ар░кр░Вр░бр▒Б
ЁЯНС	р░жр▒Кр░Вр░бр░кр░Вр░бр▒Б, р░кр░Вр░бр▒Б, р░кр▒Ар░Ър▒Н
ЁЯНТ	р░Ор░░р▒Нр░░р░ир░┐ р░кр░Вр░бр▒Б, р░Ър▒Жр░░р▒Нр░░р▒А, р░Ър▒Жр░░р▒Нр░░р▒Ар░▓р▒Б, р░кр░Вр░бр▒Б
ЁЯНУ	р░кр░Вр░бр▒Б, р░╕р▒Нр░Яр▒Нр░░р░╛р░мр▒Жр░░р▒Нр░░р▒А
ЁЯеЭ	р░Жр░╣р░╛р░░р░В, р░Хр░┐р░╡р░┐ р░кр░Вр░бр▒Б, р░Хр░┐р░╡р▒А, р░кр░Вр░бр▒Б
ЁЯНЕ	р░Хр▒Вр░░р░Чр░╛р░п, р░Яр▒Кр░ор░╛р░Яр▒Л
ЁЯее	р░Хр▒Кр░мр▒Нр░мр░░р░┐, р░др░╛р░Яр░┐ р░Ър▒Жр░Яр▒Нр░Яр▒Б, р░кр░┐р░ир░╛ р░Хр▒Лр░▓р░╛р░б
ЁЯеС	р░Ер░╡р░Хр░╛р░бр▒Л, р░Жр░╣р░╛р░░р░В, р░кр░Вр░бр▒Б
ЁЯНЖ	р░Хр▒Вр░░р░Чр░╛р░п, р░╡р░Вр░Хр░╛р░п, р░╡р░Вр░Ч р░Ър▒Жр░Яр▒Нр░Яр▒Б
ЁЯеФ	р░Жр░╣р░╛р░░р░В, р░Хр▒Вр░░р░Чр░╛р░п, р░мр░Вр░Чр░╛р░│р░╛р░жр▒Бр░Вр░к
ЁЯеХ	р░Жр░╣р░╛р░░р░В, р░Хр▒Вр░░р░Чр░╛р░п, р░Хр▒Нр░пр░╛р░░р▒Жр░Яр▒Н
ЁЯМ╜	р░Хр░Вр░Хр▒Бр░▓р▒Б, р░ор▒Кр░Хр▒Нр░Хр░Ьр▒Кр░ир▒Нр░и, р░ор▒Кр░Хр▒Нр░Хр░Ьр▒Кр░ир▒Нр░и р░Хр░Вр░Хр░┐
ЁЯеТ	р░Жр░╣р░╛р░░р░В, р░Хр▒Ар░░ р░жр▒Лр░╕р░Хр░╛р░п, р░Хр▒Вр░░р░Чр░╛р░п, р░кр░Ър▒Нр░Ър░бр░┐
ЁЯем	р░Жр░Хр▒Бр░Хр▒Вр░░, р░Хр▒Зр░▓р▒Н, р░Хр▒Нр░пр░╛р░мр▒Зр░Ьр▒А, р░Ър▒Ир░ир▒Ар░╕р▒Н р░Хр▒Нр░пр░╛р░мр▒Зр░Ьр▒А, р░▓р▒Жр░Яр▒Нр░пр▒Вр░╕р▒Н
ЁЯеж	р░Ер░бр░╡р░┐ р░Хр▒Нр░пр░╛р░мр▒Зр░Ьр▒А, р░мр▒Нр░░р▒Лр░Хр░▓р▒А
ЁЯНД	р░Хр▒Бр░Хр▒Нр░Х р░Чр▒Кр░бр▒Бр░╡р▒Б, р░кр▒Бр░Яр▒Нр░Яр░Чр▒Кр░бр▒Бр░Чр▒Б, р░ор░╖р▒Нр░░р▒Вр░ор▒Н
ЁЯеЬ	р░Жр░╣р░╛р░░р░В, р░Хр▒Вр░░р░Чр░╛р░п, р░Чр░┐р░Вр░Ь, р░╡р▒Зр░░р▒Бр░╢р▒Жр░ир░Ч
ЁЯМ░	р░Чр▒Лр░зр▒Бр░о р░░р░Вр░Чр▒Б р░Хр░╛р░п, р░мр░╛р░жр░В, р░мр░╛р░жр░В р░╡р░Вр░Яр░┐ р░жр░┐р░ир▒Бр░╕р▒Б
ЁЯНЮ	р░мр▒Нр░░р▒Жр░бр▒Нр░бр▒Б, р░░р▒Жр░╕р▒Нр░Яр░╛р░░р▒Жр░Вр░Яр▒Н, р░░р▒Кр░Яр▒Нр░Яр▒Ж р░ор▒Бр░Хр▒Нр░Х
ЁЯеР	р░Ер░░р▒Нр░зр░Ър░Вр░жр▒Нр░░р░╛р░Хр░░, р░Ер░░р▒Нр░зр░Ър░Вр░жр▒Нр░░р░╛р░Хр░░ р░░р▒Лр░▓р▒Н, р░Ер░░р▒Нр░зр░Ър░Вр░жр▒Нр░░р░╛р░Хр░╛р░░ р░░р▒Лр░▓р▒Н, р░Жр░╣р░╛р░░р░В, р░лр▒Нр░░р▒Жр░Вр░Ър▒Н, р░мр▒Нр░░р▒Жр░бр▒Н
ЁЯеЦ	р░Жр░╣р░╛р░░р░В, р░лр▒Нр░░р▒Жр░Вр░Ър▒Н, р░мр▒Нр░пр░╛р░Чр▒Жр░Яр▒Н, р░мр▒Нр░пр░╛р░Чр▒Жр░Яр▒Н р░мр▒Нр░░р▒Жр░бр▒Н, р░мр▒Нр░░р▒Жр░бр▒Н
ЁЯеи	р░Яр▒Нр░╡р░┐р░╕р▒Нр░Яр▒Жр░бр▒Н, р░кр▒Нр░░р▒Жр░Яр▒Нр░Ьр▒Жр░▓р▒Н
ЁЯеп	р░мр▒Зр░Хр░░р▒А, р░мр▒Нр░пр░╛р░Чр▒Жр░▓р▒Н, р░╖р▒Нр░ор░┐р░░р▒Н
ЁЯеЮ	р░Жр░╣р░╛р░░р░В, р░Хр▒Нр░░р▒Зр░кр▒Н, р░кр▒Нр░пр░╛р░ир▒НтАМр░Хр▒Зр░Хр▒Н, р░кр▒Нр░пр░╛р░ир▒НтАМр░Хр▒Зр░Хр▒НтАМр░▓р▒Б, р░╣р░╛р░Яр▒НтАМр░Хр▒Зр░Хр▒Н
ЁЯзА	р░Ьр▒Бр░ир▒Нр░ир▒Б, р░Ьр▒Бр░ир▒Нр░ир▒Бр░▓р▒Л р░нр░╛р░Чр░В
ЁЯНЦ	р░Ор░ор▒Бр░Хр░кр▒И р░ор░╛р░Вр░╕р░В, р░Ор░ор▒Бр░Хр░▓ р░ор░╛р░Вр░╕р░В, р░ор░╛р░Вр░╕р░В, р░░р▒Жр░╕р▒Нр░Яр░╛р░░р▒Жр░Вр░Яр▒Н
ЁЯНЧ	р░Хр░╛р░▓р▒Б, р░Хр▒Лр░бр░┐, р░Хр▒Лр░бр░┐ р░Хр░╛р░▓р▒Б, р░░р▒Жр░╕р▒Нр░Яр░╛р░░р▒Жр░Вр░Яр▒Н
ЁЯей	р░Чр▒Кр░░р▒Нр░░р▒Ж р░ор░╛р░Вр░╕р░кр▒Б р░ор▒Бр░Хр▒Нр░Х, р░кр░Вр░жр░┐ р░ор░╛р░Вр░╕р░кр▒Б р░ор▒Бр░Хр▒Нр░Х, р░ор░╛р░Вр░╕р░кр▒Б р░ор▒Бр░Хр▒Нр░Х
ЁЯеУ	р░Жр░╣р░╛р░░р░В, р░кр░Вр░жр░┐ р░ор░╛р░Вр░╕р░В, р░ор░╛р░Вр░╕р░В
ЁЯНФ	р░мр░░р▒Нр░Чр░░р▒Н, р░░р▒Жр░╕р▒Нр░Яр░╛р░░р▒Жр░Вр░Яр▒Н, р░╣р░╛р░Вр░мр░░р▒Нр░Чр░░р▒Н
ЁЯНЯ	р░лр▒Нр░░р▒Жр░Вр░Ър▒Н р░кр▒Нр░░р▒Ир░╕р▒Н, р░лр▒Нр░░р▒Жр░Вр░Ър▒Н р░лр▒Нр░░р▒Ир░╕р▒Н, р░░р▒Жр░╕р▒Нр░Яр░╛р░░р▒Жр░Вр░Яр▒Н, р░╡р▒Зр░кр▒Бр░│р▒Нр░▓р▒Б
ЁЯНХ	р░кр░┐р░Ьр▒Нр░Ьр░╛, р░ор▒Бр░Хр▒Нр░Х, р░░р▒Жр░╕р▒Нр░Яр░╛р░░р▒Жр░Вр░Яр▒Н, р░╕р▒Нр░▓р▒Ир░╕р▒Н
ЁЯМн	р░лр▒Нр░░р░╛р░Вр░Хр▒НтАМр░лр░░р▒Нр░Яр▒Жр░░р▒Н, р░╕р░╛р░╕р▒Зр░Ьр▒Н, р░╣р░╛р░Яр▒Н р░бр░╛р░Чр▒Н, р░╣р░╛р░Яр▒НтАМр░бр░╛р░Чр▒Н
ЁЯек	р░░р▒Кр░Яр▒Нр░Яр▒Ж, р░╕р░╛р░Вр░бр▒НтАМр░╡р░┐р░Ър▒Н
ЁЯМо	р░Яр░╛р░Хр▒Л, р░ор▒Жр░Хр▒Нр░╕р░┐р░Хр░ир▒Н
ЁЯМп	р░мр░░р▒Нр░░р░┐р░Яр▒Нр░Яр▒Л, р░░р▒Жр░╕р▒Нр░Яр░╛р░░р▒Жр░Вр░Яр▒Н
ЁЯеЩ	р░Жр░╣р░╛р░░р░В, р░Хр░мр░╛р░мр▒Н, р░Ьр▒Ир░░р▒Л, р░лр▒Бр░▓р░╛р░лр░▓р▒Н, р░лр▒Нр░▓р░╛р░Яр▒НтАМр░мр▒Нр░░р▒Жр░бр▒Н, р░╕р▒Нр░Яр░лр▒Н р░Ър▒Зр░╕р░┐р░и, р░╕р▒Нр░Яр░лр▒Н р░Ър▒Зр░╕р░┐р░и р░Ър░жр▒Бр░ир▒Ир░и р░мр▒Нр░░р▒Жр░бр▒Н
ЁЯеЪ	р░Жр░╣р░╛р░░р░В, р░Чр▒Нр░░р▒Бр░бр▒Нр░бр▒Б
ЁЯН│	р░░р▒Жр░╕р▒Нр░Яр░╛р░░р▒Жр░Вр░Яр▒Н, р░╡р░Вр░Я, р░╡р░Вр░бр░Яр░В, р░╡р▒Зр░кр▒Бр░│р▒Нр░▓ р░ор▒Вр░Хр▒Бр░бр▒Б
ЁЯеШ	р░Жр░╣р░╛р░░р░В, р░Жр░╣р░╛р░░р░Вр░др▒Л р░Йр░ир▒Нр░и р░мр░╛р░Вр░бр▒А, р░Хр░╛р░╕р▒Бр░░р▒Лр░▓р▒Н, р░кр▒Ир░пр░▓, р░кр▒Нр░пр░╛р░ир▒Н, р░╖р░╛р░▓р▒Л
ЁЯН▓	р░Зр░Чр▒Бр░░р▒Б, р░Хр▒Бр░Вр░б р░Жр░╣р░╛р░░р░В, р░Хр▒Бр░Вр░бр░▓р▒Л р░Жр░╣р░╛р░░р░В, р░░р▒Жр░╕р▒Нр░Яр░╛р░░р▒Жр░Вр░Яр▒Н
ЁЯег	р░Хр░╛р░Вр░Ьр▒А, р░Ър▒Жр░Вр░Ър░╛р░др▒Л р░Хр░кр▒Нр░кр▒Б, р░мр▒Нр░░р▒Зр░Хр▒НтАМр░лр░╛р░╕р▒Нр░Яр▒Н, р░╕р▒Жр░░р░▓р▒Н
ЁЯеЧ	р░Жр░╣р░╛р░░р░В, р░Чр▒Нр░░р▒Ар░ир▒Н, р░Чр▒Нр░░р▒Ар░ир▒Н р░╕р░▓р░╛р░бр▒Н, р░╕р░▓р░╛р░бр▒Н
ЁЯН┐	р░кр░╛р░кр▒НтАМр░Хр░╛р░░р▒Нр░ир▒Н, р░░р▒Жр░╕р▒Нр░Яр░╛р░░р▒Жр░Вр░Яр▒Н
ЁЯзВ	р░Йр░кр▒Нр░кр▒Б, р░ор░╕р░╛р░▓р░╛, р░╖р▒Зр░Хр░░р▒Н
ЁЯел	р░Хр▒Нр░пр░╛р░ир▒Н, р░Хр▒Нр░пр░╛р░ир▒НтАМр░▓р▒Л р░▓р░нр░┐р░Вр░Ър▒З р░Жр░╣р░╛р░░р░В
ЁЯН▒	р░Ьр░кр░ир▒Ар░╕р▒Н р░нр▒Лр░Ьр░и р░кр░╛р░░р▒Нр░╢р░┐р░▓р▒Н р░кр▒Нр░▓р▒Зр░Яр▒Б, р░мр▒Жр░Вр░Яр▒Л, р░мр▒Жр░Вр░Яр▒Л р░кр▒Жр░Яр▒Нр░Яр▒Ж, р░░р▒Жр░╕р▒Нр░Яр░╛р░░р▒Жр░Вр░Яр▒Н
ЁЯНШ	р░мр░┐р░пр▒Нр░пр░В, р░░р▒Ир░╕р▒Н р░Хр▒Нр░░р░╛р░Хр░░р▒Н
ЁЯНЩ	р░Жр░ир░┐р░Чр░┐р░░р░┐, р░мр░┐р░пр▒Нр░пр░В, р░мр░┐р░пр▒Нр░пр░кр▒Б р░Чр░┐р░ир▒Нр░ир▒Ж, р░░р▒Жр░╕р▒Нр░Яр░╛р░░р▒Жр░Вр░Яр▒Н, р░░р▒Ир░╕р▒Н р░мр░╛р░▓р▒Н
ЁЯНЪ	р░Ер░ир▒Нр░ир░В, р░Йр░бр░┐р░Хр░┐р░Вр░Ър░┐р░и р░мр░┐р░пр▒Нр░пр░В, р░Йр░бр░┐р░Хр░┐р░и р░Ер░ир▒Нр░ир░В, р░░р▒Жр░╕р▒Нр░Яр░╛р░░р▒Жр░Вр░Яр▒Н
ЁЯНЫ	р░Ер░ир▒Нр░ир░В, р░Хр▒Вр░░, р░Хр▒Вр░░ р░Ер░ир▒Нр░ир░В, р░Хр▒Вр░░ р░ор░░р░┐р░пр▒Б р░Ер░ир▒Нр░ир░В, р░░р▒Жр░╕р▒Нр░Яр░╛р░░р▒Жр░Вр░Яр▒Н
ЁЯНЬ	р░Жр░╡р░┐р░░р░┐ р░Чр░┐р░ир▒Нр░ир▒Ж, р░Жр░╡р░┐р░░р░┐ р░кр▒Жр░Яр▒Нр░Яр░бр░В, р░Чр░┐р░ир▒Нр░ир▒Ж, р░ир▒Вр░бр▒Бр░▓р▒Нр░╕р▒Н, р░░р▒Жр░╕р▒Нр░Яр░╛р░░р▒Жр░Вр░Яр▒Н
ЁЯНЭ	р░кр░╛р░╕р▒Нр░др░╛, р░░р▒Жр░╕р▒Нр░Яр░╛р░░р▒Жр░Вр░Яр▒Н, р░╕р▒Нр░кр░Чр▒Жр░Яр▒Нр░Яр▒А, р░╕р▒Нр░кр░Шр▒Жр░Яр▒Нр░Яр▒А, р░╕р▒Нр░кр░╛р░Чр▒Жр░Яр▒Нр░Яр▒А
ЁЯНа	р░Хр░╛р░▓р▒Нр░Ър░┐р░и р░Ър░┐р░▓р░Хр░б р░жр▒Бр░Вр░к, р░Хр░╛р░▓р▒Нр░Ър░┐р░и р░др░┐р░пр▒Нр░пр░ир░┐ р░мр░Вр░Чр░╛р░│ р░жр▒Бр░Вр░кр░▓р▒Б, р░Хр░╛р░▓р▒Нр░Ър░┐р░и р░мр░Вр░Чр░╛р░│ р░жр▒Бр░Вр░кр░▓р▒Б, р░Хр░╛р░▓р▒Нр░Ър░┐р░ир░╡р░┐, р░др░┐р░пр▒Нр░пр░ир░┐ р░мр░Вр░Чр░╛р░│ р░жр▒Бр░Вр░кр░▓р▒Б, р░др░┐р░пр▒Нр░пр░ир░┐р░╡р░┐, р░░р▒Жр░╕р▒Нр░Яр░╛р░░р▒Жр░Вр░Яр▒Н
ЁЯНв	р░Ур░бр▒Жр░ир▒Н, р░кр▒Бр░▓р▒Нр░▓, р░кр▒Бр░▓р▒Нр░▓р░др▒Л р░др░┐р░ир░╛р░▓р▒Нр░╕р░┐р░и р░╕р░ор▒Бр░жр▒Нр░░р░╛р░╣р░╛р░░р░В, р░кр▒Бр░▓р▒Нр░▓р░др▒Л р░др░┐р░ир░╛р░▓р▒Нр░╕р░┐р░и р░╕р▒Ар░лр▒Бр░бр▒Н, р░░р▒Жр░╕р▒Нр░Яр░╛р░░р▒Жр░Вр░Яр▒Н
ЁЯНг	р░Ьр░кр░ир▒Ар░╕р▒Н р░╡р░Вр░Яр░Хр░В, р░░р▒Жр░╕р▒Нр░Яр░╛р░░р▒Жр░Вр░Яр▒Н, р░╕р▒Бр░╖р░┐, р░╕р▒Бр░╖р▒А
ЁЯНд	р░░р▒Жр░╕р▒Нр░Яр░╛р░░р▒Жр░Вр░Яр▒Н, р░░р▒Кр░пр▒Нр░пр░▓ р░╡р▒Зр░кр▒Бр░бр▒Б, р░░р▒Кр░пр▒Нр░пр░▓р▒Б, р░╡р▒Зр░пр░┐р░Вр░Ър░┐р░и р░░р▒Кр░пр▒Нр░п
ЁЯНе	р░Ър▒Зр░кр░▓р░др▒Л р░Ър▒Зр░╕р░┐р░и р░Хр▒Зр░Хр▒Б, р░Ър▒Зр░кр░▓р▒Б, р░░р▒Жр░╕р▒Нр░Яр░╛р░░р▒Жр░Вр░Яр▒Н, р░╕р▒Бр░бр░┐ р░др░┐р░░р░┐р░Чр░┐р░ир░Яр▒Нр░▓р▒Бр░Вр░бр▒З р░Ър▒Зр░к р░Хр▒Зр░Хр▒Н, р░╕р▒Бр░бр▒Бр░▓р▒Б р░др░┐р░░р░┐р░Чр░┐р░ир░Яр▒Нр░▓р▒Бр░Вр░бр▒З р░Ър▒Зр░кр░▓ р░Хр▒Зр░Хр▒Б
ЁЯео	р░кр░Вр░бр▒Бр░Ч, р░ор▒Вр░ир▒Н р░Хр▒Зр░Хр▒Н, р░пр▒Вр░мр░┐р░Вр░Чр▒Н, р░╢р░░р░жр▒Гр░др▒Бр░╡р▒Б
ЁЯНб	р░бр░╛р░Вр░Чр▒Л, р░кр▒Бр░▓р▒Нр░▓р░др▒Л р░др░┐р░ир░╛р░▓р▒Нр░╕р░┐р░и р░ор▒Лр░Ър░┐ р░Йр░Вр░бр░▓р▒Б, р░ор▒Лр░Ър░┐, р░ор▒Лр░Ър░┐ р░Йр░Вр░бр░▓р▒Б, р░░р▒Жр░╕р▒Нр░Яр░╛р░░р▒Жр░Вр░Яр▒Н
ЁЯеЯ	р░Ор░Вр░кр░╛р░Вр░бр░╛, р░Чр▒Зр░пр▒Лр░Ьр░╛, р░Ьр░┐р░пр░╛р░Ьр▒А, р░бр░Вр░кр▒Нр░▓р░┐р░Вр░Чр▒Н, р░кр░╛р░Яр▒НтАМр░╕р▒Нр░Яр░┐р░Хр▒Нр░Хр░░р▒Н, р░кр░┐р░пр░░р▒Лр░Ьр▒А
ЁЯеа	р░Ьр▒Лр░╕р▒Нр░пр░В, р░лр░╛р░░р▒Нр░Ър▒Нр░пр▒Вр░ир▒Н р░Хр▒Бр░Хр▒Нр░Хр▒А
ЁЯеб	р░Ур░пр░┐р░╕р▒Нр░Яр░░р▒Н р░кр▒Жр░пр░┐р░▓р▒Н, р░кр░╛р░░р▒Нр░╢р░┐р░▓р▒Н р░кр▒Жр░Яр▒Нр░Яр▒Ж
ЁЯНж	р░Рр░╕р▒НтАМр░Хр▒Нр░░р▒Ар░ор▒Н, р░Хр▒Нр░░р▒Ар░ор▒Н, р░░р▒Жр░╕р▒Нр░Яр░╛р░░р▒Жр░Вр░Яр▒Н, р░╕р░╛р░лр▒Нр░Яр▒Н р░Рр░╕р▒Н р░Хр▒Нр░░р▒Ар░В, р░╕р░╛р░лр▒Нр░Яр▒Н р░╕р░░р▒Нр░╡р▒Н
ЁЯНз	р░Рр░╕р▒Н, р░Чр▒Бр░Вр░бр▒Нр░░р░Вр░Чр░╛ р░Ър▒Жр░Хр▒Нр░Хр░┐р░ир░Яр▒Нр░▓р▒Б р░Йр░Вр░бр▒З р░Рр░╕р▒Н, р░░р▒Жр░╕р▒Нр░Яр░╛р░░р▒Жр░Вр░Яр▒Н, р░╖р▒Зр░╡р▒Нр░бр▒Н
ЁЯНи	р░Рр░╕р▒Н, р░Рр░╕р▒Н р░Хр▒Нр░░р▒Ар░В, р░Хр▒Нр░░р▒Ар░ор▒Н, р░░р▒Жр░╕р▒Нр░Яр░╛р░░р▒Жр░Вр░Яр▒Н
ЁЯНй	р░бр▒Лр░ир░Яр▒Н, р░░р▒Жр░╕р▒Нр░Яр░╛р░░р▒Жр░Вр░Яр▒Н
ЁЯНк	р░Хр▒Бр░Хр▒А, р░Хр▒Бр░Хр▒Нр░Хр▒А, р░░р▒Жр░╕р▒Нр░Яр░╛р░░р▒Жр░Вр░Яр▒Н
ЁЯОВ	р░Хр▒Зр░Хр▒Б, р░кр▒Бр░Яр▒Нр░Яр░┐р░ир░░р▒Лр░Ьр▒Б, р░кр▒Бр░Яр▒Нр░Яр░┐р░ир░░р▒Лр░Ьр▒Б р░Хр▒Зр░Хр▒Б, р░кр▒Бр░Яр▒Нр░Яр▒Нр░Яр░┐р░ир░░р▒Лр░Ьр▒Б р░Хр▒Зр░Хр▒Б, р░╡р▒Зр░бр▒Бр░Х
ЁЯН░	р░Хр▒Зр░Хр▒Б, р░Хр▒Зр░Хр▒Б р░ор▒Бр░Хр▒Нр░Х, р░Хр▒Лр░╕р░┐р░и р░Хр▒Зр░Хр▒Б р░ор▒Бр░Хр▒Нр░Х, р░░р▒Жр░╕р▒Нр░Яр░╛р░░р▒Жр░Вр░Яр▒Н
ЁЯзБ	р░Хр░кр▒НтАМр░Хр▒Зр░Хр▒Н, р░мр▒Зр░Хр░░р▒А, р░╕р▒Нр░╡р▒Ар░Яр▒Н
ЁЯез	р░кр▒И, р░кр▒Нр░пр░╛р░╕р▒Нр░Яр▒Нр░░р▒А, р░лр░┐р░▓р▒Нр░▓р░┐р░Вр░Чр▒Н
ЁЯНл	р░Ър░╛р░Хр▒Кр░▓р▒Зр░Яр▒Н р░мр░╛р░░р▒Н, р░Ър░╛р░Хр▒Нр░▓р▒Зр░Яр▒Н, р░мр░╛р░░р▒Н, р░░р▒Жр░╕р▒Нр░Яр░╛р░░р▒Жр░Вр░Яр▒Н
ЁЯНм	р░Хр▒Нр░пр░╛р░Вр░бр▒А, р░░р▒Жр░╕р▒Нр░Яр░╛р░░р▒Жр░Вр░Яр▒Н
ЁЯНн	р░Хр▒Нр░пр░╛р░Вр░бр▒А, р░░р▒Жр░╕р▒Нр░Яр░╛р░░р▒Жр░Вр░Яр▒Н, р░▓р░╛р░▓р▒Ар░кр░╛р░кр▒Н
ЁЯНо	р░Хр░╕р▒Нр░Яр░░р▒Нр░бр▒Н, р░Хр▒Лр░бр░┐ р░Чр▒Бр░бр▒Нр░▓р▒Б, р░кр░╛р░▓р▒Б р░Ър░Хр▒Нр░Хр▒Жр░░ р░Хр░▓р░┐р░кр░┐ р░Ър▒Зр░╕р░┐р░и р░ор░┐р░ар░╛р░пр░┐, р░кр░┐р░Вр░бр░┐р░╡р░Вр░Я, р░░р▒Жр░╕р▒Нр░Яр░╛р░░р▒Жр░Вр░Яр▒Н
ЁЯНп	р░Хр▒Бр░Вр░б, р░др▒Зр░ир▒Ж, р░др▒Зр░ир▒Ж р░Хр▒Бр░Вр░б, р░░р▒Жр░╕р▒Нр░Яр░╛р░░р▒Жр░Вр░Яр▒Н
ЁЯН╝	р░Ър░┐р░ир▒Нр░ир░кр░┐р░▓р▒Нр░▓р░▓р░Хр▒Б р░кр░╛р░▓р▒Б р░кр░Яр▒Нр░Яр░┐р░Вр░Ър▒З р░мр░╛р░Яр░┐р░▓р▒Н, р░кр░╛р░ир▒Ар░пр░В, р░кр░╛р░▓ р░бр░мр▒Нр░мр░╛, р░кр░╛р░▓р▒Б, р░мр░╛р░Яр░┐р░▓р▒Н, р░мр▒Зр░мр▒А р░мр░╛р░Яр░┐р░▓р▒Н
ЁЯеЫ	р░Чр▒Нр░▓р░╛р░╕р▒Н, р░кр░╛р░ир▒Ар░пр░В, р░кр░╛р░▓ р░Чр▒Нр░▓р░╛р░╕р▒Н, р░кр░╛р░▓р▒Б
ЁЯН╡	р░Яр▒А р░Йр░ир▒Нр░и р░Хр░кр▒Нр░кр▒Б, р░Яр▒Ар░Хр░кр▒Нр░кр▒Б, р░кр░╛р░ир▒Ар░пр░В, р░╣р▒Нр░пр░╛р░Вр░бр░┐р░▓р▒Н р░▓р▒Зр░ир░┐ р░Яр▒А р░Хр░кр▒Нр░кр▒Б
ЁЯН╢	р░Хр░кр▒Нр░кр▒Б, р░кр░╛р░ир▒Ар░пр░В, р░кр░┐р░Вр░Чр░╛р░гр░┐, р░кр░┐р░Вр░Чр░╛р░гр░┐ р░мр░╛р░Яр░┐р░▓р▒Н р░ор░░р░┐р░пр▒Б р░Хр░кр▒Нр░кр▒Б, р░мр░╛р░Яр░┐р░▓р▒Н, р░мр░╛р░░р▒Н, р░░р▒Жр░╕р▒Нр░Яр░╛р░░р▒Жр░Вр░Яр▒Н, р░╕р▒Зр░Хр▒Н
ЁЯН╛	р░Хр░╛р░░р▒Нр░Хр▒Н, р░Хр░╛р░░р▒Нр░Хр▒Н р░Йр░Вр░бр▒З р░╕р▒Ар░╕р░╛, р░кр░╛р░ир▒Ар░пр░В, р░мр░╛р░░р▒Н, р░╕р▒Ар░╕р░╛
ЁЯН╖	р░Чр▒Нр░▓р░╛р░╕р▒Б, р░кр░╛р░ир▒Ар░пр░В, р░мр░╛р░░р▒Н, р░ор░жр▒Нр░пр░В р░Чр▒Нр░▓р░╛р░╕р▒Н, р░░р▒Жр░╕р▒Нр░Яр░╛р░░р▒Жр░Вр░Яр▒Н, р░╡р▒Ир░ир▒Н, р░╡р▒Ир░ир▒Н р░Йр░ир▒Нр░и р░Чр▒Нр░▓р░╛р░╕р▒Б
ЁЯН╣	р░Йр░╖р▒Нр░гр░ор░Вр░бр░▓ р░кр░╛р░ир▒Ар░пр░В, р░кр░╛р░ир▒Ар░пр░В, р░мр░╛р░░р▒Н, р░░р▒Жр░╕р▒Нр░Яр░╛р░░р▒Жр░Вр░Яр▒Н, р░╡р▒Зр░бр░┐ р░кр░╛р░ир▒Ар░пр░В, р░╡р▒Зр░бр░┐р░╡р░┐
ЁЯН║	р░мр░╛р░░р▒Н, р░мр▒Ар░░р▒Б, р░мр▒Ар░░р▒Н р░ор░Чр▒Нр░Чр▒Б, р░ор░Чр▒Нр░Чр▒Б, р░░р▒Жр░╕р▒Нр░Яр░╛р░░р▒Жр░Вр░Яр▒Н
ЁЯН╗	р░Тр░Хр░жр░╛р░ир░┐р░др▒Л р░Тр░Хр░Яр░┐ р░др░╛р░Хр░┐р░╕р▒Нр░др▒Бр░ир▒Нр░и р░мр▒Ар░░р▒Н р░ор░Чр▒Нр░Чр▒Бр░▓р▒Б, р░мр░╛р░░р▒Н, р░мр▒Ар░░р▒Б, р░ор░Чр▒Нр░Чр▒Б, р░ор░Чр▒Нр░Чр▒Бр░▓р▒Б, р░░р▒Жр░╕р▒Нр░Яр░╛р░░р▒Жр░Вр░Яр▒Н
ЁЯеВ	р░Тр░Хр░жр░╛р░ир░┐р░др▒Л р░Тр░Хр░Яр░┐ р░др░╛р░Хр░┐р░╕р▒Нр░др▒Бр░ир▒Нр░и р░Чр▒Нр░▓р░╛р░╕р▒НтАМр░▓р▒Б, р░Чр▒Нр░▓р░╛р░╕р▒Б р░╢р░мр▒Нр░жр░В, р░Чр▒Нр░▓р░╛р░╕р▒Н, р░кр░╛р░ир▒Ар░пр░В, р░╡р▒Зр░бр▒Бр░Х
ЁЯеГ	р░Чр▒Нр░▓р░╛р░╕р▒Н, р░Яр░Вр░мр▒Нр░▓р░░р▒Н, р░Яр░Вр░мр▒Нр░▓р░░р▒Н р░Чр▒Нр░▓р░╛р░╕р▒Н, р░ор░жр▒Нр░пр░В, р░╡р░┐р░╕р▒Нр░Хр▒А, р░╖р░╛р░Яр▒Н
ЁЯед	р░Ьр▒Нр░пр▒Вр░╕р▒Н, р░╕р▒Лр░бр░╛, р░╕р▒Нр░Яр▒Нр░░р░╛р░др▒Л р░Хр░кр▒Н
ЁЯев	р░Ър░╛р░кр▒НтАМр░╕р▒Нр░Яр░┐р░Хр▒НтАМр░▓р▒Б, р░╣р░╛р░╖р▒А
ЁЯН┤	р░Хр░др▒Нр░др░┐, р░лр▒Лр░░р▒Нр░Хр▒Н р░ор░░р░┐р░пр▒Б р░Хр░др▒Нр░др░┐, р░лр▒Лр░░р▒Нр░Хр▒Н р░ор░░р░┐р░пр▒Б р░ир▒Ир░лр▒Н, р░ор▒Бр░│р▒Нр░▓ р░Чр░░р░┐р░Яр▒Ж, р░░р▒Жр░╕р▒Нр░Яр░╛р░░р▒Жр░Вр░Яр▒Н
ЁЯеД	р░Ър▒Жр░Вр░Ър░╛, р░Яр▒Зр░мр▒Бр░▓р▒Н р░╕р▒Нр░кр▒Вр░ир▒Н, р░╕р▒Нр░кр▒Вр░ир▒Н
ЁЯФк	р░Хр▒Вр░░р░Чр░╛р░пр░▓р▒Б р░др░░р░┐р░Чр▒З р░Хр░др▒Нр░др░┐, р░Ър░┐р░ир▒Нр░и р░Хр░др▒Нр░др░┐, р░╡р░Вр░Я р░Чр░жр░┐р░▓р▒Л р░Йр░кр░пр▒Лр░Чр░┐р░Вр░Ър▒З р░Хр░др▒Нр░др░┐
ЁЯП║	р░Хр▒Бр░Вр░нр░В, р░кр░╛р░ир▒Ар░пр░В, р░╡р░Вр░Я, р░╕р▒Ар░╕р░╛
ЁЯМН	р░Жр░лр▒Нр░░р░┐р░Хр░╛, р░нр▒Вр░Чр▒Лр░│р░В, р░нр▒Вр░ор░┐, р░пр▒Вр░░р░кр▒Н, р░пр▒Вр░░р░кр▒Н-р░Жр░лр▒Нр░░р░┐р░Хр░╛р░ир▒Б р░Ър▒Вр░кр▒З р░Чр▒Нр░▓р▒Лр░мр▒Н
ЁЯМП	р░Жр░╕р░┐р░пр░╛, р░Жр░╕р░┐р░пр░╛-р░Жр░╕р▒Нр░Яр▒Нр░░р▒Зр░▓р░┐р░пр░╛р░ир▒Б р░Ър▒Вр░кр▒З р░Чр▒Нр░▓р▒Лр░мр▒Н, р░Жр░╕р▒Нр░Яр▒Нр░░р▒Зр░▓р░┐р░пр░╛, р░нр▒Вр░Чр▒Лр░│р░В, р░нр▒Вр░ор░┐
ЁЯМР	р░зр▒Гр░╡р░░р▒Зр░Цр░▓р▒Б, р░нр▒Вр░Чр▒Лр░│р░В, р░ор░зр▒Нр░пр░╛р░╣р▒Нр░и р░░р▒Зр░Цр░▓р░др▒Л р░Чр▒Нр░▓р▒Лр░мр▒Н, р░ор░зр▒Нр░пр░╛р░╣р▒Нр░ир░╛ р░░р▒Зр░Цр░▓р▒Б
ЁЯЧ╛	р░Ьр░кр░╛р░ир▒Н, р░Ьр░кр░╛р░ир▒Н р░ор▒Нр░пр░╛р░кр▒Н
ЁЯзн	р░Ер░пр░╕р▒Нр░Хр░╛р░Вр░др░В, р░Ур░░р░┐р░пр▒Жр░Вр░Яр▒Ар░░р░┐р░Вр░Чр▒Н, р░жр░┐р░Хр▒Нр░╕р▒Вр░Ър░┐, р░ир░╛р░╡р░┐р░Чр▒Зр░╖р░ир▒Н
ЁЯМЛ	р░Ер░Чр▒Нр░ир░┐ р░кр░░р▒Нр░╡р░др░В р░мр░жр▒Нр░жр░▓р░╡р▒Нр░╡р░бр░В, р░Ер░Чр▒Нр░ир░┐р░кр░░р▒Нр░╡р░др░В, р░Хр▒Лр░кр░В р░Хр░Яр▒Нр░Яр░▓р▒Б р░др▒Жр░Вр░Ър▒Бр░Хр▒Лр░╡р░бр░В, р░▓р░╛р░╡р░╛ р░Ор░Чр░Ьр░┐р░ор▒Нр░ор░бр░В
ЁЯЧ╗	р░лр▒Бр░Ьр░┐ р░кр░░р▒Нр░╡р░др░В, р░ор░Вр░Ър▒Бр░др▒Л р░Хр░кр▒Нр░кр░мр░бр░┐р░и р░кр░░р▒Нр░╡р░др░В
ЁЯз▒	р░Зр░Яр▒Бр░Х, р░Зр░Яр▒Бр░Хр░▓р▒Б, р░Чр▒Лр░б, р░мр░Вр░Хр░ор░Яр▒Нр░Яр░┐, р░ор▒Лр░░р▒Нр░Яр░╛р░░р▒Н
ЁЯПб	р░Зр░▓р▒Нр░▓р▒Б, р░Чр▒Гр░╣р░В, р░др▒Лр░Я, р░др▒Лр░Я р░Йр░Вр░бр▒З р░Зр░▓р▒Нр░▓р▒Б, р░др▒Лр░Я р░Йр░ир▒Нр░и р░Зр░▓р▒Нр░▓р▒Б, р░нр░╡р░ир░В
ЁЯПв	р░Хр░╛р░░р▒Нр░пр░╛р░▓р░п р░нр░╡р░ир░В, р░Хр░╛р░░р▒Нр░пр░╛р░▓р░пр░В, р░нр░╡р░ир░В
ЁЯПг	р░Ьр░кр░ир▒Ар░пр▒Бр░▓ р░кр▒Лр░╕р▒Нр░Яр░╛р░лр▒Ар░╕р▒Н, р░Ьр░кр░╛р░ир▒Н, р░кр▒Лр░╕р▒Нр░Яр░╛р░лр▒Ар░╕р▒Н, р░нр░╡р░ир░В
ЁЯПд	р░др░кр░╛р░▓р░╛, р░др░кр░╛р░▓р░╛ р░Хр░╛р░░р▒Нр░пр░╛р░▓р░пр░В, р░кр▒Лр░╕р▒Нр░Яр░╛р░лр▒Ар░╕р▒Н, р░кр▒Лр░╕р▒Нр░Яр▒Н, р░нр░╡р░ир░В, р░пр▒Вр░░р▒Лр░кр░┐р░пр░ир▒Н, р░пр▒Вр░░р▒Лр░кр░┐р░пр░ир▒Н р░др░кр░╛р░▓р░╛ р░Хр░╛р░░р▒Нр░пр░╛р░▓р░пр░В
ЁЯПе	р░Жр░╕р▒Бр░кр░др▒Нр░░р░┐, р░нр░╡р░ир░В
ЁЯПж	р░мр▒Нр░пр░╛р░Вр░Хр▒Н, р░нр░╡р░ир░В
ЁЯПи	р░нр░╡р░ир░В, р░╣р▒Лр░Яр░▓р▒Н
ЁЯПй	р░кр▒Нр░░р▒Зр░о, р░кр▒Нр░░р▒Зр░о р░╣р▒Лр░Яр░▓р▒Н, р░╣р▒Лр░Яр░▓р▒Н
ЁЯПк	р░жр▒Бр░Хр░╛р░гр░В, р░ир░┐р░др▒Нр░пр░╛р░╡р░╕р░░, р░ир░┐р░др▒Нр░пр░╛р░╡р░╕р░░ р░╡р░╕р▒Нр░др▒Бр░╡р▒Бр░▓ р░жр▒Бр░Хр░╛р░гр░В, р░╡р░╕р▒Нр░др▒Бр░╡р▒Б
ЁЯПл	р░кр░╛р░ар░╢р░╛р░▓, р░кр░╛р░ар░╢р░╛р░▓ р░нр░╡р░ир░В, р░нр░╡р░ир░В
ЁЯПм	р░бр░┐р░кр░╛р░░р▒Нр░Яр▒НтАМр░ор▒Жр░Вр░Яр▒Н, р░бр░┐р░кр░╛р░░р▒Нр░Яр▒НтАМр░ор▒Жр░Вр░Яр▒Н р░жр▒Бр░Хр░╛р░гр░В, р░жр▒Бр░Хр░╛р░гр░В
ЁЯПп	р░Хр▒Лр░Я, р░Ьр░кр░ир▒Ар░пр▒Бр░▓ р░Хр▒Лр░Я, р░Ьр░кр░╛р░ир▒Н
ЁЯП░	р░Хр▒Лр░Я, р░пр▒Вр░░р░кр▒Н, р░пр▒Вр░░р▒Лр░кр░┐р░пр░ир▒Н р░Хр▒Лр░Я
ЁЯТТ	р░кр▒Жр░│р▒Нр░▓р░┐, р░╡р░┐р░╡р░╛р░╣ р░╡р▒Зр░жр░┐р░Х, р░╡р░┐р░╡р░╛р░╣р░В
ЁЯЧ╝	р░Яр░╡р░░р▒Н, р░Яр▒Лр░Хр▒Нр░пр▒Л, р░Яр▒Лр░Хр▒Нр░пр▒Л р░Яр░╡р░░р▒Н
ЁЯЧ╜	р░▓р░┐р░мр░░р▒Нр░Яр▒А, р░▓р░┐р░мр░░р▒Нр░Яр▒А р░╡р░┐р░Чр▒Нр░░р░╣р░В, р░╡р░┐р░Чр▒Нр░░р░╣р░В
ЁЯХМ	р░Зр░╕р▒Нр░▓р░╛р░В, р░ор░др░В, р░ор░╕р▒Ар░жр▒Б, р░ор▒Бр░╕р▒Нр░▓р░┐р░В
ЁЯХН	р░ор░Вр░жр░┐р░░р░В, р░пр▒Вр░жр▒Бр░▓ р░ор░Вр░жр░┐р░░р░В, р░пр▒Вр░жр▒Бр░▓р▒Б
ЁЯХЛ	р░ор░Хр▒Нр░Хр░╛, р░ор░Хр▒Нр░Хр░╛ р░ор░╕р▒Ар░жр▒Б, р░ор░╕р▒Ар░жр▒Б
ЁЯМБ	р░кр▒Кр░Ч, р░кр▒Кр░Ч р░░р▒Вр░кр░Вр░▓р▒Лр░ир░┐ р░ор░Вр░Ър▒Б, р░ор░Вр░Ър▒Б
ЁЯМГ	р░ир░Хр▒Нр░╖р░др▒Нр░░р░В, р░ир░Хр▒Нр░╖р░др▒Нр░░р░╛р░▓р░др▒Л р░░р░╛р░др▒Нр░░р░┐, р░░р░╛р░др▒Нр░░р░┐
ЁЯМД	р░кр░░р▒Нр░╡р░др░В, р░кр░░р▒Нр░╡р░др░╛р░▓ р░ор▒Ар░жр▒Бр░Чр░╛ р░Йр░жр░пр░┐р░╕р▒Нр░др▒Бр░ир▒Нр░и р░╕р▒Вр░░р▒Нр░пр▒Бр░бр▒Б, р░╕р▒Вр░░р▒Нр░пр▒Бр░бр▒Б
ЁЯМЕ	р░Йр░жр░пр░В, р░Йр░жр░пр░┐р░╕р▒Нр░др▒Бр░ир▒Нр░и р░╕р▒Вр░░р▒Нр░пр▒Бр░бр▒Б, р░╕р▒Вр░░р▒Нр░пр▒Бр░бр▒Б
ЁЯМЖ	р░ир░Чр░░р░В, р░╕р░Вр░зр▒Нр░пр░╛, р░╕р░Вр░зр▒Нр░пр░╛ р░╕р░ор░пр░Вр░▓р▒Л р░ир░Чр░░ р░╡р▒Ар░Хр▒Нр░╖р░г
ЁЯМЗ	р░Ер░╕р▒Нр░др░ор░пр░В, р░╕р▒Вр░░р▒Нр░п, р░╕р▒Вр░░р▒Нр░пр░╛р░╕р▒Нр░др░ор░пр░В
ЁЯМЙ	р░░р░╛р░др▒Нр░░р░┐, р░░р░╛р░др▒Нр░░р░┐р░кр▒Вр░Я р░╡р░Вр░др▒Жр░и, р░╡р░Вр░др▒Жр░и
ЁЯММ	р░Жр░Хр░╛р░╢р░В, р░ир░Хр▒Нр░╖р░др▒Нр░░р░╡р▒Ар░зр░┐, р░кр░╛р░▓р░кр▒Бр░Вр░д
ЁЯОа	р░Хр░╛р░░р▒Лр░╕р░┐р░▓р▒Н, р░Хр░╛р░░р▒Лр░╕р░┐р░▓р▒Н р░Чр▒Бр░░р▒Нр░░р░В, р░Чр▒Бр░░р▒Нр░░р░В
ЁЯОб	р░░р░Вр░Чр▒Б, р░░р░Вр░Чр▒Бр░▓ р░░р░╛р░Яр▒Нр░ир░В, р░░р░╛р░Яр▒Нр░ир░В
ЁЯОв	р░Хр▒Лр░╕р▒Нр░Яр░░р▒Н, р░░р▒Лр░▓р░░р▒Н, р░░р▒Лр░▓р░░р▒Н р░Хр▒Лр░╕р▒Нр░Яр░░р▒Н
ЁЯТИ	р░ор░Вр░Чр░▓р░┐, р░ор░Вр░Чр░▓р░┐ р░░р░╛р░пр░┐, р░░р░╛р░пр░┐
ЁЯОк	р░Яр▒Жр░Вр░Яр▒Н, р░╕р░░р▒Нр░Хр░╕р▒Н, р░╕р░░р▒Нр░Хр░╕р▒Н р░Яр▒Жр░Вр░Яр▒Н
ЁЯЪВ	р░Жр░╡р░┐р░░р░┐, р░Жр░╡р░┐р░░р░┐р░др▒Л р░ир░бр░┐р░Ър▒З р░░р▒Ир░▓р▒Б, р░░р▒Ир░▓р▒Б
ЁЯЪГ	р░нр▒Лр░Чр▒А, р░░р▒Ир░▓р▒Б, р░░р▒Ир░▓р▒Б р░мр▒Лр░Чр▒А
ЁЯЪД	р░Ер░зр░┐р░Х р░╡р▒Зр░Чр░В р░Хр░▓р░┐р░Чр░┐р░и р░░р▒Ир░▓р▒Б, р░░р▒Ир░▓р▒Б, р░╡р▒Зр░Чр░В
ЁЯЪЕ	р░Ер░зр░┐р░Х р░╡р▒Зр░Чр░В р░Хр░▓р░┐р░Чр░┐р░и р░мр▒Бр░▓р▒Нр░▓р▒Жр░Яр▒Н р░░р▒Ир░▓р▒Б, р░мр▒Бр░▓р▒Нр░▓р▒Жр░Яр▒Н, р░░р▒Ир░▓р▒Б, р░╡р▒Зр░Чр░В
ЁЯЪЖ	р░░р▒Ир░▓р▒Б, р░╕р░╛р░зр░╛р░░р░г р░Хр░░р▒Жр░Вр░Яр▒Б р░▓р▒Зр░жр░╛ р░бр▒Ар░Ьр░┐р░▓р▒Н р░░р▒Ир░▓р▒Б
ЁЯЪИ	р░др░Хр▒Нр░Хр▒Бр░╡ р░кр░░р░┐р░ор░╛р░г р░░р▒Ир░▓р▒Б, р░кр░░р░┐р░ор░╛р░гр░В, р░░р▒Ир░▓р▒Б
ЁЯЪЙ	р░░р▒Ир░▓р▒Б, р░░р▒Ир░▓р▒Нр░╡р▒З р░╕р▒Нр░Яр▒Зр░╖р░ир▒Н, р░╕р▒Нр░Яр▒Зр░╖р░ир▒Н
ЁЯЪК	р░Яр▒Нр░░р░╛р░ор▒Н, р░ор░Вр░жр▒Бр░╡р▒Ир░кр▒Б р░Ър▒Вр░кр▒Бр░др▒Бр░ир▒Нр░и р░Яр▒Нр░░р░╛р░ор▒Н р░Хр░╛р░░р▒Б
ЁЯЪЭ	р░Тр░Хр▒З р░Яр▒Нр░░р░╛р░Хр▒Н р░Йр░Вр░бр▒З р░░р▒Ир░▓р▒Б, р░Яр▒Нр░░р░╛р░Хр▒Н, р░░р▒Ир░▓р▒Б
ЁЯЪЮ	р░кр░░р▒Нр░╡р░др░В, р░кр░░р▒Нр░╡р░др░╛р░▓р▒Нр░▓р▒Л р░кр▒Нр░░р░пр░╛р░гр░┐р░Вр░Ър▒З р░░р▒Ир░▓р▒Б, р░░р▒Ир░▓р▒Б
ЁЯЪЛ	р░Яр▒Нр░░р░╛р░ор▒Н, р░Яр▒Нр░░р░╛р░ор▒Н р░╡р░╛р░╣р░ир░В, р░╡р░╛р░╣р░ир░В
ЁЯЪМ	р░Хр░╛р░░р▒Б, р░Яр▒Нр░░р░╛р░ор▒Н, р░Яр▒Нр░░р░╛р░ор▒Н р░Хр░╛р░░р▒Б
ЁЯЪО	р░др▒Ар░Ч, р░мр░╕р▒Нр░╕р▒Б, р░╡р░┐р░жр▒Нр░пр▒Бр░др▒Н, р░╡р░┐р░жр▒Нр░пр▒Бр░др▒Н р░др▒Ар░Чр░▓р░др▒Л р░ир░бр░┐р░Ър▒З р░мр░╕р▒Нр░╕р▒Б
ЁЯЪР	р░др░Хр▒Нр░Хр▒Бр░╡ р░кр░░р░┐р░ор░╛р░г р░мр░╕р▒Нр░╕р▒Б, р░кр░░р░┐р░ор░╛р░гр░В, р░мр░╕р▒Нр░╕р▒Б
ЁЯЪТ	р░Ер░Чр▒Нр░ир░┐, р░Ер░Чр▒Нр░ир░┐ р░ор░╛р░кр░Х р░пр░Вр░др▒Нр░░р░В, р░пр░Вр░др▒Нр░░р░В
ЁЯЪУ	р░кр▒Лр░▓р▒Ар░╕р▒Б, р░кр▒Лр░▓р▒Ар░╕р▒Б р░╡р░╛р░╣р░ир░В, р░╡р░╛р░╣р░ир░В
ЁЯЪХ	р░Яр░╛р░Хр▒Нр░╕р▒А, р░кр░Хр▒Нр░Хр░Хр▒Б р░Ър▒Вр░кр░мр░бр▒З р░Яр░╛р░Хр▒Нр░╕р▒А р░Ър░┐р░╣р▒Нр░ир░В
ЁЯЪЦ	р░Яр░╛р░Хр▒Нр░╕р▒А, р░ор▒Бр░Вр░жр▒Б, р░ор▒Бр░Вр░жр▒Бр░╡р▒Ир░кр▒Б р░╡р░╕р▒Нр░др▒Бр░ир▒Нр░и р░Яр░╛р░Хр▒Нр░╕р▒А
ЁЯЪЧ	р░Жр░Яр▒Лр░ор▒Кр░мр▒Ир░▓р▒Н, р░Хр░╛р░░р▒Б, р░кр░Хр▒Нр░Хр░Хр▒Б р░Ър▒Вр░кр░мр░бр▒З р░Хр░╛р░░р▒Б р░Ър░┐р░╣р▒Нр░ир░В
ЁЯЪЩ	р░╡р░╛р░╣р░ир░В, р░╡р░┐р░ир▒Лр░ж р░╡р░╛р░╣р░ир░В, р░╡р░┐р░ир▒Лр░жр░В
ЁЯЪЪ	р░╡р░╕р▒Нр░др▒Бр░╡р▒Б, р░╡р░╕р▒Нр░др▒Бр░╡р▒Бр░▓ р░╕р░░р░лр░░р░╛ р░╡р░╛р░╣р░ир░В, р░╡р░╛р░╣р░ир░В
ЁЯЪЫ	р░Яр▒Нр░░р▒Ир░▓р░░р▒Н, р░Яр▒Нр░░р▒Ир░▓р░░р▒НтАМр░др▒Л р░кр░╛р░Яр▒Бр░Чр░╛ р░Йр░ир▒Нр░и р░▓р░╛р░░р▒А, р░▓р░╛р░░р▒А
ЁЯЪЬ	р░Яр▒Нр░░р░╛р░Хр▒Нр░Яр░░р▒Н, р░╡р░╛р░╣р░ир░В
ЁЯЫ┤	р░Хр░┐р░Хр▒Н, р░Хр░┐р░Хр▒Н р░╕р▒Нр░Хр▒Вр░Яр░░р▒Н, р░╕р▒Нр░Хр▒Вр░Яр░░р▒Н
ЁЯЫ╣	р░мр▒Лр░░р▒Нр░бр▒Н, р░╕р▒Нр░Хр▒Зр░Яр▒НтАМр░мр▒Лр░░р▒Нр░бр▒Н
ЁЯЫ╡	р░ор▒Лр░Яр░╛р░░р▒Н, р░ор▒Лр░Яр░╛р░░р▒Н р░╕р▒Нр░Хр▒Вр░Яр░░р▒Н, р░╕р▒Нр░Хр▒Вр░Яр░░р▒Н
ЁЯЪП	р░мр░╕р▒Нр░╕р▒Б, р░мр░╕р▒Нр░╕р▒Бр░▓р▒Б р░ир░┐р░▓р▒Бр░кр▒Б р░╕р▒Нр░ер░▓р░В, р░╕р▒Нр░ер░▓р░В
ЁЯЪи	р░Ор░░р▒Бр░кр▒Б, р░кр▒Лр░▓р▒Ар░╕р▒Б, р░кр▒Лр░▓р▒Ар░╕р▒Б р░╡р░╛р░╣р░ир░╛р░▓р░кр▒И р░др░┐р░░р░┐р░Чр▒З р░Ор░░р▒Бр░кр▒Б р░▓р▒Ир░Яр▒Н, р░▓р▒Ир░Яр▒Н, р░╡р░╛р░╣р░ир░В
ЁЯЪе	р░Ер░бр▒Нр░бр▒Б р░Яр▒Нр░░р░╛р░лр░┐р░Хр▒Н р░▓р▒Ир░Яр▒Н, р░Яр▒Нр░░р░лр░┐р░Хр▒Н, р░▓р▒Ир░Яр▒Н
ЁЯЪж	р░Яр▒Нр░░р░╛р░лр░┐р░Хр▒Н, р░ир░┐р░▓р▒Бр░╡р▒Б р░Яр▒Нр░░р░╛р░лр░┐р░Хр▒Н р░▓р▒Ир░Яр▒Н, р░▓р▒Ир░Яр▒Н
ЁЯЫС	р░Ер░╖р▒Нр░Яр░Хр▒Лр░г, р░Жр░Чр▒Бр░ор▒Б, р░Жр░Чр▒Бр░ор▒Б р░Ър░┐р░╣р▒Нр░ир░В, р░Ър░┐р░╣р▒Нр░ир░В
ЁЯЪз	р░ир░┐р░░р▒Нр░ор░╛р░гр░В, р░ир░┐р░░р▒Нр░ор░╛р░гр░Вр░▓р▒Л р░Йр░ир▒Нр░и р░нр░╡р░ир░В, р░нр░╡р░ир░В
ЁЯЫ╢	р░Хр░╛р░ир▒Б, р░Ър░┐р░ир▒Нр░и р░кр░бр░╡, р░кр░бр░╡
ЁЯЪд	р░кр░бр░╡, р░╕р▒Нр░кр▒Ар░бр▒Н, р░╕р▒Нр░кр▒Ар░бр▒Н р░кр░бр░╡
ЁЯЪв	р░Ур░б, р░ир▒Мр░Х
ЁЯЫл	р░мр░пр░▓р▒Бр░жр▒Зр░░р░┐р░и р░╡р░┐р░ор░╛р░ир░В, р░мр░пр░▓р▒Бр░жр▒Зр░░р▒Бр░Я, р░╡р░┐р░ор░╛р░ир░В
ЁЯЫм	р░Хр▒Нр░░р░┐р░Вр░жр░Хр░┐, р░Хр▒Нр░░р░┐р░Вр░жр░Хр░┐ р░жр░┐р░Чр▒Бр░др▒Бр░ир▒Нр░и р░╡р░┐р░ор░╛р░ир░В, р░╡р░┐р░ор░╛р░ир░В
ЁЯТ║	р░Жр░╕р░ир░В, р░Хр▒Бр░░р▒Нр░Ър▒А, р░╕р▒Ар░Яр▒Б
ЁЯЪБ	р░╣р▒Жр░▓р░┐р░Хр░╛р░кр▒Нр░Яр░░р▒Н, р░╣р▒Жр░▓р░┐р░Хр░╛р░лр▒Нр░Яр░░р▒Н
ЁЯЪЯ	р░кр░Яр▒Нр░Яр░╛р░▓ р░Хр▒Нр░░р░┐р░Вр░ж р░╡р▒Зр░▓р░╛р░бр▒Бр░др▒В р░кр▒Нр░░р░пр░╛р░гр░┐р░Вр░Ър▒З р░░р▒Ир░▓р▒Б, р░кр░Яр▒Нр░Яр░╛р░▓р▒Б, р░кр▒Нр░░р░пр░╛р░гр░В, р░░р▒Ир░▓р▒Б
ЁЯЪа	р░др▒Ар░Ч, р░кр░░р▒Нр░╡р░др░В, р░кр░░р▒Нр░╡р░др░╛р░▓ р░др▒Ар░Чр░▓ р░ор░╛р░░р▒Нр░Чр░В, р░кр▒Нр░░р░пр░╛р░гр░В
ЁЯЪб	р░Чр░╛р░▓р░┐, р░Чр░╛р░▓р░┐р░▓р▒Л р░др▒Ар░Чр░▓р░кр▒И р░кр▒Нр░░р░пр░╛р░гр░В, р░др▒Ар░Ч, р░кр▒Нр░░р░пр░╛р░гр░В
ЁЯЪА	р░░р░╛р░Хр▒Жр░Яр▒Н, р░░р▒Лр░жр░╕р▒А, р░╡р░╛р░╣р░ир░В
ЁЯЫ╕	р░Ор░Чр░┐р░░р▒З р░кр░│р▒Нр░▓р▒Жр░В
ЁЯз│	р░кр▒Нр░пр░╛р░Хр░┐р░Вр░Чр▒Н, р░кр▒Нр░░р░пр░╛р░гр░В, р░▓р░Чр▒Зр░Ьр▒А
тП░	р░Ер░▓р░╛р░░р░В, р░Ер░▓р░╛р░░р░В р░Чр░бр░┐р░пр░╛р░░р░В, р░Чр░бр░┐р░пр░╛р░░р░В
ЁЯХз	р░Чр░Вр░Я, р░Чр░бр░┐р░пр░╛р░░р░В, р░кр░ир▒Нр░ир▒Жр░Вр░бр▒Бр░ир▒Нр░ир░░, р░кр░ир▒Нр░ир▒Жр░Вр░бр▒Бр░ир▒Нр░ир░░ р░╕р▒Вр░Ър░┐р░Вр░Ър▒З р░Чр░бр░┐р░пр░╛р░░р░В
ЁЯХЬ	р░Тр░Хр░Яр░┐р░ир▒Нр░ир░░, р░Тр░Хр░Яр░┐р░ир▒Нр░ир░░ р░╕р▒Вр░Ър░┐р░Вр░Ър▒З р░Чр░бр░┐р░пр░╛р░░р░В, р░Чр░Вр░Я, р░Чр░бр░┐р░пр░╛р░░р░В
ЁЯХЭ	р░Чр░Вр░Я, р░Чр░бр░┐р░пр░╛р░░р░В, р░░р▒Жр░Вр░бр▒Бр░ир▒Нр░ир░░, р░░р▒Жр░Вр░бр▒Бр░ир▒Нр░ир░░ р░╕р▒Вр░Ър░┐р░Вр░Ър▒З р░Чр░бр░┐р░пр░╛р░░р░В
ЁЯХЮ	р░Чр░Вр░Я, р░Чр░бр░┐р░пр░╛р░░р░В, р░ор▒Вр░бр▒Бр░ир▒Нр░ир░░, р░ор▒Вр░бр▒Бр░ир▒Нр░ир░░ р░╕р▒Вр░Ър░┐р░Вр░Ър▒З р░Чр░бр░┐р░пр░╛р░░р░В
ЁЯХЯ	р░Чр░Вр░Я, р░Чр░бр░┐р░пр░╛р░░р░В, р░ир░╛р░▓р▒Бр░Чр▒Бр░ир▒Нр░ир░░, р░ир░╛р░▓р▒Бр░Чр▒Бр░ир▒Нр░ир░░ р░╕р▒Вр░Ър░┐р░Вр░Ър▒З р░Чр░бр░┐р░пр░╛р░░р░В
ЁЯХа	р░Рр░жр▒Бр░ир▒Нр░ир░░, р░Рр░жр▒Бр░ир▒Нр░ир░░ р░╕р▒Вр░Ър░┐р░Вр░Ър▒З р░Чр░бр░┐р░пр░╛р░░р░В, р░Чр░Вр░Я, р░Чр░бр░┐р░пр░╛р░░р░В
ЁЯХб	р░Жр░░р▒Бр░ир▒Нр░ир░░, р░Жр░░р▒Бр░ир▒Нр░ир░░ р░╕р▒Вр░Ър░┐р░Вр░Ър▒З р░Чр░бр░┐р░пр░╛р░░р░В, р░Чр░Вр░Я, р░Чр░бр░┐р░пр░╛р░░р░В
ЁЯХв	р░Пр░бр▒Бр░ир▒Нр░ир░░, р░Пр░бр▒Бр░ир▒Нр░ир░░ р░╕р▒Вр░Ър░┐р░Вр░Ър▒З р░Чр░бр░┐р░пр░╛р░░р░В, р░Чр░Вр░Я, р░Чр░бр░┐р░пр░╛р░░р░В
ЁЯХг	р░Ор░ир░┐р░ор░┐р░жр░┐р░ир▒Нр░ир░░, р░Ор░ир░┐р░ор░┐р░жр░┐р░ир▒Нр░ир░░ р░╕р▒Вр░Ър░┐р░Вр░Ър▒З р░Чр░бр░┐р░пр░╛р░░р░В, р░Чр░Вр░Я, р░Чр░бр░┐р░пр░╛р░░р░В
ЁЯХд	р░Чр░Вр░Я, р░Чр░бр░┐р░пр░╛р░░р░В, р░др▒Кр░ор▒Нр░ор░┐р░жр░┐р░ир▒Нр░ир░░, р░др▒Кр░ор▒Нр░ор░┐р░жр░┐р░ир▒Нр░ир░░ р░╕р▒Вр░Ър░┐р░Вр░Ър▒З р░Чр░бр░┐р░пр░╛р░░р░В
ЁЯХе	р░Чр░Вр░Я, р░Чр░бр░┐р░пр░╛р░░р░В, р░кр░жр░┐р░ир▒Нр░ир░░, р░кр░жр░┐р░ир▒Нр░ир░░ р░╕р▒Вр░Ър░┐р░Вр░Ър▒З р░Чр░бр░┐р░пр░╛р░░р░В
ЁЯХж	р░Чр░Вр░Я, р░Чр░бр░┐р░пр░╛р░░р░В, р░кр░жр░Хр▒Кр░Вр░бр▒Бр░ир▒Нр░ир░░, р░кр░жр░Хр▒Кр░Вр░бр▒Бр░ир▒Нр░ир░░ р░╕р▒Вр░Ър░┐р░Вр░Ър▒З р░Чр░бр░┐р░пр░╛р░░р░В
ЁЯМС	р░Ер░ор░╛р░╡р░╛р░╕р▒Нр░п, р░Ър░Вр░жр▒Нр░░р▒Бр░бр▒Б
ЁЯМТ	р░Ър░Вр░жр▒Нр░░р▒Бр░бр▒Б, р░кр▒Жр░░р▒Бр░Чр▒Б, р░кр▒Жр░░р▒Бр░Чр▒Бр░др▒Бр░ир▒Нр░и р░Ър░Вр░жр▒Нр░░р▒Бр░бр▒Б
ЁЯМУ	р░Ър░Вр░жр▒Нр░░р▒Бр░бр▒Б, р░ир░╛р░▓р▒Бр░Чр░╡, р░ор▒Кр░жр░Яр░┐ р░ир░╛р░▓р▒Бр░Чр░╡ р░╡р░Вр░др▒Б р░Ър░Вр░жр▒Нр░░р▒Бр░бр▒Б
ЁЯМФ	р░Йр░мр▒Нр░мр▒Жр░др▒Нр░др▒Бр░Чр░╛, р░Йр░мр▒Нр░мр▒Жр░др▒Нр░др▒Бр░Чр░╛ р░Йр░ир▒Нр░и р░Ър░Вр░жр▒Нр░░р▒Бр░бр▒Б, р░Ър░Вр░жр▒Нр░░р▒Бр░бр▒Б
ЁЯМЦ	р░Ър░Вр░жр▒Нр░░р▒Бр░бр▒Б, р░др░░р▒Бр░Чр▒Б, р░др░░р▒Бр░Чр▒Бр░др▒Бр░ир▒Нр░и р░Ър░Вр░жр▒Нр░░р▒Бр░бр▒Б
ЁЯМЧ	р░Ър░Вр░жр▒Нр░░р▒Бр░бр▒Б, р░Ър░┐р░╡р░░р░┐ р░ир░╛р░▓р▒Бр░Чр░╡ р░╡р░Вр░др▒Б р░Ър░Вр░жр▒Нр░░р▒Бр░бр▒Б, р░ир░╛р░▓р▒Бр░Чр░╡
ЁЯМШ	р░Ър░Вр░жр▒Нр░░р▒Бр░бр▒Б, р░др░Чр▒Нр░Чр▒Б, р░др░Чр▒Нр░Чр▒Бр░др▒Бр░ир▒Нр░и р░Ър░Вр░жр▒Нр░░р▒Бр░бр▒Б
ЁЯМЩ	р░Ер░░р▒Нр░зр░Ър░Вр░жр▒Нр░░р▒Бр░бр▒Б, р░Ър░Вр░жр▒Нр░░р░╡р░Вр░Х, р░ир▒Жр░▓р░╡р░Вр░Х
ЁЯМЪ	р░Ер░ор░╛р░╡р░╛р░╕р▒Нр░п, р░Ер░ор░╛р░╡р░╛р░╕р▒Нр░п р░Ър░Вр░жр▒Нр░░р▒Бр░ир░┐ р░ор▒Бр░Цр░В, р░Ър░Вр░жр▒Нр░░р▒Бр░бр▒Б, р░ор▒Бр░Цр░В
ЁЯМЫ	р░Ър░Вр░жр▒Нр░░р▒Бр░бр▒Б, р░ир░╛р░▓р▒Бр░Чр░╡, р░ир░╛р░▓р▒Бр░Чр░╡ р░╡р░Вр░др▒Б р░Ър░Вр░жр▒Нр░░р▒Бр░ир░┐ р░ор▒Бр░Цр░В, р░ор▒Бр░Цр░В
ЁЯМЭ	р░кр▒Вр░░р▒Нр░г р░Ър░Вр░жр▒Нр░░р▒Бр░бр▒Б, р░кр▒Вр░░р▒Нр░г р░Ър░Вр░жр▒Нр░░р▒Бр░ир░┐ р░ор▒Бр░Цр░В, р░ор▒Бр░Цр░В
ЁЯМЮ	р░ор▒Бр░Цр░В, р░╕р▒Вр░░р▒Нр░п р░ор▒Бр░Цр░В, р░╕р▒Вр░░р▒Нр░пр▒Бр░бр▒Б
ЁЯМЯ	р░ир░Хр▒Нр░╖р░др▒Нр░░р░В, р░ор▒Жр░░р░┐р░╕р▒З, р░ор▒Жр░░р░┐р░╕р▒З р░ир░Хр▒Нр░╖р░др▒Нр░░р░В
ЁЯМа	р░Йр░▓р▒Нр░Х, р░Йр░▓р▒Нр░Х р░ир▒Зр░▓ р░░р░╛р░▓р░бр░В, р░ир▒Зр░▓
ЁЯМА	р░Хр░│р▒Нр░▓р▒Б р░др░┐р░░р░Чр░бр░В, р░др▒Бр░лр░╛р░ир▒Б, р░╡р░╢р▒Ар░Хр░░р░г, р░╕р▒Бр░бр░┐р░Чр▒Бр░Вр░бр░В, р░╣р░┐р░кр▒Нр░ир░╛р░Яр░┐р░Ьр░ор▒Н
ЁЯМИ	р░Зр░Вр░жр▒Нр░░р░зр░ир▒Бр░╕р▒Нр░╕р▒Б, р░╡р░┐р░▓р▒Нр░▓р▒Б
ЁЯМВ	р░Чр▒Кр░бр▒Бр░Чр▒Б, р░ор▒Вр░пр░мр░бр░┐р░и, р░ор▒Вр░╕р░┐р░╡р▒Зр░╕р░┐р░и р░Чр▒Кр░бр▒Бр░Чр▒Б
ЁЯФе	р░Ер░Чр▒Нр░ир░┐, р░ир░┐р░кр▒Нр░кр▒Б, р░ор░Вр░Я
ЁЯТз	р░ир▒Ар░Яр░┐р░мр▒Кр░Яр▒Нр░Яр▒Б, р░ир▒Ар░░р▒Б, р░мр▒Кр░Яр▒Нр░Яр▒Б
ЁЯМК	р░Ер░▓, р░╕р░ор▒Бр░жр▒Нр░░р░В, р░╕р░ор▒Бр░жр▒Нр░░р░кр▒Б р░Ер░▓
ЁЯОГ	р░Чр▒Бр░ор▒Нр░ор░бр░┐, р░Ьр░кр░ир▒Ар░╕р▒Н р░Чр▒Бр░ор▒Нр░ор░бр░┐р░Хр░╛р░п, р░Ьр░кр░╛р░ир▒Н
ЁЯОД	р░Хр▒Нр░░р░┐р░╕р▒Нр░ор░╕р▒Н, р░Хр▒Нр░░р░┐р░╕р▒Нр░ор░╕р▒Н р░Ър▒Жр░Яр▒Нр░Яр▒Б, р░Ър▒Жр░Яр▒Нр░Яр▒Б
ЁЯОЖ	р░Яр░кр░╛р░╕р▒Бр░▓р▒Б, р░╡р▒Зр░бр▒Бр░Х
ЁЯОЗ	р░Яр░кр░╛р░╕р▒Бр░▓р▒Б, р░ор▒Жр░░р▒Бр░кр▒Б, р░ор▒Жр░░р▒Бр░кр▒Бр░▓р▒Б р░╡р░Ър▒Нр░Ър▒З р░Яр░кр░╛р░╕р▒Бр░▓р▒Б
ЁЯзи	р░Яр░кр░╛р░Хр░╛р░пр░▓р▒Б, р░Яр░кр░╛р░╕р▒Бр░▓р▒Б, р░бр▒Ир░ир░ор▒Ир░Яр▒Н, р░кр▒Зр░▓р▒Бр░бр▒Бр░кр░жр░╛р░░р▒Нр░ер░╛р░▓р▒Б
тЬи	р░Ър░┐р░ир▒Нр░и, р░Ър░┐р░ир▒Нр░и р░Ър░┐р░ир▒Нр░и р░ор▒Жр░░р▒Бр░кр▒Бр░▓р▒Б, р░ор▒Жр░░р▒Бр░кр▒Б
ЁЯОИ	р░Чр░╛р░▓р░┐, р░Чр░╛р░▓р░┐ р░мр▒Бр░бр░Ч, р░мр▒Бр░бр░Ч
ЁЯОЙ	р░кр░╛р░кр░░р▒Н, р░кр░╛р░░р▒Нр░Яр▒А, р░кр░╛р░░р▒Нр░Яр▒А р░кр░╛р░кр░░р▒Н, р░кр░╛р░░р▒Нр░Яр▒Ар░▓р▒Нр░▓р▒Л р░зр░░р░┐р░Вр░Ър▒З р░╢р░Вр░Хр░В р░Жр░Хр░╛р░░ р░Яр▒Лр░кр▒А
ЁЯОК	р░мр░╛р░▓р▒Н, р░░р░Вр░Чр▒Б р░Хр░╛р░Чр░┐р░др░╛р░▓р▒Б, р░░р░Вр░Чр▒Б р░Хр░╛р░Чр░┐р░др░╛р░▓р▒Б р░ир░┐р░Вр░кр░┐р░и р░мр░Вр░др░┐, р░╡р▒Зр░бр▒Бр░Хр░▓р▒Б
ЁЯОЛ	р░Хр░╛р░Чр░┐р░др░кр▒Б р░кр▒Зр░▓р░┐р░Хр░▓р▒Б, р░Хр░╛р░Чр░┐р░др░╛р░▓р▒Б р░╡р▒Зр░▓р░╛р░бр░жр▒Ар░╕р░┐р░и р░Ър▒Жр░Яр▒Нр░Яр▒Б, р░Яр░╛р░ир░╛р░мр▒Зр░Яр░╛ р░Ър▒Жр░Яр▒Нр░Яр▒Б, р░ир░Хр▒Нр░╖р░др▒Нр░░р░╛р░▓ р░кр░Вр░бр▒Бр░Ч, р░╡р▒Гр░Хр▒Нр░╖р░В, р░╡р▒Зр░бр▒Бр░Х
ЁЯОН	р░Ьр░кр░ир▒Ар░╕р▒Н, р░жр▒Зр░╡р░жр░╛р░░р▒Б р░Ър▒Жр░Яр▒Нр░Яр▒Б, р░жр▒Зр░╡р░жр░╛р░░р▒Б р░╡р▒Гр░Хр▒Нр░╖р░В р░Ер░▓р░Вр░Хр░░р░г, р░ир▒Вр░др░и р░╕р░Вр░╡р░др▒Нр░╕р░░р░В, р░╡р▒Зр░бр▒Бр░Хр░▓р▒Б
ЁЯОО	р░Ьр░кр░ир▒Ар░╕р▒Н, р░кр░Вр░бр▒Бр░Ч, р░мр▒Кр░ор▒Нр░ор░▓ р░жр░┐р░ир▒Лр░др▒Нр░╕р░╡р░В, р░мр▒Кр░ор▒Нр░ор░▓р▒Б, р░ор░Ч р░ор░░р░┐р░пр▒Б р░Жр░б р░Ьр░кр░ир▒Ар░╕р▒Н р░мр▒Кр░ор▒Нр░ор░▓р▒Б, р░ор░Ч р░ор░░р░┐р░пр▒Б р░Жр░б р░мр▒Кр░ор▒Нр░ор░▓р▒Б, р░╡р▒Зр░бр▒Бр░Хр░▓р▒Б
ЁЯОП	р░Хр░╛р░пр░┐р░ир▒Лр░мр▒Лр░░р▒А, р░Хр░╛р░░р▒Нр░кр▒Н р░╕р▒Нр░Яр▒Нр░░р▒Ар░ор░░р▒Н, р░Чр░╛р░▓р▒Нр░▓р▒Л р░Чр▒Бр░Вр░бр▒Б р░Ър▒Зр░к р░Жр░Хр░╛р░░р░╛р░▓р▒Нр░▓р▒Л р░╕р░╛р░Хр▒Нр░╕р▒Бр░▓р▒Б р░Ор░Чр░░р▒Зр░пр░бр░В, р░╡р▒Зр░бр▒Бр░Хр░▓р▒Б
ЁЯОР	р░Чр░Вр░Яр░▓р▒Б, р░Чр░╛р░▓р░┐р░Хр░┐ р░ор▒Нр░░р▒Лр░Чр▒З р░Чр░Вр░Яр░▓р▒Б, р░╡р░┐р░Вр░бр▒Н р░Ър▒Ар░ор▒Н
ЁЯОС	р░Ър░Вр░жр▒Нр░░ р░╡р▒Ар░Хр▒Нр░╖р░г р░Йр░др▒Нр░╕р░╡р░В, р░Ър░Вр░жр▒Нр░░р▒Бр░бр░┐р░ир░┐ р░Ър▒Вр░бр░Яр░В, р░Ър░Вр░жр▒Нр░░р▒Бр░бр▒Б, р░╡р▒Зр░бр▒Бр░Хр░▓р▒Б
ЁЯзз	р░бр░мр▒Нр░мр▒Б, р░мр░╣р▒Бр░ор░др░┐, р░░р▒Жр░бр▒Н р░Ор░ир▒Нр░╡р░▓р░кр▒Н, р░╢р▒Бр░нр░В
ЁЯОА	р░░р░┐р░мр▒Нр░мр░ир▒Н, р░╡р▒Зр░бр▒Бр░Х
ЁЯОБ	р░Ер░▓р░Вр░Хр░╛р░░ р░Хр░╛р░Чр░┐р░др░В р░Ър▒Бр░Яр▒Нр░Яр░┐р░ир░жр░┐, р░Ер░▓р░Вр░Хр░╛р░░ р░Хр░╛р░Чр░┐р░др░Вр░др▒Л р░Ър▒Бр░Яр▒Нр░Яр░┐р░и р░мр░╣р▒Бр░ор░др░┐, р░мр░╣р▒Бр░ор░др░┐, р░╡р▒Зр░бр▒Бр░Х
ЁЯОл	р░Яр░┐р░Хр▒Нр░Хр▒Жр░Яр▒Н, р░кр▒Нр░░р░╡р▒Зр░╢ р░Ър▒Ар░Яр▒А, р░╡р░┐р░ир▒Лр░жр░В
ЁЯПЕ	р░Хр▒Нр░░р▒Ар░бр░▓р▒Б, р░Хр▒Нр░░р▒Ар░бр░╛ р░кр░др░Хр░В, р░кр░др░Хр░В, р░ор▒Жр░бр░▓р▒Н
ЁЯеЗ	1р░╡ р░╕р▒Нр░ер░╛р░и р░кр░др░Хр░В, р░мр░Вр░Чр░╛р░░р▒Б, р░ор▒Жр░бр░▓р▒Н, р░ор▒Кр░жр░Яр░┐ р░╕р▒Нр░ер░╛р░ир░В
ЁЯеИ	2р░╡ р░╕р▒Нр░ер░╛р░и р░кр░др░Хр░В, р░ор▒Жр░бр░▓р▒Н, р░░р▒Жр░Вр░бр▒Л р░╕р▒Нр░ер░╛р░ир░В, р░╡р▒Жр░Вр░бр░┐
ЁЯеЙ	3р░╡ р░╕р▒Нр░ер░╛р░и р░кр░др░Хр░В, р░ор▒Вр░бр▒Л р░╕р▒Нр░ер░╛р░ир░В, р░ор▒Жр░бр░▓р▒Н, р░░р░Ьр░др░В
ЁЯеО	р░Ер░Вр░бр░░р▒Нр░Жр░░р▒Нр░ор▒Н, р░Чр▒Нр░▓р▒Лр░╡р▒Н, р░мр░╛р░▓р▒Н, р░╕р░╛р░лр▒Нр░Яр▒НтАМр░мр░╛р░▓р▒Н
ЁЯПА	р░Хр▒Нр░░р▒Ар░б, р░мр░╛р░▓р▒Н, р░мр░╛р░╕р▒Нр░Хр▒Жр░Яр▒Н, р░мр░╛р░╕р▒Нр░Хр▒Жр░Яр▒НтАМр░мр░╛р░▓р▒Н
ЁЯПР	р░Жр░Я, р░мр░╛р░▓р▒Н, р░╡р░╛р░▓р▒Ар░мр░╛р░▓р▒Н
ЁЯПИ	р░Ер░ор▒Жр░░р░┐р░Хр░ир▒Н, р░Ер░ор▒Жр░░р░┐р░Хр░ир▒Н р░лр▒Бр░Яр▒НтАМр░мр░╛р░▓р▒Н, р░Хр▒Нр░░р▒Ар░б, р░мр░╛р░▓р▒Н
ЁЯПЙ	р░Хр▒Нр░░р▒Ар░б, р░мр░╛р░▓р▒Н, р░░р░Чр▒Нр░мр▒А р░лр▒Бр░Яр▒НтАМр░мр░╛р░▓р▒Н, р░╕р░╛р░Хр░░р▒Н
ЁЯО╛	р░Хр▒Нр░░р▒Ар░б, р░Яр▒Жр░ир▒Нр░ир░┐р░╕р▒Н, р░Яр▒Жр░ир▒Нр░ир░┐р░╕р▒Н р░░р░╛р░Хр▒Жр░Яр▒Н р░ор░░р░┐р░пр▒Б р░мр░Вр░др░┐, р░мр░Вр░др░┐
ЁЯеП	р░Ер░др▒Нр░пр▒Бр░др▒Нр░др░ор░В, р░лр▒Нр░▓р░пр░┐р░Вр░Чр▒Н р░бр░┐р░╕р▒Нр░Хр▒Н
ЁЯО│	р░Жр░Я, р░мр░Вр░др░╛р░Я, р░мр▒Мр░▓р░┐р░Вр░Чр▒Н
ЁЯПП	р░Жр░Я, р░Хр▒Нр░░р░┐р░Хр▒Жр░Яр▒Н р░Чр▒Зр░ор▒Н, р░мр░╛р░▓р▒Н, р░мр▒Нр░пр░╛р░Яр▒Н
ЁЯПС	р░Жр░Я, р░лр▒Ар░▓р▒Нр░бр▒Н р░╣р░╛р░Хр▒А, р░мр░╛р░▓р▒Н, р░╣р░╛р░Хр▒А р░╕р▒Нр░Яр░┐р░Хр▒Н
ЁЯПТ	р░Жр░Я, р░Рр░╕р▒Н р░╣р░╛р░Хр▒А, р░ор░Вр░Ър▒Б, р░╣р░╛р░Хр▒А р░╕р▒Нр░Яр░┐р░Хр▒Н
ЁЯеН	р░Чр▒Лр░▓р▒Н, р░мр░╛р░▓р▒Н, р░▓р░╛р░Хр▒Нр░░р▒Лр░╕р▒Н, р░╕р▒Нр░Яр░┐р░Хр▒Н
ЁЯПУ	р░Яр▒Зр░мр▒Бр░▓р▒Н р░Яр▒Жр░ир▒Нр░ир░┐р░╕р▒Н, р░кр░┐р░Вр░Чр▒Н р░кр░╛р░Вр░Чр▒Н, р░кр▒Нр░пр░╛р░бр░┐р░▓р▒Н, р░мр▒Нр░пр░╛р░Яр▒Н
ЁЯП╕	р░Жр░Я, р░Хр░╛р░Хр▒Н, р░мр▒Нр░пр░╛р░бр▒Нр░ор░┐р░Вр░Яр░ир▒Н, р░░р░╛р░Хр▒Жр░Яр▒Н
ЁЯеК	р░Хр▒Нр░░р▒Ар░б, р░Чр▒Нр░▓р░╡р▒Н, р░мр░╛р░Хр▒Нр░╕р░┐р░Вр░Чр▒Н, р░мр░╛р░Хр▒Нр░╕р░┐р░Вр░Чр▒Н р░Чр▒Нр░▓р░╡р▒Н
ЁЯеЛ	р░Хр░░р░╛р░Яр▒З, р░Хр▒Нр░░р▒Ар░б, р░Ьр▒Вр░бр▒Л, р░др▒Ир░Хр▒Нр░╡р░╛р░Вр░бр▒Л, р░ор░╛р░░р▒Нр░╖р░▓р▒Н р░Жр░░р▒Нр░Яр▒Нр░╕р▒Н, р░ор░╛р░░р▒Нр░╖р░▓р▒Н р░Жр░░р▒Нр░Яр▒Нр░╕р▒Н р░пр▒Вр░ир░┐р░лр░╛р░ор▒Н, р░пр▒Вр░ир░┐р░лр░╛р░ор▒Н
ЁЯеЕ	р░Хр▒Нр░░р▒Ар░б, р░Чр▒Лр░▓р▒Н, р░Чр▒Лр░▓р▒Н р░ир▒Жр░Яр▒Н, р░ир▒Жр░Яр▒Н
ЁЯОг	р░Чр▒Зр░▓р░╛р░ир░┐р░Хр░┐ р░Ър░┐р░Хр▒Нр░Хр░┐р░и р░Ър▒Зр░к, р░Ър▒Зр░к, р░Ър▒Зр░кр░▓р▒Б р░кр░Яр▒Нр░Яр░бр░В, р░Ър▒Зр░кр░▓р▒Б р░кр░Яр▒Нр░Яр▒З р░Чр▒Зр░▓р░В, р░Яр▒Ир░ор▒Н р░кр░╛р░╕р▒Н, р░╡р░┐р░ир▒Лр░жр░В
ЁЯО╜	р░Хр▒Нр░░р▒Ар░б, р░Ър▒Кр░Хр▒Нр░Хр░╛, р░кр░Яр▒Нр░Яр▒Бр░жр░Яр▒Нр░Яр▒А, р░кр░░р░┐р░Чр▒Жр░др▒Нр░др▒Зр░Яр░кр▒Нр░кр▒Бр░бр▒Б р░зр░░р░┐р░Вр░Ър▒З р░Ър▒Кр░Хр▒Нр░Хр░╛, р░кр░░р░┐р░Чр▒Жр░др▒Нр░др▒Зр░Яр░кр▒Нр░кр▒Бр░бр▒Б р░зр░░р░┐р░Вр░Ър▒З р░кр░Яр▒Нр░Яр▒Бр░жр░Яр▒Нр░Яр▒А р░Чр░▓ р░Ър▒Кр░Хр▒Нр░Хр░╛, р░кр░░р▒Бр░Чр▒Б, р░кр░░р▒Бр░Чр▒Б р░кр░Вр░жр▒Жр░ор▒Бр░▓р▒Нр░▓р▒Л р░зр░░р░┐р░Вр░Ър▒З р░Ър▒Кр░Хр▒Нр░Хр░╛
ЁЯО┐	р░ор░Вр░Ър▒Бр░кр▒И р░Ьр░╛р░░р░бр░╛р░ир░┐р░Хр░┐ р░Йр░кр░пр▒Лр░Чр░┐р░Вр░Ър▒З р░╕р░╛р░зр░ир░В р░ор░░р░┐р░пр▒Б р░мр▒Вр░Яр▒Нр░▓р▒Б, р░╕р▒Нр░Хр▒Ар░пр░┐р░Вр░Чр▒Н р░Йр░кр░Хр░░р░гр░╛р░▓р▒Б
ЁЯЫ╖	р░Чр▒Бр░░р▒Нр░░р░кр▒Б р░мр░Вр░бр░┐, р░кр▒Жр░жр▒Нр░ж, р░╕р▒Нр░▓р▒Жр░бр▒Н
ЁЯеМ	р░Жр░Я, р░Хр░░р▒Нр░▓р░┐р░Вр░Чр▒Н р░╕р▒Нр░Яр▒Лр░ир▒Н, р░░р░╛р░пр░┐
ЁЯОп	р░Жр░Я, р░бр▒Ир░░р▒Жр░Хр▒Нр░Яр▒Н р░╣р░┐р░Яр▒Н, р░мр░╛р░гр░В, р░╕р░░р░┐р░Чр▒Нр░Чр░╛ р░▓р░Хр▒Нр░╖р▒Нр░пр░╛р░ир▒Нр░ир░┐ р░Хр▒Кр░Яр▒Нр░Яр░бр░В
ЁЯО▒	р░Ор░ир░┐р░ор░┐р░жр░┐ р░мр░Вр░др▒Бр░▓р▒Б, р░Чр▒Зр░ор▒Н, р░жр░Вр░др░кр▒Б р░Чр▒Бр░Вр░бр▒Нр░▓р░╛р░Я, р░мр░┐р░▓р░┐р░пр░░р▒Нр░бр▒Нр░╕р▒Н, р░░р░Вр░Чр▒Бр░░р░Вр░Чр▒Бр░▓ р░мр░Вр░др▒Бр░▓р▒Б
ЁЯФо	р░Ьр▒Нр░пр▒Лр░др░┐р░╖р▒Нр░пр▒Бр░бр▒Б, р░пр▒Лр░Чр░┐, р░╕р▒Нр░лр░Яр░┐р░Х р░мр░Вр░др░┐
ЁЯз┐	р░Ър▒Жр░бр▒Б р░жр▒Гр░╖р▒Нр░Яр░┐, р░др░╛р░пр░др▒Нр░др▒Б, р░жр░┐р░╖р▒Нр░Яр░┐, р░жр░┐р░╖р▒Нр░Яр░┐ р░░р░Хр▒Нр░╖, р░жр▒Гр░╖р▒Нр░Яр░┐, р░кр▒Вр░╕
ЁЯО░	р░ор▒Жр░╖р▒Ар░ир▒Н, р░╕р▒Нр░▓р░╛р░Яр▒Н, р░╕р▒Нр░▓р░╛р░Яр▒Н р░ор▒Жр░╖р▒Ар░ир▒Н
ЁЯО▓	р░Жр░Я, р░кр░╛р░Ър░┐р░Хр░▓р▒Б
ЁЯзй	р░Зр░Вр░Яр░░р▒НтАМр░▓р░╛р░Хр░┐р░Вр░Чр▒Н, р░Хр▒Нр░▓р▒В, р░Ьр░┐р░Чр▒Нр░╕р░╛, р░кр░Ьр░┐р░▓р▒Н, р░ор▒Бр░Хр▒Нр░Х
ЁЯз╕	р░Жр░Яр░╡р░╕р▒Нр░др▒Бр░╡р▒Б, р░Хр▒Вр░░р▒Нр░Ър░┐р░ир░жр░┐, р░Яр▒Жр░бр▒Нр░бр▒А р░мр▒Зр░░р▒Н, р░кр▒Нр░▓р░╖р▒Н, р░мр▒Кр░ор▒Нр░о
ЁЯГП	р░Ьр▒Лр░Хр░░р▒Н, р░Ьр▒Лр░Хр░░р▒Н р░Хр░╛р░░р▒Нр░бр▒Н, р░кр▒Зр░Хр░ор▒Бр░Хр▒Нр░Х, р░кр▒Зр░Хр░ор▒Бр░Хр▒Нр░Хр░кр▒И р░ир░▓р▒Бр░кр▒Бр░░р░Вр░Чр▒Б р░Ьр▒Лр░Хр░░р▒Н р░мр▒Кр░ор▒Нр░о
ЁЯО┤	р░Ьр░кр░ир▒Ар░╕р▒Н р░кр▒Зр░Х р░ор▒Бр░Хр▒Нр░Х, р░Ьр░кр░ир▒Ар░╕р▒Н р░кр▒Зр░Хр░╛р░Я, р░кр▒Бр░╡р▒Нр░╡р▒Бр░▓р▒Б, р░кр▒Бр░╡р▒Нр░╡р▒Бр░▓р▒Б р░Йр░Вр░бр▒З р░Хр░╛р░░р▒Нр░бр▒Н, р░╣р░ир░╛р░лр▒Бр░бр░╛
ЁЯОи	р░лр░▓р░Хр░В, р░░р░Вр░Чр▒Б, р░░р░Вр░Чр▒Бр░▓ р░лр░▓р░Хр░В
ЁЯз╡	р░Хр▒Бр░Яр▒Нр░Яр░бр░В, р░жр░╛р░░р░В, р░╕р▒Вр░жр░┐, р░╕р▒Нр░Яр▒Нр░░р░┐р░Вр░Чр▒Н, р░╕р▒Нр░кр▒Вр░▓р▒Н
ЁЯз╢	р░Ер░▓р▒Нр░▓р░┐р░Х, р░Хр▒Нр░░р▒Лр░Ър▒Жр░Яр▒Н, р░ир▒Вр░▓р▒Б, р░мр░Вр░др░┐
ЁЯФЗ	р░╡р░╛р░▓р▒Нр░пр▒Вр░ор▒Н р░ор▒Нр░пр▒Вр░Яр▒НтАМр░▓р▒Л р░Йр░Вр░жр░┐ р░Ър░┐р░╣р▒Нр░ир░В, р░╢р░мр▒Нр░жр░В р░Ър▒Зр░пр░╡р░жр▒Нр░жр▒Б р░Ър░┐р░╣р▒Нр░ир░В, р░╕р▒Нр░кр▒Ар░Хр░░р▒Н р░Жр░лр▒Н
ЁЯФЙ	р░др░Хр▒Нр░Хр▒Бр░╡ р░╢р░мр▒Нр░жр░В р░Ър▒Зр░пр░┐, р░ор░зр▒Нр░пр░╕р▒Нр░е р░╢р░мр▒Нр░жр░Вр░др▒Л р░╕р▒Нр░кр▒Ар░Хр░░р▒Н, р░╡р░╛р░▓р▒Нр░пр▒Вр░ор▒Н р░др░Чр▒Нр░Чр░┐р░Вр░Ър▒Б
ЁЯФК	р░Чр░░р░┐р░╖р▒Нр░Я р░╡р░╛р░▓р▒Нр░пр▒Вр░ор▒Н, р░кр▒Жр░жр▒Нр░ж р░╢р░мр▒Нр░жр░Вр░др▒Л р░╕р▒Нр░кр▒Ар░Хр░░р▒Н, р░╡р░╛р░▓р▒Нр░пр▒Вр░ор▒Н р░Ор░Хр▒Нр░Хр▒Бр░╡р░Чр░╛ р░Йр░Вр░жр░┐
ЁЯУв	р░нр░╛р░░р▒А р░▓р▒Мр░бр▒Н р░╕р▒Нр░кр▒Ар░Хр░░р▒Н, р░▓р▒Мр░бр▒НтАМр░╕р▒Нр░кр▒Ар░Хр░░р▒Н
ЁЯУг	р░ир░╡р▒Нр░╡р░бр░В, р░ор▒Жр░Чр░╛р░лр▒Лр░ир▒Н
ЁЯУп	р░Ер░др▒Нр░пр░╡р░╕р░░ р░ор▒Жр░пр░┐р░▓р▒Н р░╡р░╕р▒Нр░др▒Лр░Вр░жр░┐, р░кр▒Лр░╕р▒Нр░Яр░▓р▒Н р░╣р░╛р░░р░ир▒Н
ЁЯФФ	р░Чр░Вр░Я, р░░р░┐р░Вр░Чр░░р▒Н, р░╢р░мр▒Нр░жр░В р░Ър▒Зр░пр░╛р░▓р░┐ р░Ър░┐р░╣р▒Нр░ир░В
ЁЯФХ	р░Чр░Вр░Я р░Хр▒Кр░Яр▒Нр░Яр░╡р░жр▒Нр░жр▒Б, р░╢р░мр▒Нр░жр░В р░Ър▒Зр░пр░╡р░жр▒Нр░жр▒Б р░Ър░┐р░╣р▒Нр░ир░В, р░╢р░мр▒Нр░жр░В р░ир░┐р░▓р░┐р░кр░┐р░╡р▒Зр░пр░мр░бр░┐р░Вр░жр░┐
ЁЯО╝	р░░р░Ър░и, р░╕р░Вр░Чр▒Ар░д р░░р░Ър░и, р░╕р░Вр░Чр▒Ар░др░В
ЁЯО╡	р░╕р░Вр░Чр▒Ар░д р░╕р▒Нр░╡р░░р░В, р░╕р░Вр░Чр▒Ар░др░В, р░╕р▒Нр░╡р░░р░В
ЁЯО╢	р░╕р░Вр░Чр▒Ар░д р░╕р▒Нр░╡р░░р░╛р░▓р▒Б, р░╕р░Вр░Чр▒Ар░др░В, р░╕р▒Нр░╡р░░р░В, р░╕р▒Нр░╡р░░р░╛р░▓р▒Б
ЁЯОд	р░Хр░╛р░░р▒Лр░Хр▒З, р░кр▒Нр░░р░╕р░Вр░Чр░В, р░ор▒Ир░Хр▒Н, р░ор▒Ир░Хр▒Нр░░р▒Лр░лр▒Лр░ир▒Н, р░╡р░┐р░ир▒Лр░жр░В, р░╕р░Вр░Чр▒Ар░др░В
ЁЯО╖	р░мр▒Нр░пр░╛р░Вр░бр▒Н р░ор▒Зр░│ р░╡р░╛р░пр░┐р░жр▒Нр░пр░В, р░╢р░╛р░Хр▒Нр░╕р▒Лр░лр▒Лр░ир▒Н
ЁЯО╕	р░Чр░┐р░Яр░╛р░░р▒Н, р░╕р░Вр░Чр▒Ар░д р░кр░░р░┐р░Хр░░р░В, р░╕р░Вр░Чр▒Ар░др░В
ЁЯО╣	р░Хр▒Ар░мр▒Лр░░р▒Нр░бр▒Н, р░кр░┐р░пр░╛р░ир▒Л, р░╕р░Вр░Чр▒Ар░д р░Хр▒Ар░мр▒Лр░░р▒Нр░бр▒Н, р░╕р░Вр░Чр▒Ар░д р░кр░░р░┐р░Хр░░р░В, р░╕р░Вр░Чр▒Ар░др░В
ЁЯО║	р░Хр▒Кр░ор▒Нр░ор▒Б, р░Яр▒Нр░░р░Вр░кр▒Жр░Яр▒Н, р░мр░╛р░Хр░╛, р░мр▒Вр░░, р░╕р░Вр░Чр▒Ар░д р░кр░░р░┐р░Хр░░р░В, р░╕р░Вр░Чр▒Ар░др░В
ЁЯО╗	р░╡р░пр▒Кр░▓р░┐р░ир▒Н, р░╡р░пр▒Лр░▓р░┐р░ир▒Н, р░╕р░Вр░Чр▒Ар░д р░кр░░р░┐р░Хр░░р░В, р░╕р░Вр░Чр▒Ар░др░В
ЁЯеБ	р░бр▒Нр░░р░ор▒Н, р░бр▒Нр░░р░ор▒Н р░╕р▒Нр░Яр░┐р░Хр▒НтАМр░▓р▒Б, р░╕р░Вр░Чр▒Ар░др░В
ЁЯУ▒	р░Яр▒Жр░▓р▒Ар░лр▒Лр░ир▒Н, р░лр▒Лр░ир▒Н, р░ор▒Кр░мр▒Ир░▓р▒Н, р░ор▒Кр░мр▒Ир░▓р▒Н р░лр▒Лр░ир▒Н, р░╕р▒Жр░▓р▒Н
ЁЯУ▓	р░Зр░ир▒НтАМр░Хр░ор░┐р░Вр░Чр▒Н р░лр▒Лр░ир▒Н р░Хр░╛р░▓р▒Н, р░лр▒Лр░ир▒НтАМр░Хр▒Б р░╕р▒Зр░╡р▒Н р░Ър▒Зр░пр░┐, р░мр░╛р░гр░В р░Чр▒Бр░░р▒Нр░др▒Бр░др▒Л р░╕р▒Вр░Ър░┐р░╕р▒Нр░др▒Бр░ир▒Нр░и р░ор▒Кр░мр▒Ир░▓р▒Н р░лр▒Лр░ир▒Н
ЁЯУЮ	р░Яр▒Жр░▓р░┐р░лр▒Лр░ир▒Н р░░р░┐р░╕р▒Ар░╡р░░р▒Н, р░Яр▒Жр░▓р▒Ар░лр▒Лр░ир▒Н, р░лр▒Лр░ир▒Н, р░░р░┐р░╕р▒Ар░╡р░░р▒Н
ЁЯУа	р░лр▒Нр░пр░╛р░Хр▒Нр░╕р▒Н, р░лр▒Нр░пр░╛р░Хр▒Нр░╕р▒Н р░ор▒Жр░╖р▒Ар░ир▒Н
ЁЯФЛ	р░мр▒Нр░пр░╛р░Яр░░р▒А, р░мр▒Нр░пр░╛р░Яр░░р▒А р░Ър░┐р░╣р▒Нр░ир░В, р░мр▒Нр░пр░╛р░Яр░░р▒А р░╕р▒Вр░Ър░┐р░Х
ЁЯФМ	р░Ор░▓р░Хр▒Нр░Яр▒Нр░░р░┐р░Хр▒Н р░кр▒Нр░▓р░Чр▒Н, р░кр░╡р░░р▒Н р░Хр░ир▒Жр░Хр▒Нр░Яр▒Н р░Ър▒Зр░пр░мр░бр░┐р░Вр░жр░┐, р░кр▒Нр░▓р░Чр░┐р░ир▒Н р░Ър▒Зр░пр░мр░бр░┐р░Вр░жр░┐
ЁЯТ╜	р░Жр░кр▒Нр░Яр░┐р░Хр░▓р▒Н, р░Хр░Вр░кр▒Нр░пр▒Вр░Яр░░р▒Н, р░бр░┐р░╕р▒Нр░Хр▒Н, р░ор░┐р░ир▒Ар░бр░┐р░╕р▒Нр░Хр▒Н
ЁЯТ╛	р░Хр░Вр░кр▒Нр░пр▒Вр░Яр░░р▒Н, р░бр░┐р░╕р▒Нр░Хр▒Н, р░лр▒Нр░▓р░╛р░кр▒А, р░лр▒Нр░▓р░╛р░кр▒А р░бр░┐р░╕р▒Нр░Хр▒Н
ЁЯУА	р░бр░┐р░╡р░┐р░бр░┐, р░бр░┐р░╕р▒Нр░Хр▒Н
ЁЯзо	р░Ер░мр░╛р░Хр░╕р▒Н, р░Чр░гр░и
ЁЯОе	р░Ър░▓р░ир░Ър░┐р░др▒Нр░░р░В, р░╡р░┐р░ир▒Лр░жр░В, р░╡р▒Ар░бр░┐р░пр▒Л р░Хр▒Жр░ор▒Жр░░р░╛, р░╖р▒Вр░Яр░┐р░Вр░Чр▒Н, р░╕р░┐р░ир░┐р░ор░╛, р░╕р░┐р░ир░┐р░ор░╛ р░Хр▒Жр░ор▒Жр░░р░╛
ЁЯУ╕	р░Хр▒Жр░ор▒Жр░░р░╛, р░лр▒Лр░Яр▒Л р░др▒Ар░пр░бр░В, р░лр▒Нр░▓р░╛р░╖р▒Н, р░лр▒Нр░▓р░╛р░╖р▒Н р░Хр▒Жр░ор▒Жр░░р░╛
ЁЯУ╝	р░╡р▒Ар░бр░┐р░пр▒Л р░Хр▒Нр░пр░╛р░╕р▒Жр░Яр▒Н, р░╡р▒Ар░бр░┐р░пр▒Л р░Яр▒Зр░кр▒Н
ЁЯФН	р░Ор░бр░ор░Хр░┐ р░╡р░Вр░Чр░┐ р░Йр░ир▒Нр░и р░нр▒Вр░др░жр▒Нр░жр░В, р░Ор░бр░ор░╡р▒Ир░кр▒Б р░╕р▒Вр░Ър░┐р░Вр░Ър▒З р░нр▒Вр░др░жр▒Нр░жр░В, р░╢р▒Лр░зр░и р░Ър░┐р░╣р▒Нр░ир░В
ЁЯФО	р░Хр▒Бр░бр░┐р░Хр░┐ р░╡р░Вр░Чр░┐ р░Йр░ир▒Нр░и р░нр▒Вр░др░жр▒Нр░жр░В, р░Хр▒Бр░бр░┐р░╡р▒Ир░кр▒Б р░╕р▒Вр░Ър░┐р░Вр░Ър▒З р░нр▒Вр░др░жр▒Нр░жр░В, р░╢р▒Лр░зр░и р░Ър░┐р░╣р▒Нр░ир░В
ЁЯТб	р░Жр░▓р▒Лр░Ър░и р░░р░╛р░╡р░бр░В, р░мр░▓р▒Нр░мр▒Н, р░╡р░┐р░жр▒Нр░пр▒Бр░др▒Нр░др▒Б, р░╡р▒Жр░▓р▒Бр░др▒Бр░░р▒Б
ЁЯФж	р░Яр░╛р░░р▒Нр░Ър▒Н р░▓р▒Ир░Яр▒Н, р░лр▒Нр░▓р░╛р░╖р▒Н р░▓р▒Ир░Яр▒Н
ЁЯПо	р░Ор░░р▒Бр░кр▒Б р░░р░Вр░Чр▒Б, р░Ор░░р▒Бр░кр▒Б р░▓р░╛р░Вр░др░░р▒Б, р░Ьр░кр░ир▒Ар░╕р▒Н р░мр░╛р░░р▒Н р░Чр▒Бр░░р▒Нр░др▒Б, р░Ьр░кр░ир▒Ар░╕р▒Н р░░р▒Жр░╕р▒Нр░Яр░╛р░░р▒Жр░Вр░Яр▒Н р░Чр▒Бр░░р▒Нр░др▒Б, р░▓р░╛р░Вр░др░░р▒Б
ЁЯУФ	р░Ер░Яр▒Нр░Я, р░Ер░▓р░Вр░Хр░╛р░░р░В, р░кр▒Бр░╕р▒Нр░др░Хр░В, р░ор▒Бр░Вр░жр▒Бр░╡р▒Ир░кр▒Б р░Ер░▓р░Вр░Хр░░р░┐р░Вр░Ър░┐р░и р░кр▒Бр░╕р▒Нр░др░Хр░В
ЁЯУХ	р░кр▒Бр░╕р▒Нр░др░Хр░В, р░ор▒Вр░пр░бр░В, р░ор▒Вр░╕р░┐р░и р░кр▒Бр░╕р▒Нр░др░Хр░В
ЁЯУЦ	р░др▒Жр░░р░╡р░бр░В, р░др▒Жр░░р░┐р░Ър░┐р░и р░кр▒Бр░╕р▒Нр░др░Хр░В, р░кр▒Бр░╕р▒Нр░др░Хр░В
ЁЯУЧ	р░кр░Ър▒Нр░Ъ р░░р░Вр░Чр▒Б, р░кр░Ър▒Нр░Ъ р░░р░Вр░Чр▒Б р░кр▒Бр░╕р▒Нр░др░Хр░В, р░кр▒Бр░╕р▒Нр░др░Хр░В
ЁЯУШ	р░ир▒Ар░▓р░┐ р░░р░Вр░Чр▒Б, р░ир▒Ар░▓р░┐ р░░р░Вр░Чр▒Б р░кр▒Бр░╕р▒Нр░др░Хр░В, р░кр▒Бр░╕р▒Нр░др░Хр░В
ЁЯУЩ	р░ир░╛р░░р░┐р░Вр░Ь р░░р░Вр░Чр▒Б, р░ир░╛р░░р░┐р░Вр░Ь р░░р░Вр░Чр▒Б р░кр▒Бр░╕р▒Нр░др░Хр░В, р░кр▒Бр░╕р▒Нр░др░Хр░В
ЁЯУУ	р░ир▒Лр░Яр▒Б р░кр▒Бр░╕р▒Нр░др░Хр░В, р░кр▒Бр░╕р▒Нр░др░Хр░В
ЁЯУТ	р░Жр░╡р░░р▒Нр░Ьр░╛, р░Цр░╛р░др░╛, р░кр▒Бр░╕р▒Нр░др░Хр░В, р░▓р▒Жр░бр▒Нр░Ьр░░р▒Н
ЁЯУГ	р░жр░┐р░Чр▒Бр░╡ р░ор░бр░┐р░Ър░┐р░и р░кр▒Зр░Ьр▒А, р░кр▒Зр░Ьр▒А, р░ор░бр░╡р░бр░В
ЁЯУЬ	р░кр▒Зр░кр░░р▒Н, р░ор░бр░╡р░бр░В, р░╕р▒Нр░Хр▒Нр░░р▒Лр░▓р▒Н
ЁЯУД	р░кр▒Зр░Ьр▒А р░ор░бр░╡р░бр░В, р░кр▒Зр░кр░░р▒Н, р░кр▒Ир░и р░ор░бр░┐р░Ър░┐р░и р░кр▒Зр░Ьр▒А
ЁЯУ░	р░ир▒Нр░пр▒Вр░╕р▒НтАМр░кр▒Зр░кр░░р▒Н, р░кр░др▒Нр░░р░┐р░Х, р░╡р░╛р░░р▒Нр░др░╛р░кр░др▒Нр░░р░┐р░Х
ЁЯЧЮ	р░Ър▒Бр░Яр▒Нр░Яр░бр░В, р░Ър▒Бр░Яр▒Нр░Яр░┐ р░Йр░ир▒Нр░и р░╡р░╛р░░р▒Нр░др░╛р░кр░др▒Нр░░р░┐р░Х, р░ир▒Нр░пр▒Вр░╕р▒НтАМр░кр▒Зр░кр░░р▒Н, р░кр░др▒Нр░░р░┐р░Х
ЁЯУС	р░Чр▒Бр░░р▒Нр░др▒Б р░кр▒Жр░Яр▒Нр░Яр░бр░В, р░Яр▒Нр░пр░╛р░мр▒НтАМр░▓р▒Б, р░мр▒Бр░Хр▒НтАМр░ор░╛р░░р▒Нр░Хр▒Н, р░мр▒Бр░Хр▒НтАМр░ор░╛р░░р▒Нр░Хр▒Н р░Яр▒Нр░пр░╛р░мр▒НтАМр░▓р▒Б
ЁЯФЦ	р░Яр▒Нр░пр░╛р░Чр▒Н, р░мр▒Бр░Хр▒НтАМр░ор░╛р░░р▒Нр░Хр▒Н
ЁЯТ┤	р░Хр░░р▒Жр░ир▒Нр░╕р▒А, р░мр▒Нр░пр░╛р░Вр░Хр▒Б р░ир▒Лр░Яр▒Б, р░пр▒Жр░ир▒Н, р░пр▒Жр░ир▒Н р░Ър░┐р░╣р▒Нр░ир░В р░Йр░ир▒Нр░и р░мр▒Нр░пр░╛р░Вр░Хр▒Б р░ир▒Лр░Яр▒Б
ЁЯТ╡	р░Хр░░р▒Жр░ир▒Нр░╕р▒А, р░бр░╛р░▓р░░р▒Н, р░бр░╛р░▓р░░р▒Н р░Ър░┐р░╣р▒Нр░ир░В р░Йр░ир▒Нр░и р░мр▒Нр░пр░╛р░Вр░Хр▒Б р░ир▒Лр░Яр▒Б, р░мр▒Нр░пр░╛р░Вр░Хр▒Б р░ир▒Лр░Яр▒Б
ЁЯТ╢	р░Хр░░р▒Жр░ир▒Нр░╕р▒А, р░мр▒Нр░пр░╛р░Вр░Хр▒Б р░ир▒Лр░Яр▒Б, р░пр▒Вр░░р▒Л, р░пр▒Вр░░р▒Л р░Ър░┐р░╣р▒Нр░ир░В р░Йр░ир▒Нр░и р░мр▒Нр░пр░╛р░Вр░Хр▒Б р░ир▒Лр░Яр▒Б
ЁЯТ╖	р░Хр░░р▒Жр░ир▒Нр░╕р▒А, р░кр▒Мр░Вр░бр▒Н, р░кр▒Мр░Вр░бр▒Н р░Ър░┐р░╣р▒Нр░ир░В р░Йр░ир▒Нр░и р░мр▒Нр░пр░╛р░Вр░Хр▒Б р░ир▒Лр░Яр▒Б, р░мр▒Нр░пр░╛р░Вр░Хр▒Б р░ир▒Лр░Яр▒Б
ЁЯТ╕	р░бр░мр▒Нр░мр▒Б р░Цр░░р▒Нр░Ър░пр░┐р░кр▒Лр░╡р░бр░В, р░░р▒Жр░Хр▒Нр░Хр░▓р▒Б р░Йр░ир▒Нр░и р░бр░мр▒Нр░мр▒Б
ЁЯз╛	р░Ер░Хр▒Мр░Вр░Яр░┐р░Вр░Чр▒Н, р░кр▒Бр░╕р▒Нр░др░Хр░Вр░▓р▒Л р░ир▒Лр░Яр▒Н р░Ър▒Зр░╕р▒Бр░Хр▒Лр░╡р░бр░В, р░░р░╕р▒Ар░жр▒Б, р░░р▒Бр░Ьр▒Бр░╡р▒Б, р░╕р░╛р░Хр▒Нр░╖р▒Нр░пр░В
ЁЯТ╣	р░Ър░╛р░░р▒Нр░Яр▒Н, р░пр▒Жр░ир▒Н, р░пр▒Жр░ир▒Н р░Ър░┐р░╣р▒Нр░ир░Вр░др▒Л р░кр▒Ир░Хр░┐ р░Ър▒Вр░кр▒Бр░др▒Бр░ир▒Нр░и р░Ър░╛р░░р▒Нр░Яр▒Н
ЁЯТ▒	р░Хр░░р▒Жр░ир▒Нр░╕р▒А, р░Хр░░р▒Жр░ир▒Нр░╕р▒А р░ор░╛р░░р▒Нр░кр░┐р░бр░┐, р░ор░╛р░░р▒Нр░кр▒Б
ЁЯТ▓	р░Хр░░р▒Жр░ир▒Нр░╕р▒А, р░бр░мр▒Нр░мр▒Б, р░бр░╛р░▓р░░р▒Н р░Ър░┐р░╣р▒Нр░ир░В, р░кр▒Жр░жр▒Нр░ж р░бр░╛р░▓р░░р▒Н р░Ър░┐р░╣р▒Нр░ир░В
ЁЯУз	р░Зр░ор▒Жр░пр░┐р░▓р▒Н, р░ор▒Жр░пр░┐р░▓р▒Н
ЁЯУи	р░Зр░ир▒НтАМр░Хр░ор░┐р░Вр░Чр▒Н р░ор▒Жр░пр░┐р░▓р▒Н, р░Ор░ир▒Нр░╡р░▓р░кр▒Н р░░р░╛р░╡р░бр░В, р░ор▒Жр░пр░┐р░▓р▒Н р░╡р░╕р▒Нр░др▒Лр░Вр░жр░┐
ЁЯУй	р░Ер░╡р▒Бр░Яр▒НтАМр░Чр▒Лр░пр░┐р░Вр░Чр▒Н р░ор▒Жр░пр░┐р░▓р▒Н, р░мр░╛р░гр░Вр░др▒Л р░╕р▒Вр░Ър░┐р░╕р▒Нр░др▒Бр░ир▒Нр░и р░Ор░ир▒Нр░╡р░▓р░кр▒Н, р░ор▒Жр░пр░┐р░▓р▒Н р░кр░Вр░кр▒Б
ЁЯУо	р░кр▒Лр░╕р▒Нр░Яр▒Н р░мр░╛р░Хр▒Нр░╕р▒Н, р░ор▒Жр░пр░┐р░▓р▒Н, р░ор▒Жр░пр░┐р░▓р▒Н р░кр▒Жр░Яр▒Нр░Яр▒Ж
ЁЯУЭ	р░Чр░ор░ир░┐р░Х, р░ор▒Жр░ор▒Л
ЁЯТ╝	р░мр▒Нр░░р▒Ар░лр▒Н р░Хр▒Зр░╕р▒Н, р░╕р▒Вр░Яр▒Н р░Хр▒Зр░╕р▒Н
ЁЯУБ	р░лр▒Ир░▓р▒Н, р░лр▒Ир░▓р▒Н р░лр▒Лр░▓р▒Нр░бр░░р▒Н, р░лр▒Лр░▓р▒Нр░бр░░р▒Н
ЁЯУВ	р░др▒Жр░░р░╡р░бр░В, р░др▒Жр░░р░┐р░Ър░┐р░и р░лр▒Ир░▓р▒Н р░лр▒Лр░▓р▒Нр░бр░░р▒Н, р░лр▒Ир░▓р▒Н, р░лр▒Лр░▓р▒Нр░бр░░р▒Н
ЁЯУЕ	р░Хр▒Нр░пр░╛р░▓р▒Жр░Вр░бр░░р▒Н, р░др▒Зр░жр▒А
ЁЯУЖ	р░кр▒Нр░░р░др░┐ р░░р▒Лр░Ьр▒В р░ор░╛р░░р▒Нр░Ър▒З р░Хр▒Нр░пр░╛р░▓р▒Жр░Вр░бр░░р▒Н, р░░р▒Лр░Ьр▒Бр░╡р░╛р░░р▒А р░Хр▒Нр░пр░╛р░▓р▒Жр░Вр░бр░░р▒Н
ЁЯУЗ	р░Хр░╛р░░р▒Нр░бр▒Н р░╕р▒Вр░Ър░┐р░Х, р░╕р▒Вр░Ър░┐р░Х
ЁЯУИ	р░Чр▒Нр░░р░╛р░лр▒Н, р░Ър░╛р░░р▒Нр░Яр▒Н, р░кр▒Жр░░р▒Бр░Чр▒Бр░жр░▓, р░кр▒Жр░░р▒Бр░Чр▒Бр░жр░▓ р░Ър░╛р░░р▒Нр░Яр▒Н
ЁЯУЙ	р░Чр▒Нр░░р░╛р░лр▒Н, р░Ър░╛р░░р▒Нр░Яр▒Н, р░др░Чр▒Нр░Чр▒Бр░жр░▓, р░др░Чр▒Нр░Чр▒Бр░жр░▓ р░Ър░╛р░░р▒Нр░Яр▒Н
ЁЯУК	р░мр░╛р░░р▒Н р░Чр▒Нр░░р░╛р░лр▒Н, р░мр░╛р░░р▒Н р░Ър░╛р░░р▒Нр░Яр▒Н, р░мр░╛р░░р▒Н р░кр░Яр▒Нр░Яр▒А
ЁЯУМ	р░кр░┐р░ир▒Н, р░кр▒Бр░╖р▒Н, р░кр▒Бр░╖р▒Н р░кр░┐р░ир▒Н
ЁЯУН	р░Чр▒Бр░Вр░бр▒Б р░кр░┐р░ир▒Нр░ир▒Б, р░Чр▒Бр░Вр░бр▒Б р░╕р▒Вр░жр░┐
ЁЯУО	р░Хр░╛р░Чр░┐р░др░В р░Хр▒Нр░▓р░┐р░кр▒Н, р░кр▒Зр░кр░░р▒Н р░Хр▒Нр░▓р░┐р░кр▒Н
ЁЯУП	р░ор▒Вр░▓, р░░р▒Вр░▓р░░р▒Н, р░░р▒Вр░▓р░░р▒Н р░╕р▒Нр░Хр▒Зр░▓р▒Н, р░╕р▒Нр░Хр▒Зр░▓р▒Н
ЁЯУР	р░др▒Нр░░р░┐р░нр▒Бр░Ьр░В, р░др▒Нр░░р░┐р░нр▒Бр░Ьр░╛р░Хр░╛р░░ р░░р▒Вр░▓р░░р▒Н, р░░р▒Вр░▓р░░р▒Н, р░╕р▒Нр░Хр▒Зр░▓р▒Н
ЁЯФП	р░Зр░Вр░Хр▒Н р░кр▒Жр░ир▒НтАМр░др▒Л р░кр░╛р░Яр▒Бр░Чр░╛ р░Йр░ир▒Нр░и р░др░╛р░│р░В, р░Ър░жр░╡р░бр░╛р░ир░┐р░Хр░┐ р░ор░╛р░др▒Нр░░р░ор▒З, р░др░╛р░│р░В р░Ър▒Жр░╡р░┐р░др▒Л р░╡р▒Зр░╕р░┐ р░Йр░ир▒Нр░и р░Хр░▓р░В, р░░р░Хр▒Нр░╖р░┐р░Вр░Ър░мр░бр░┐р░Вр░жр░┐, р░╕р░╡р░░р░┐р░Вр░Ър░▓р▒Зр░░р▒Б
ЁЯФР	р░др░╛р░│р░В р░Ър▒Жр░╡р░┐р░др▒Л р░кр░╛р░Яр▒Бр░Чр░╛ р░ор▒Вр░╕р░┐р░╡р▒Зр░╕р░┐р░и р░др░╛р░│р░В, р░др░╛р░│р░В р░Ър▒Жр░╡р░┐р░др▒Л р░╡р▒Зр░╕р░┐ р░Йр░ир▒Нр░и р░др░╛р░│р░В, р░░р░Хр▒Нр░╖р░┐р░Вр░Ър░мр░бр░┐р░Вр░жр░┐, р░╕р▒Бр░░р░Хр▒Нр░╖р░┐р░др░В
ЁЯФС	р░Ър▒Жр░╡р░┐, р░др░╛р░│р░В, р░др░╛р░│р░В р░Ър▒Жр░╡р░┐, р░кр░╛р░╕р▒НтАМр░╡р░░р▒Нр░бр▒Н
ЁЯФи	р░╕р░╛р░зр░ир░В, р░╕р▒Бр░др▒Нр░др░┐
ЁЯФл	р░Ър░┐р░ир▒Нр░и р░др▒Бр░кр░╛р░Хр▒А, р░кр░┐р░╕р▒Нр░др▒Лр░▓р▒Б, р░░р░┐р░╡р░╛р░▓р▒Нр░╡р░░р▒Н
ЁЯП╣	р░зр░ир▒Бр░╕р▒Нр░╕р▒Б, р░мр░╛р░гр░В, р░╡р░┐р░▓р▒Нр░▓р▒Б, р░╡р░┐р░▓р▒Нр░▓р▒Б р░ор░░р░┐р░пр▒Б р░мр░╛р░гр░В
ЁЯФз	р░░р▒Жр░Вр░Ър░┐, р░░р▒Жр░Вр░Ър▒Н, р░╕р▒Нр░кр░╛р░ир░░р▒Н
ЁЯФй	р░ир░Яр▒Нр░Яр▒Б, р░ир░Яр▒Нр░Яр▒Б р░ор░░р░┐р░пр▒Б р░мр▒Лр░▓р▒Нр░Яр▒Б, р░мр▒Лр░▓р▒Нр░Яр▒Б, р░╕р░╛р░зр░ир░В
ЁЯФЧ	р░Ер░нр▒Зр░жр▒Нр░пр░ор▒Ир░и, р░Хр░▓р░пр░┐р░Х, р░▓р░┐р░Вр░Хр▒Б
ЁЯз░	р░Яр▒Вр░▓р▒НтАМр░мр░╛р░Хр▒Нр░╕р▒Н, р░кр▒Жр░Яр▒Нр░Яр▒Ж, р░ор▒Жр░Хр░╛р░ир░┐р░Хр▒Н, р░╕р░╛р░зр░ир░В
ЁЯз▓	р░Ер░пр░╕р▒Нр░Хр░╛р░Вр░др░В, р░Жр░Хр░░р▒Нр░╖р░г, р░╣р░╛р░░р▒Нр░╕р▒НтАМр░╖р▒В
ЁЯзк	р░Яр▒Жр░╕р▒Нр░Яр▒Н р░Яр▒Нр░пр▒Вр░мр▒Н, р░кр▒Нр░░р░пр▒Лр░Чр░В, р░кр▒Нр░░р░пр▒Лр░Чр░╢р░╛р░▓, р░░р░╕р░╛р░пр░и р░╢р░╛р░╕р▒Нр░др▒Нр░░р░В, р░░р░╕р░╛р░пр░ир░┐р░Х р░╢р░╛р░╕р▒Нр░др▒Нр░░р░╡р▒Зр░др▒Нр░д, р░╡р░┐р░Ьр▒Нр░Юр░╛р░ир░╢р░╛р░╕р▒Нр░др▒Нр░░р░В
ЁЯзл	р░Йр░др▒Нр░кр░╛р░жр░и, р░Ьр▒Ар░╡р░╢р░╛р░╕р▒Нр░др▒Нр░░ р░ир░┐р░кр▒Бр░гр▒Бр░▓р▒Б, р░Ьр▒Ар░╡р░╢р░╛р░╕р▒Нр░др▒Нр░░р░В, р░кр▒Жр░Яр▒Нр░░р░┐ р░бр░┐р░╖р▒Н, р░кр▒Нр░░р░пр▒Лр░Чр░╢р░╛р░▓, р░мр▒Нр░пр░╛р░Хр▒Нр░Яр▒Ар░░р░┐р░пр░╛
ЁЯзм	р░Жр░╡р░┐р░░р▒Нр░нр░╛р░╡р░В, р░Ьр░ир▒Нр░пр▒Бр░╡р▒Б, р░Ьр░ир▒Нр░пр▒Бр░╢р░╛р░╕р▒Нр░др▒Нр░░р░В, р░Ьр▒Ар░╡р░╢р░╛р░╕р▒Нр░др▒Нр░░ р░ир░┐р░кр▒Бр░гр▒Бр░▓р▒Б, р░Ьр▒Ар░╡р░┐р░др░В, р░бр░┐р░Ор░ир▒Нр░О
ЁЯФм	р░ор▒Ир░Хр▒Нр░░р▒Лр░╕р▒Нр░Хр▒Лр░кр▒Н, р░╕р▒Вр░Хр▒Нр░╖р▒Нр░ор░жр░░р▒Нр░╢р░┐р░ир░┐
ЁЯФн	р░Яр▒Жр░▓р░┐р░╕р▒Нр░Хр▒Лр░кр▒Н, р░жр▒Вр░░р░жр░░р▒Нр░╢р░┐р░ир░┐
ЁЯУб	р░Йр░кр░Чр▒Нр░░р░╣ р░пр░╛р░Вр░Яр▒Жр░ир▒Нр░ир░╛, р░╢р░╛р░Яр░┐р░▓р▒Ир░Яр▒Н р░пр░╛р░Вр░Яр▒Жр░ир▒Нр░ир░╛
ЁЯТЙ	р░╕р░┐р░░р░Вр░Ьр░┐, р░╕р▒Вр░жр░┐
ЁЯТК	р░Чр▒Бр░│р░┐р░Х, р░ор░╛р░др▒Нр░░
ЁЯЪк	р░др░▓р▒Бр░кр▒Б
ЁЯЪ╜	р░Яр░╛р░пр░┐тАМр░▓р▒Жр░Яр▒Н
ЁЯЪ┐	р░др▒Бр░Вр░кр░░, р░ир▒Ар░Яр░┐ р░др▒Бр░Вр░кр░░р░▓р▒Б, р░ир▒Ар░░р▒Б
ЁЯЫБ	р░др▒Кр░Яр▒Нр░Яр▒Ж, р░╕р▒Нр░ир░╛р░ир░В, р░╕р▒Нр░ир░╛р░ир░кр▒Б р░др▒Кр░Яр▒Нр░Яр▒Ж
ЁЯз┤	р░ор░╛р░пр░┐р░╢р▒Нр░Ър░░р▒Ир░Ьр░░р▒Н, р░▓р▒Лр░╖р░ир▒Н, р░▓р▒Лр░╖р░ир▒Н р░мр░╛р░Яр░┐р░▓р▒Н, р░╖р░╛р░Вр░кр▒В, р░╕р░ир▒НтАМр░╕р▒Нр░Хр▒Нр░░р▒Ар░ир▒Н
ЁЯз╖	р░Чр▒Бр░Вр░бр▒Бр░кр░┐р░ир▒Нр░ир▒Б, р░бр▒Ир░кр░░р▒Н, р░кр░Вр░Хр▒Н р░░р░╛р░Хр▒Н
ЁЯз╣	р░Кр░бр▒Нр░Ър░бр░В, р░Ър▒Ар░кр▒Бр░░р▒Б, р░╡р░┐р░Ър▒Н, р░╢р▒Бр░нр▒Нр░░р░кр░░р░Ър░бр░В
ЁЯз║	р░кр░┐р░Хр▒НтАМр░ир░┐р░Хр▒Н, р░мр▒Бр░Яр▒Нр░Я, р░▓р░╛р░Вр░бр▒Нр░░р▒А, р░╡р▒Нр░пр░╡р░╕р░╛р░пр░В
ЁЯз╗	р░Яр░╛р░пр░┐р░▓р▒Жр░Яр▒Н р░кр▒Зр░кр░░р▒Н, р░кр▒Зр░кр░░р▒Н р░Яр░╡р░▓р▒НтАМр░▓р▒Б, р░кр▒Зр░кр░░р▒Н р░░р▒Лр░▓р▒Н
ЁЯз╝	р░ир▒Бр░░р░Ч, р░мр░╛р░░р▒Н, р░╢р▒Бр░нр▒Нр░░р░кр░░р░Ър░бр░В, р░╕р░мр▒Нр░мр▒Б, р░╕р▒Лр░кр▒НтАМр░бр░┐р░╖р▒Н, р░╕р▒Нр░ир░╛р░ир░В
ЁЯз╜	р░кр▒Ар░▓р▒Нр░Ър▒Бр░Хр▒Лр░╡р░бр░В, р░░р░Вр░зр▒Нр░░р░╛р░▓р▒Б, р░╢р▒Бр░нр▒Нр░░р░кр░░р░Ър░бр░В, р░╕р▒Нр░кр░╛р░Вр░Ьр▒Н
ЁЯзп	р░Ер░Чр▒Нр░ир░┐, р░Ер░Чр▒Нр░ир░┐р░ор░╛р░кр░Х р░кр░░р░┐р░Хр░░р░В, р░Жр░░р▒Нр░кр░бр░В, р░ир░┐р░░р▒Лр░зр░┐р░Вр░Ър░бр░В
ЁЯЫТ	р░Хр░╛р░░р▒Нр░Яр▒Н, р░Яр▒Нр░░р░╛р░▓р▒А, р░╖р░╛р░кр░┐р░Вр░Чр▒Н, р░╖р░╛р░кр░┐р░Вр░Чр▒Н р░Хр░╛р░░р▒Нр░Яр▒Н
ЁЯЪм	р░И р░кр▒Нр░░р░╛р░Вр░др░Вр░▓р▒Л р░кр▒Кр░Ч р░др▒Нр░░р░╛р░Чр░бр░В р░Ер░ир▒Бр░ор░др░┐р░Вр░Ър░мр░бр░┐р░Вр░жр░┐, р░зр▒Вр░ор░кр░╛р░ир░В, р░кр▒Кр░Чр░др▒Нр░░р░╛р░Чр▒Б р░╕р▒Нр░ер░▓р░В
ЁЯЧ┐	р░ор░ир▒Бр░╖р▒Бр░▓р▒Б р░Ър▒Жр░Хр▒Нр░Хр░┐р░и р░░р░╛р░др░┐ р░╡р░┐р░Чр▒Нр░░р░╣р░В, р░ор▒Лр░пр░╛р░пр▒Н, р░ор▒Лр░пр░╛р░пр▒Н р░╡р░┐р░Чр▒Нр░░р░╣р░В
ЁЯПз	р░Жр░Яр▒Лр░ор▒Зр░Яр▒Жр░бр▒Н, р░Ор░Яр░┐р░Ор░ор▒Н, р░Пр░Яр░┐р░Ор░ор▒Н, р░Яр▒Жр░▓р▒Нр░▓р░░р▒Н
ЁЯЪо	р░Зр░Хр▒Нр░Хр░б р░Ър▒Жр░др▒Нр░д р░╡р▒Зр░пр░Вр░бр░┐, р░Ор░Хр▒Нр░Хр░б р░кр░бр░┐р░др▒З р░Ер░Хр▒Нр░Хр░б р░Ър▒Жр░др▒Нр░д р░╡р▒Зр░пр░╡р░жр▒Нр░жр▒Б, р░Ър▒Жр░др▒Нр░д р░кр░╛р░░р░╡р▒Зр░╕р▒З р░╕р▒Нр░ер░▓р░В, р░Ър▒Жр░др▒Нр░д р░мр▒Бр░Яр▒Нр░Я
ЁЯЪ░	р░др▒Нр░░р░╛р░Чр▒Бр░ир▒Ар░░р▒Б, р░╕р▒Бр░░р░Хр▒Нр░╖р░┐р░д р░ир▒Ар░░р▒Б
ЁЯЪ╗	р░мр░╛р░др▒Нр░░р▒Вр░В, р░╡р░┐р░╢р▒Нр░░р░╛р░Вр░др░┐ р░Чр░жр░┐
ЁЯЪ╛	р░Чр░жр▒Бр░▓р▒Нр░▓р▒Л р░Ер░Вр░др░░р▒Нр░Чр░др░Вр░Чр░╛ р░ир▒Ар░Яр░┐ р░кр▒Ир░кр▒Бр░▓ р░╕р▒Мр░▓р░нр▒Нр░пр░В, р░╡р░╛р░Яр░░р▒Н р░Хр▒Нр░▓р▒Лр░╕р▒Жр░Яр▒Н
ЁЯЫВ	р░др░ир░┐р░Цр▒А, р░кр░╛р░╕р▒НтАМр░кр▒Лр░░р▒Нр░Яр▒Н, р░кр░╛р░╕р▒НтАМр░кр▒Лр░░р▒Нр░Яр▒Н р░др░ир░┐р░Цр▒А, р░кр▒Нр░░р░пр░╛р░гр░В
ЁЯЫГ	р░Ер░зр░┐р░Хр░╛р░░р▒Бр░▓р▒Б, р░Хр░╕р▒Нр░Яр░ор▒Нр░╕р▒Н, р░др░ир░┐р░Цр▒А, р░╕р░╛р░ор░╛р░Чр▒Нр░░р░┐
ЁЯЫД	р░Хр▒Нр░▓р▒Жр░пр░┐р░ор▒Н, р░▓р░Чр▒Зр░Ьр▒А, р░╕р░╛р░ор░╛р░ир▒Б р░др▒Ар░╕р▒Бр░Хр▒Лр░╡р░бр░В
ЁЯЫЕ	р░▓р░Чр▒Зр░Ьр▒А, р░╡р░жр░┐р░▓р░┐р░╡р▒Зр░╕р░┐р░и р░╕р░╛р░ор░╛р░ир▒Б, р░╕р░╛р░ор░╛р░Чр▒Нр░░р░┐
ЁЯЪ╕	р░Ър░┐р░ир▒Нр░ир░кр░┐р░▓р▒Нр░▓р░▓р▒Б р░др░┐р░░р░┐р░Чр▒З р░╕р▒Нр░ер░▓р░В, р░кр░╛р░ар░╢р░╛р░▓ р░кр▒Нр░░р░╛р░Вр░др░В
ЁЯЪл	р░Зр░Хр▒Нр░Хр░б р░кр▒Нр░░р░╡р▒Зр░╢р░┐р░Вр░Ър░╡р░жр▒Нр░жр▒Б, р░ир░┐р░╖р░┐р░жр▒Нр░зр░В, р░кр▒Нр░░р░╡р▒Зр░╢р░В р░ир░┐р░╖р▒Зр░зр░┐р░Вр░Ър░мр░бр░┐р░Вр░жр░┐, р░кр▒Нр░░р░╡р▒Зр░╢р░В р░▓р▒Зр░жр▒Б
ЁЯЪ│	р░И р░кр▒Нр░░р░╛р░Вр░др░Вр░▓р▒Л р░╕р▒Ир░Хр░┐р░▓р▒НтАМр░▓р▒Б р░ир░┐р░╖р▒Зр░зр░В, р░ир░┐р░╖р▒Зр░зр░В, р░░р▒Ир░бр░┐р░Вр░Чр▒Н, р░╕р▒Ир░Хр░┐р░▓р▒НтАМр░▓р▒Б
ЁЯЪп	р░И р░кр▒Нр░░р░╛р░Вр░др░Вр░▓р▒Л р░Ър▒Жр░др▒Нр░д р░╡р▒Зр░пр░бр░В р░ир░┐р░╖р▒Зр░зр░┐р░Вр░Ър░мр░бр░┐р░Вр░жр░┐, р░Ър▒Жр░др▒Нр░д р░╡р▒Зр░пр░░р░╛р░жр▒Б, р░Ър▒Жр░др▒Нр░д р░╡р▒Зр░пр░╡р░жр▒Нр░жр▒Б р░Ър░┐р░╣р▒Нр░ир░В
ЁЯЪ▒	р░др▒Нр░░р░╛р░Чр▒Бр░ир▒Ар░░р▒Б р░Хр░╛р░жр▒Б, р░ир▒Ар░Яр░┐р░ир░┐ р░Йр░кр░пр▒Лр░Чр░┐р░Вр░Ър░бр░В р░╢р▒Нр░░р▒Зр░пр░╕р▒Нр░Хр░░р░В р░Хр░╛р░жр▒Б, р░╡р░┐р░ир░┐р░пр▒Лр░Чр░┐р░Вр░Ър░жр░Чр░┐р░и р░ир▒Ар░░р▒Б р░Хр░╛р░жр▒Б
ЁЯЪ╖	р░ир░бр░Х, р░ир░┐р░╖р░┐р░жр▒Нр░зр░В, р░кр░╛р░жр░Ър░╛р░░р▒Бр░▓р░Хр▒Б р░ир░┐р░╖р░┐р░жр▒Нр░зр░В, р░кр░╛р░жр░Ър░╛р░░р▒Бр░▓р▒Б
ЁЯУ╡	р░Ър░┐р░╣р▒Нр░ир░В, р░ор▒Кр░мр▒Ир░▓р▒Н, р░ор▒Кр░мр▒Ир░▓р▒Н р░лр▒Лр░ир▒Н р░ир░┐р░╖р▒Зр░зр░В р░Ър░┐р░╣р▒Нр░ир░В
ЁЯФЮ	18, р░др░Хр▒Нр░Хр▒Бр░╡ р░╡р░пр░╕р▒Нр░╕р▒Б, р░ир░┐р░░р▒Лр░зр░┐р░Вр░Ър░мр░бр░┐р░Вр░жр░┐, р░ир░┐р░╖р▒Зр░зр░┐р░Вр░Ър░мр░бр░┐р░Вр░жр░┐, р░кр░жр▒Нр░жр▒Жр░ир░┐р░ор░┐р░жр░┐, р░кр░жр▒Нр░жр▒Жр░ир░┐р░ор░┐р░жр░┐ р░╕р░Вр░╡р░др▒Нр░╕р░░р░╛р░▓ р░Хр░Вр░Яр▒З р░Ор░Хр▒Нр░Хр▒Бр░╡ р░╡р░пр░╕р▒Нр░╕р▒Б р░Йр░Вр░бр░╛р░▓р░┐, р░▓р▒Зр░жр▒Б, р░╡р░жр▒Нр░жр▒Б, р░╡р░пр░╕р▒Нр░╕р▒Б р░кр░░р░┐р░ор░┐р░др░┐
ЁЯФГ	р░ор░│р▒Нр░▓р▒А р░▓р▒Лр░бр▒Н р░Ър▒Зр░пр░┐, р░░р▒Ар░▓р▒Лр░бр▒Н р░Ър░┐р░╣р▒Нр░ир░В, р░╕р░╡р▒Нр░пр░жр░┐р░╢р░▓р▒Л р░ир░┐р░▓р▒Бр░╡р▒Б р░мр░╛р░гр░╛р░▓р▒Б
ЁЯФД	р░Ер░кр░╕р░╡р▒Нр░пр░жр░┐р░╢р░▓р▒Л р░мр░╛р░гр░╛р░▓ р░мр░Яр░ир▒Н, р░░р░┐р░лр▒Нр░░р▒Жр░╖р▒Н р░Ър░┐р░╣р▒Нр░ир░В, р░░р░┐р░лр▒Нр░░р▒Жр░╖р▒Н р░Ър▒Зр░пр░┐
ЁЯФЩ	р░мр░╛р░гр░В, р░╡р▒Жр░ир▒Бр░Хр░Хр▒Б, р░╡р▒Жр░ир▒Бр░Хр░Хр▒Б р░мр░╛р░гр░В
ЁЯФЪ	р░мр░╛р░гр░В, р░ор▒Бр░Чр░┐р░Вр░кр▒Б, р░ор▒Бр░Чр░┐р░╕р░┐р░Вр░жр░┐ р░мр░╛р░гр░В
ЁЯФЫ	р░Зр░░р▒Бр░╡р▒Ир░кр▒Бр░▓р░╛ р░кр▒Нр░░р░╡р▒Зр░╢р░В р░Йр░Вр░жр░┐, р░Зр░░р▒Бр░╡р▒Ир░кр▒Бр░▓р▒Б р░мр░╛р░гр░В, р░Ор░▓р░╛р░Чр▒Ир░ир░╛ р░╡р▒Жр░│р▒Нр░▓р░╡р░Ър▒Нр░Ър▒Б
ЁЯФЬ	р░др▒Нр░╡р░░р░▓р▒Л р░░р░╛р░мр▒Лр░др▒Бр░Вр░жр░┐, р░жр░Чр▒Нр░Чр░░р░▓р▒Л р░Йр░Вр░жр░┐, р░╕р░ор▒Ар░кр░┐р░╕р▒Нр░др▒Лр░Вр░жр░┐ р░мр░╛р░гр░В
ЁЯФЭ	р░кр▒Ир░Хр░┐, р░кр▒Ир░Хр░┐ р░мр░╛р░гр░В, р░мр░╛р░гр░В
ЁЯЫР	р░кр▒Нр░░р░╛р░░р▒Нр░ер░и, р░кр▒Нр░░р░╛р░░р▒Нр░ер░ир░╛ р░╕р▒Нр░ер░▓р░В, р░ор░др░В
ЁЯХО	р░Хр▒Кр░╡р▒Нр░╡р▒Кр░др▒Нр░др░┐, р░ор░др░В, р░ор▒Жр░ир▒Лр░░р░╛
ЁЯФп	р░Жр░░р▒Б р░Хр▒Лр░гр░╛р░▓ р░ир░Хр▒Нр░╖р░др▒Нр░░р░В, р░Ър▒Бр░Хр▒Нр░Хр░▓р░др▒Л р░Жр░░р▒Б р░Хр▒Лр░гр░╛р░▓ р░ир░Хр▒Нр░╖р░др▒Нр░░р░В, р░пр▒Вр░жр░┐р░пр░╛ р░ор░др░В р░Ър░┐р░╣р▒Нр░ир░В
тЫО	р░Ьр░кр░ир▒Ар░╕р▒Н р░░р░╛р░╢р░┐р░Ър░Хр▒Нр░░р░Вр░▓р▒Л 13р░╡ р░Чр▒Бр░░р▒Нр░др▒Б, р░Ьр░кр░╛р░ир▒Н, р░░р░╛р░╢р░┐р░Ър░Хр▒Нр░░р░В
ЁЯФА	р░Ър░┐р░╣р▒Нр░ир░В, р░Яр▒Нр░░р░╛р░Хр▒НтАМр░▓р░ир▒Б р░╖р░лр▒Бр░▓р▒Н р░Ър▒Зр░пр░┐ р░мр░Яр░ир▒Н, р░╖р░кр▒Бр░▓р▒Н
ЁЯФБ	р░Чр▒Бр░░р▒Нр░др▒Б, р░кр▒Нр░▓р▒З, р░ор░│р▒Нр░▓р▒А р░кр▒Нр░▓р▒З р░Ър▒Зр░пр░┐ р░мр░Яр░ир▒Н
ЁЯФВ	р░Тр░Хр▒Зр░жр░╛р░ир▒Нр░ир░┐ р░ор░│р▒Нр░▓р▒А р░кр▒Нр░▓р▒З р░Ър▒Зр░пр░┐ р░мр░Яр░ир▒Н, р░Чр▒Бр░░р▒Нр░др▒Б, р░кр▒Нр░▓р▒З
тЦ╢	р░Чр▒Бр░░р▒Нр░др▒Б, р░кр▒Нр░▓р▒З, р░кр▒Нр░▓р▒З р░Ър▒Зр░пр░┐ р░мр░Яр░ир▒Н
тПй	р░Чр▒Бр░░р▒Нр░др▒Б, р░лр░╛р░╕р▒Нр░Яр▒Н р░лр░╛р░░р▒Нр░╡р░╛р░░р▒Нр░бр▒Н р░мр░Яр░ир▒Н, р░╡р▒Зр░Чр░В
тПн	р░Чр▒Бр░░р▒Нр░др▒Б, р░др░жр▒Бр░кр░░р░┐ р░Яр▒Нр░░р░╛р░Хр▒Н р░мр░Яр░ир▒Н, р░др░░р▒Бр░╡р░╛р░д
тПп	р░Чр▒Бр░░р▒Нр░др▒Б, р░ир░┐р░▓р░┐р░кр░┐р░╡р▒Зр░пр░бр░В, р░кр▒Нр░▓р▒З, р░кр▒Нр░▓р▒З р░▓р▒Зр░жр░╛ р░кр░╛р░Ьр▒Н р░мр░Яр░ир▒Н
тЧА	р░Чр▒Бр░░р▒Нр░др▒Б, р░╡р▒Жр░ир░Хр▒Нр░Хр░┐, р░╡р▒Жр░ир░Хр▒Нр░Хр░┐ р░╡р▒Жр░│р▒Нр░▓р▒З р░мр░Яр░ир▒Н
тПк	р░Чр▒Бр░░р▒Нр░др▒Б, р░╡р▒Жр░ир░Хр▒Нр░Хр░┐, р░╡р▒Зр░Чр░В, р░╡р▒Зр░Чр░Вр░Чр░╛ р░╡р▒Жр░ир░Хр▒Нр░Хр░┐ р░╡р▒Жр░│р▒Нр░▓р▒З р░мр░Яр░ир▒Н
тПо	р░Ер░Вр░др░Хр▒Б р░ор▒Бр░ир▒Бр░кр░Яр░┐ р░Яр▒Нр░░р░╛р░Хр▒Н р░мр░Яр░ир▒Н, р░Чр▒Бр░░р▒Нр░др▒Б, р░ор▒Бр░Вр░жр▒Бр░Хр▒Б
ЁЯФ╝	р░Ор░░р▒Бр░кр▒Б, р░Ър░┐р░╣р▒Нр░ир░В, р░кр▒Ир░Хр░┐, р░кр▒Ир░Хр░┐ р░╡р▒Жр░│р▒Нр░▓р▒З р░мр░Яр░ир▒Н, р░░р░Вр░Чр▒Б
тПл	р░др▒Нр░░р░┐р░Хр▒Лр░гр░В, р░ир░▓р▒Бр░кр▒Б, р░кр▒Ир░Хр░┐, р░░р░Вр░Чр▒Б, р░╡р▒Зр░Чр░Вр░Чр░╛ р░кр▒Ир░Хр░┐ р░╡р▒Жр░│р▒Нр░▓р▒З р░мр░Яр░ир▒Н
ЁЯФ╜	р░Ор░░р▒Бр░кр▒Б, р░Хр▒Нр░░р░┐р░Вр░жр░Хр░┐, р░Хр▒Нр░░р░┐р░Вр░жр░┐р░Хр░┐ р░╡р▒Жр░│р▒Нр░▓р▒З р░мр░Яр░ир▒Н, р░др▒Нр░░р░┐р░нр▒Бр░Ьр░В, р░░р░Вр░Чр▒Б
тПм	р░Хр▒Нр░░р░┐р░Вр░жр░Хр░┐, р░др▒Нр░░р░┐р░Хр▒Лр░гр░В, р░ир░▓р▒Бр░кр▒Б, р░░р░Вр░Чр▒Б, р░╡р▒Зр░Чр░Вр░Чр░╛ р░Хр▒Нр░░р░┐р░Вр░жр░┐р░Хр░┐ р░╡р▒Жр░│р▒Нр░▓р▒З р░мр░Яр░ир▒Н
ЁЯОж	р░Хр▒Жр░ор▒Жр░░р░╛, р░Ър░┐р░╣р▒Нр░ир░В, р░╡р▒Ар░бр░┐р░пр▒Л, р░╡р▒Ар░бр░┐р░пр▒Л р░Хр▒Жр░ор▒Жр░░р░╛ р░Ър░┐р░╣р▒Нр░ир░В
ЁЯФЕ	р░Ър░┐р░╣р▒Нр░ир░В, р░др░Хр▒Нр░Хр▒Бр░╡, р░др░Хр▒Нр░Хр▒Бр░╡ р░кр▒Нр░░р░Хр░╛р░╢р░В р░мр░Яр░ир▒Н, р░кр▒Нр░░р░Хр░╛р░╢р░В
ЁЯФЖ	р░Ор░Хр▒Нр░Хр▒Бр░╡, р░Ор░Хр▒Нр░Хр▒Бр░╡ р░кр▒Нр░░р░Хр░╛р░╢р░В р░мр░Яр░ир▒Н, р░Ър░┐р░╣р▒Нр░ир░В, р░кр▒Нр░░р░Хр░╛р░╢р░В
ЁЯУ╢	р░Ър░┐р░╣р▒Нр░ир░В, р░╕р░┐р░Чр▒Нр░ир░▓р▒Н, р░╕р░┐р░Чр▒Нр░ир░▓р▒Н р░Ър░┐р░╣р▒Нр░ир░В
ЁЯУ│	р░Ър░┐р░╣р▒Нр░ир░В, р░╡р▒Ир░мр▒Нр░░р▒Зр░╖р░ир▒Н, р░╡р▒Ир░мр▒Нр░░р▒Зр░╖р░ир▒Н р░ор▒Лр░бр▒Н
ЁЯУ┤	р░Жр░лр▒Н, р░Ър░┐р░╣р▒Нр░ир░В, р░ор▒Кр░мр▒Ир░▓р▒Н, р░ор▒Кр░мр▒Ир░▓р▒Н р░лр▒Лр░ир▒Н р░Жр░лр▒НтАМр░▓р▒Л р░Йр░ир▒Нр░и р░Ър░┐р░╣р▒Нр░ир░В
тЪЬ	р░Хр░▓р▒Бр░╡, р░кр▒Бр░╡р▒Нр░╡р▒Б, р░лр▒Нр░▓р▒Вр░░р▒Н р░бр░┐-р░▓р░┐р░╕р▒Н
ЁЯФ▒	р░др▒Нр░░р░┐р░╢р▒Вр░▓ р░Ър░┐р░╣р▒Нр░ир░В, р░др▒Нр░░р░┐р░╢р▒Вр░▓р░В р░Ър░┐р░╣р▒Нр░ир░В, р░кр░Вр░Чр░▓р░Хр░░р▒Нр░░ р░Чр▒Бр░░р▒Нр░др▒Б
ЁЯУЫ	р░кр▒Зр░░р▒Б р░Яр▒Нр░пр░╛р░Чр▒Н, р░кр▒Зр░░р▒Б р░мр▒Нр░пр░╛р░бр▒Нр░Ьр▒А, р░кр▒Зр░░р▒Б р░мр▒Нр░пр░╛р░бр▒Нр░Ьр▒Н
ЁЯФ░	р░Ьр░кр░╛р░ир▒Н р░╡р░╛р░╣р░и р░╢р░┐р░Хр▒Нр░╖р░Хр▒Бр░▓р▒Б р░кр▒Нр░░р░жр░░р▒Нр░╢р░┐р░Вр░Ър▒З р░Чр▒Бр░░р▒Нр░др▒Б, р░Ьр░кр░╛р░ир▒НтАМр░▓р▒Л р░бр▒Нр░░р▒Ир░╡р░┐р░Вр░Чр▒Н р░ир▒Зр░░р▒Нр░Ър▒Бр░Хр▒Бр░ир▒Зр░╡р░╛р░░р▒Б р░кр▒Нр░░р░жр░░р▒Нр░╢р░┐р░Вр░Ър▒З р░Чр▒Бр░░р▒Нр░др▒Б
тЬЕ	р░др░ир░┐р░Цр▒А р░Чр▒Бр░░р▒Нр░др▒Б, р░кр░Ър▒Нр░Ъ р░кр▒Жр░Яр▒Нр░Яр▒Жр░▓р▒Л р░др▒Жр░▓р▒Бр░кр▒Б р░░р░Вр░Чр▒Б р░др░ир░┐р░Цр▒А р░Чр▒Бр░░р▒Нр░др▒Б, р░╕р░░р▒Ир░ир░жр░┐ р░Чр▒Бр░░р▒Нр░др▒Б
тЭМ	р░Хр▒Вр░бр░▓р░┐, р░Хр▒Нр░░р░╛р░╕р▒Н р░Чр▒Бр░░р▒Нр░др▒Б, р░Чр▒Бр░гр░Хр░╛р░░р░В р░Чр▒Бр░░р▒Нр░др▒Б, р░ир░▓р▒Бр░кр▒Б р░░р░Вр░Чр▒Б р░╡р▒Нр░пр░др░┐р░░р▒Зр░Хр░В р░Чр▒Бр░░р▒Нр░др▒Б, р░╡р▒Нр░пр░др░┐р░░р▒Зр░Хр░В р░Чр▒Бр░░р▒Нр░др▒Б
тЭО	р░Хр▒Вр░бр░▓р░┐, р░Хр▒Нр░░р░╛р░╕р▒Н р░Чр▒Бр░░р▒Нр░др▒Б р░мр░Яр░ир▒Н, р░Чр▒Бр░гр░Хр░╛р░░р░В р░Чр▒Бр░░р▒Нр░др▒Б, р░ир░▓р▒Бр░кр▒Б р░░р░Вр░Чр▒Б р░ир▒Зр░кр░ер▒Нр░пр░Вр░▓р▒Л р░др▒Жр░▓р▒Бр░кр▒Б р░░р░Вр░Чр▒Б р░╡р▒Нр░пр░др░┐р░░р▒Зр░Хр░В р░Чр▒Бр░░р▒Нр░др▒Б, р░╡р▒Нр░пр░др░┐р░░р▒Зр░Хр░В р░Чр▒Бр░░р▒Нр░др▒Б
тЮХ	р░Хр▒Вр░бр░┐р░Х р░Чр▒Бр░░р▒Нр░др▒Б, р░кр▒Нр░▓р░╕р▒Н, р░нр░╛р░░р▒А р░Хр▒Вр░бр░┐р░Х р░Ър░┐р░╣р▒Нр░ир░В
тЮЦ	р░др▒Ар░╕р░┐р░╡р▒Зр░д р░Чр▒Бр░░р▒Нр░др▒Б, р░нр░╛р░░р▒А р░др▒Ар░╕р░┐р░╡р▒Зр░д р░Ър░┐р░╣р▒Нр░ир░В, р░ор▒Ир░ир░╕р▒Н
тЮЧ	р░бр░┐р░╡р░┐р░Ьр░ир▒Н, р░нр░╛р░Чр░╣р░╛р░░р░В р░Чр▒Бр░░р▒Нр░др▒Б1, р░нр░╛р░░р▒А р░нр░╛р░Чр░╣р░╛р░░ р░Ър░┐р░╣р▒Нр░ир░В
тЮ░	р░Хр░░р▒Нр░▓р▒А р░▓р▒Вр░кр▒Н, р░ор▒Жр░▓р░┐ р░др░┐р░░р░┐р░Чр░┐р░и р░╡р░Вр░кр▒Б
тЮ┐	р░бр░мр▒Бр░▓р▒Н, р░бр░мр▒Бр░▓р▒Н р░Хр░░р▒Нр░▓р▒А р░▓р▒Вр░кр▒Н, р░ор▒Жр░▓р░┐р░Х, р░▓р▒Вр░кр▒Н
тЭФ	р░Чр▒Бр░░р▒Нр░др▒Б, р░др▒Жр░▓р▒Бр░кр▒Б, р░др▒Жр░▓р▒Бр░кр▒Б р░░р░Вр░Чр▒Б р░кр▒Нр░░р░╢р▒Нр░ир░╛р░░р▒Нр░ер░Хр░В р░Чр▒Бр░░р▒Нр░др▒Б, р░кр▒Нр░░р░╢р▒Нр░ир░╛р░░р▒Нр░ер░Хр░В
тЭХ	р░Жр░╢р▒Нр░Ър░░р▒Нр░пр░╛р░░р▒Нр░ер░Хр░В, р░Чр▒Бр░░р▒Нр░др▒Б, р░др▒Жр░▓р▒Бр░кр▒Б, р░др▒Жр░▓р▒Бр░кр▒Б р░░р░Вр░Чр▒Б р░Жр░╢р▒Нр░Ър░░р▒Нр░пр░╛р░░р▒Нр░ер░Хр░В р░Чр▒Бр░░р▒Нр░др▒Б
ЁЯТп	100 р░кр░╛р░пр░┐р░Вр░Яр▒НтАМр░▓р▒Б, р░╕р░Вр░Цр▒Нр░п
ЁЯФа	р░Ер░Хр▒Нр░╖р░░р░В, р░кр▒Жр░жр▒Нр░ж, р░кр▒Жр░жр▒Нр░ж р░Ер░Хр▒Нр░╖р░░р░╛р░▓р▒Б
ЁЯФб	р░Ер░Хр▒Нр░╖р░░р░В, р░Ър░┐р░ир▒Нр░и, р░Ър░┐р░ир▒Нр░и р░Ер░Хр▒Нр░╖р░░р░╛р░▓р▒Б
ЁЯФв	1234, р░Зр░ир▒НтАМр░кр▒Бр░Яр▒Н, р░Зр░ир▒НтАМр░кр▒Бр░Яр▒Н р░╕р░Вр░Цр▒Нр░пр░▓р▒Б, р░╕р░Вр░Цр▒Нр░пр░▓р▒Б
ЁЯФг	р░Зр░ир▒НтАМр░кр▒Бр░Яр▒Н р░Чр▒Бр░░р▒Нр░др▒Бр░▓р▒Б, р░Чр▒Бр░░р▒Нр░др▒Б, р░Ър░┐р░╣р▒Нр░ир░В
ЁЯФд	р░Ер░Хр▒Нр░╖р░░р░В, р░Зр░ир▒НтАМр░кр▒Бр░Яр▒Н р░▓р░╛р░Яр░┐р░ир▒Н р░Ер░Хр▒Нр░╖р░░р░╛р░▓р▒Б, р░▓р░╛р░Яр░┐р░ир▒Н
ЁЯЖО	р░Ер░Хр▒Нр░╖р░░р░В, р░Ор░мр░┐, р░Ор░мр░┐ р░мр░Яр░ир▒Н (р░░р░Хр▒Нр░др░В р░░р░Хр░В)
ЁЯЖС	р░Хр▒Нр░▓р░┐р░пр░░р▒Н, р░Хр▒Нр░▓р░┐р░пр░░р▒Н р░мр░Яр░ир▒Н, р░Чр▒Бр░░р▒Нр░др▒Б
ЁЯЖТ	р░Жр░╡р▒Зр░╢р░кр░бр░╡р░жр▒Нр░жр▒Б, р░Хр▒Вр░▓р▒Н, р░Хр▒Вр░▓р▒Н р░Ър░┐р░╣р▒Нр░ир░В, р░╢р░╛р░Вр░др░В р░мр░Яр░ир▒Н
ЁЯЖУ	р░Йр░Ър░┐р░др░В р░мр░Яр░ир▒Н, р░Цр░╛р░│р▒А р░╕р▒Нр░ер░▓р░В, р░Цр░╛р░│р▒Ар░Чр░╛ р░Йр░ир▒Нр░ир░╛р░ир▒Б, р░Ыр░╛р░░р▒Нр░Ьр▒А р░░р░╣р░┐р░др░В
ЁЯЖФ	р░Рр░бр░┐ р░Хр░╛р░░р▒Нр░бр▒Н, р░Рр░бр░┐ р░Чр▒Бр░░р▒Нр░др▒Б, р░Рр░бр░┐ р░мр░Яр░ир▒Н, р░Чр▒Бр░░р▒Нр░др░┐р░Вр░кр▒Б, р░░р▒Бр░Ьр▒Бр░╡р▒Б
ЁЯЖХ	р░Хр▒Кр░др▒Нр░др░жр░┐ р░Ър░┐р░╣р▒Нр░ир░В, р░Хр▒Кр░др▒Нр░др░жр░┐ р░мр░Яр░ир▒Н, р░Чр▒Бр░░р▒Нр░др▒Б, р░╕р░░р░┐р░Хр▒Кр░др▒Нр░д
ЁЯЖЦ	р░Ор░ир▒НтАМр░Ьр░┐, р░Ор░ир▒НтАМр░Ьр░┐ р░Ер░Хр▒Нр░╖р░░р░╛р░▓р▒Б, р░Ор░ир▒НтАМр░Ьр░┐ р░Чр▒Бр░░р▒Нр░др▒Б, р░Ър░др▒Бр░░р░╕р▒Нр░░р░Вр░▓р▒Л р░Ор░ир▒НтАМр░Ьр░┐ р░Ер░Хр▒Нр░╖р░░р░╛р░▓р▒Б, р░кр▒Нр░░р░ор░╛р░ж р░╕р░Вр░Хр▒Зр░др░В, р░ор░Вр░Ър░┐р░жр░┐ р░Хр░╛р░жр▒Б
ЁЯЖЧ	р░Ур░Хр▒З, р░Ур░Хр▒З р░Ер░Хр▒Нр░╖р░░р░╛р░▓р▒Б, р░Ър░др▒Бр░░р░╕р▒Нр░░р░Вр░▓р▒Л р░Ур░Хр▒З р░Ер░Хр▒Нр░╖р░░р░╛р░▓р▒Б, р░╕р░░р▒З, р░╕р░░р▒З р░Чр▒Бр░░р▒Нр░др▒Б
ЁЯЖШ	р░Ор░╕р▒Нр░Ур░Ор░╕р▒Н, р░Ор░╕р▒Нр░Ур░Ор░╕р▒Н р░Ер░Хр▒Нр░╖р░░р░╛р░▓р▒Б, р░Ор░╕р▒Нр░Ур░Ор░╕р▒Н р░Чр▒Бр░░р▒Нр░др▒Б, р░Ър░др▒Бр░░р░╕р▒Нр░░р░Вр░▓р▒Л р░Ор░╕р▒Нр░Ур░Ор░╕р▒Н, р░ир░ир▒Нр░ир▒Б р░Хр░╛р░кр░╛р░бр░Вр░бр░┐, р░ор▒А р░╕р░╣р░╛р░пр░В р░Хр░╛р░╡р░╛р░▓р░┐
ЁЯЖЩ	р░Ер░кр▒Н, р░Жр░╢р▒Нр░Ър░░р▒Нр░пр░╛р░░р▒Нр░ер░Х р░Чр▒Бр░░р▒Нр░др▒Бр░др▒Л р░пр▒Бр░кр░┐ р░Ер░Хр▒Нр░╖р░░р░╛р░▓р▒Б, р░Чр▒Бр░░р▒Нр░др▒Б, р░кр▒Ир░Хр░┐ р░мр░Яр░ир▒Н, р░пр▒Бр░кр░┐
ЁЯЖЪ	р░кр▒Нр░░р░др▒Нр░пр░░р▒Нр░ер░┐, р░╡р░░р▒Нр░╕р▒Ж. р░мр░Яр░ир▒Н, р░╡р░░р▒Нр░╕р▒Жр░╕р▒Н, р░╡р░┐р░Ор░╕р▒Н р░Ер░Хр▒Нр░╖р░░р░╛р░▓р▒Б, р░╡р░┐р░░р▒Бр░жр▒Нр░зр░В
ЁЯИБ	р░Хр░Яр░Хр░╛р░ир░╛ р░Хр▒Лр░Хр▒Л, р░Ьр░кр░ир▒Ар░╕р▒Н р░кр░жр░В, р░Ьр░кр░ир▒Ар░╕р▒НтАМр░▓р▒Л "р░Зр░Хр▒Нр░Хр░б" р░╕р▒Вр░Ър░┐р░Вр░Ър▒З р░мр░Яр░ир▒Н
ЁЯИ╖	р░Жр░Хр▒Гр░др░┐р░▓р░┐р░кр░┐ р░Ер░Хр▒Нр░╖р░░р░В, р░Ьр░кр░ир▒Ар░╕р▒Н р░кр░жр░В, р░Ьр░кр░ир▒Ар░╕р▒Н р░нр░╛р░╖, р░Ьр░кр░ир▒Ар░╕р▒НтАМр░▓р▒Л "р░ир▒Жр░▓р░╡р░╛р░░р▒А р░ор▒Кр░др▒Нр░др░В" р░╕р▒Вр░Ър░┐р░Вр░Ър▒З р░мр░Яр░ир▒Н, р░Ьр░кр░╛р░ир▒Н
ЁЯИ╢	р░Жр░Хр▒Гр░др░┐р░▓р░┐р░кр░┐ р░Ер░Хр▒Нр░╖р░░р░В, р░Ьр░кр░ир▒Ар░╕р▒Н р░кр░жр░В, р░Ьр░кр░ир▒Ар░╕р▒Н р░нр░╛р░╖, р░Ьр░кр░ир▒Ар░╕р▒НтАМр░▓р▒Л "р░Ыр░╛р░░р▒Нр░Ьр▒Ар░▓р▒Б р░Йр░ир▒Нр░ир░╛р░пр░┐" р░╕р▒Вр░Ър░┐р░Вр░Ър▒З р░мр░Яр░ир▒Н, р░Ьр░кр░╛р░ир▒Н
ЁЯИп	р░Жр░Хр▒Гр░др░┐р░▓р░┐р░кр░┐ р░Ер░Хр▒Нр░╖р░░р░В, р░Ьр░кр░ир▒Ар░╕р▒Н р░кр░жр░В, р░Ьр░кр░ир▒Ар░╕р▒Н р░нр░╛р░╖, р░Ьр░кр░ир▒Ар░╕р▒НтАМр░▓р▒Л "р░░р░┐р░Ьр░░р▒Нр░╡р▒Н р░Ър▒Зр░пр░мр░бр░┐р░Вр░жр░┐" р░╕р▒Вр░Ър░┐р░Вр░Ър▒З р░мр░Яр░ир▒Н, р░Ьр░кр░╛р░ир▒Н
ЁЯЙР	р░Жр░Хр▒Гр░др░┐р░▓р░┐р░кр░┐ р░Ер░Хр▒Нр░╖р░░р░В, р░Ьр░кр░ир▒Ар░╕р▒Н р░кр░жр░В, р░Ьр░кр░ир▒Ар░╕р▒Н р░нр░╛р░╖, р░Ьр░кр░ир▒Ар░╕р▒НтАМр░▓р▒Л "р░мр▒Зр░░р░В" р░╕р▒Вр░Ър░┐р░Вр░Ър▒З р░мр░Яр░ир▒Н, р░Ьр░кр░╛р░ир▒Н
ЁЯИ╣	р░Жр░Хр▒Гр░др░┐р░▓р░┐р░кр░┐ р░Ер░Хр▒Нр░╖р░░р░В, р░Ьр░кр░ир▒Ар░╕р▒Н р░кр░жр░В, р░Ьр░кр░ир▒Ар░╕р▒Н р░нр░╛р░╖, р░Ьр░кр░ир▒Ар░╕р▒НтАМр░▓р▒Л "р░бр░┐р░╕р▒Нр░Хр▒Мр░Вр░Яр▒Н" р░╕р▒Вр░Ър░┐р░Вр░Ър▒З р░мр░Яр░ир▒Н, р░Ьр░кр░╛р░ир▒Н
ЁЯИЪ	р░Жр░Хр▒Гр░др░┐р░▓р░┐р░кр░┐ р░Ер░Хр▒Нр░╖р░░р░В, р░Ьр░кр░ир▒Ар░╕р▒Н р░кр░жр░В, р░Ьр░кр░ир▒Ар░╕р▒Н р░нр░╛р░╖, р░Ьр░кр░ир▒Ар░╕р▒НтАМр░▓р▒Л "р░Ыр░╛р░░р▒Нр░Ьр▒А р░▓р▒Зр░жр▒Б" р░╕р▒Вр░Ър░┐р░Вр░Ър▒З р░мр░Яр░ир▒Н, р░Ьр░кр░╛р░ир▒Н
ЁЯИ▓	р░Жр░Хр▒Гр░др░┐р░▓р░┐р░кр░┐ р░Ер░Хр▒Нр░╖р░░р░В, р░Ьр░кр░ир▒Ар░╕р▒Н р░кр░жр░В, р░Ьр░кр░ир▒Ар░╕р▒Н р░нр░╛р░╖, р░Ьр░кр░ир▒Ар░╕р▒НтАМр░▓р▒Л "р░ир░┐р░╖р░┐р░жр▒Нр░зр░В" р░╕р▒Вр░Ър░┐р░Вр░Ър▒З р░мр░Яр░ир▒Н, р░Ьр░кр░╛р░ир▒Н
ЁЯЙС	р░Жр░Хр▒Гр░др░┐р░▓р░┐р░кр░┐ р░Ер░Хр▒Нр░╖р░░р░В, р░Ър▒Ир░ир░╛, р░Ър▒Ир░ир▒Ар░╕р▒Н р░кр░жр░В, р░Ър▒Ир░ир▒Ар░╕р▒Н р░нр░╛р░╖, р░Ьр░кр░ир▒Ар░╕р▒НтАМр░▓р▒Л "р░Жр░ор▒Лр░жр░пр▒Лр░Чр▒Нр░пр░ор▒Ир░ир░жр░┐" р░╕р▒Вр░Ър░┐р░Вр░Ър▒З р░мр░Яр░ир▒Н
ЁЯИ╕	р░Жр░Хр▒Гр░др░┐р░▓р░┐р░кр░┐ р░Ер░Хр▒Нр░╖р░░р░В, р░Ър▒Ир░ир░╛, р░Ър▒Ир░ир▒Ар░╕р▒Н р░кр░жр░В, р░Ър▒Ир░ир▒Ар░╕р▒Н р░нр░╛р░╖, р░Ьр░кр░ир▒Ар░╕р▒НтАМр░▓р▒Л "р░жр░░р░Цр░╛р░╕р▒Нр░др▒Б" р░╕р▒Вр░Ър░┐р░Вр░Ър▒З р░мр░Яр░ир▒Н
ЁЯИ┤	р░Жр░Хр▒Гр░др░┐р░▓р░┐р░кр░┐ р░Ер░Хр▒Нр░╖р░░р░В, р░Ър▒Ир░ир░╛, р░Ър▒Ир░ир▒Ар░╕р▒Н р░кр░жр░В, р░Ър▒Ир░ир▒Ар░╕р▒Н р░нр░╛р░╖, р░Ьр░кр░ир▒Ар░╕р▒НтАМр░▓р▒Л "р░Йр░др▒Нр░др▒Ар░░р▒Нр░гр░д р░Чр▒Нр░░р▒Зр░бр▒Н" р░╕р▒Вр░Ър░┐р░Вр░Ър▒З р░мр░Яр░ир▒Н
ЁЯИ│	р░Жр░Хр▒Гр░др░┐р░▓р░┐р░кр░┐ р░Ер░Хр▒Нр░╖р░░р░В, р░Ър▒Ир░ир░╛, р░Ър▒Ир░ир▒Ар░╕р▒Н р░кр░жр░В, р░Ър▒Ир░ир▒Ар░╕р▒Н р░нр░╛р░╖, р░Ьр░кр░ир▒Ар░╕р▒НтАМр░▓р▒Л "р░Цр░╛р░│р▒А р░Йр░Вр░жр░┐" р░╕р▒Вр░Ър░┐р░Вр░Ър▒З р░мр░Яр░ир▒Н
ЁЯИ║	р░Жр░Хр▒Гр░др░┐р░▓р░┐р░кр░┐ р░Ер░Хр▒Нр░╖р░░р░В, р░Ър▒Ир░ир░╛, р░Ър▒Ир░ир▒Ар░╕р▒Н р░нр░╛р░╖, р░Ьр░кр░ир▒Ар░╕р▒НтАМр░▓р▒Л "р░╡р▒Нр░пр░╛р░кр░╛р░░р░В р░Хр▒Лр░╕р░В р░Ер░Вр░жр▒Бр░мр░╛р░Яр▒Бр░▓р▒Л р░Йр░Вр░жр░┐" р░╕р▒Вр░Ър░┐р░Вр░Ър▒З р░мр░Яр░ир▒Н
ЁЯИ╡	р░Жр░Хр▒Гр░др░┐р░▓р░┐р░кр░┐ р░Ер░Хр▒Нр░╖р░░р░В, р░Ър▒Ир░ир░╛, р░Ър▒Ир░ир▒Ар░╕р▒Н р░кр░жр░В, р░Ър▒Ир░ир▒Ар░╕р▒Н р░нр░╛р░╖, р░Ьр░кр░ир▒Ар░╕р▒НтАМр░▓р▒Л "р░Цр░╛р░│р▒Ар░▓р▒Б р░▓р▒Зр░╡р▒Б" р░╕р▒Вр░Ър░┐р░Вр░Ър▒З р░мр░Яр░ир▒Н
ЁЯФ┤	р░Ор░░р▒Бр░кр▒Б р░░р░Вр░Чр▒Б, р░кр▒Жр░жр▒Нр░ж р░Ор░░р▒Бр░кр▒Б р░░р░Вр░Чр▒Б р░╡р▒Гр░др▒Нр░др░В, р░╡р▒Гр░др▒Нр░др░В
ЁЯФ╡	р░ир▒Ар░▓р░┐ р░░р░Вр░Чр▒Б, р░кр▒Жр░жр▒Нр░ж р░ир▒Ар░▓р░┐ р░░р░Вр░Чр▒Б р░╡р▒Гр░др▒Нр░др░В, р░╡р▒Гр░др▒Нр░др░В
ЁЯФ╢	р░Хр░╛р░╖р░╛р░п р░░р░Вр░Чр▒Б, р░Ър░др▒Бр░░р▒Нр░нр▒Бр░Ьр░╛р░Хр░╛р░░р░В, р░бр▒Ир░ор░Вр░бр▒Н, р░кр▒Жр░жр▒Нр░ж р░Хр░╛р░╖р░╛р░п р░░р░Вр░Чр▒Б р░Ър░др▒Бр░░р▒Нр░нр▒Бр░Ьр░╛р░Хр░╛р░░р░В
ЁЯФ╖	р░Ър░др▒Бр░░р▒Нр░нр▒Бр░Ьр░╛р░Хр░╛р░░р░В, р░бр▒Ир░ор░Вр░бр▒Н, р░ир▒Ар░▓р░┐ р░░р░Вр░Чр▒Б, р░кр▒Жр░жр▒Нр░ж р░ир▒Ар░▓р░┐ р░░р░Вр░Чр▒Б р░Ър░др▒Бр░░р▒Нр░нр▒Бр░Ьр░╛р░Хр░╛р░░р░В
ЁЯФ╕	р░Хр░╛р░╖р░╛р░п р░░р░Вр░Чр▒Б, р░Ър░др▒Бр░░р▒Нр░нр▒Бр░Ьр░╛р░Хр░╛р░░р░В, р░Ър░┐р░ир▒Нр░и р░Хр░╛р░╖р░╛р░п р░░р░Вр░Чр▒Б р░Ър░др▒Бр░░р▒Нр░нр▒Бр░Ьр░╛р░Хр░╛р░░р░В, р░бр▒Ир░ор░Вр░бр▒Н
ЁЯФ╣	р░Ър░др▒Бр░░р▒Нр░нр▒Бр░Ьр░╛р░Хр░╛р░░р░В, р░Ър░┐р░ир▒Нр░и р░ир▒Ар░▓р░┐ р░░р░Вр░Чр▒Б р░Ър░др▒Бр░░р▒Нр░нр▒Бр░Ьр░╛р░Хр░╛р░░р░В, р░бр▒Ир░ор░Вр░бр▒Н, р░ир▒Ар░▓р░┐ р░░р░Вр░Чр▒Б
ЁЯФ║	р░Ор░░р▒Бр░кр▒Бр░░р░Вр░Чр▒Б, р░др▒Нр░░р░┐р░нр▒Бр░Ьр░В, р░кр▒Ир░Хр░┐, р░кр▒Ир░Хр░┐ р░╕р▒Вр░Ър░┐р░Вр░Ър▒З р░кр▒Жр░жр▒Нр░ж р░Ор░░р▒Бр░кр▒Бр░░р░Вр░Чр▒Б р░др▒Нр░░р░┐р░нр▒Бр░Ьр░В
ЁЯФ╗	р░Ор░░р▒Бр░кр▒Бр░░р░Вр░Чр▒Б, р░Хр▒Нр░░р░┐р░Вр░жр░┐р░Хр░┐, р░Хр▒Нр░░р░┐р░Вр░жр░┐р░Хр░┐ р░╕р▒Вр░Ър░┐р░Вр░Ър▒З р░кр▒Жр░жр▒Нр░ж р░Ор░░р▒Бр░кр▒Бр░░р░Вр░Чр▒Б р░др▒Нр░░р░┐р░нр▒Бр░Ьр░В, р░др▒Нр░░р░┐р░нр▒Бр░Ьр░В
ЁЯТа	р░Ър░др▒Бр░░р▒Нр░нр▒Бр░Ьр░╛р░Хр░╛р░░р░В р░ор░зр▒Нр░пр░▓р▒Л р░Ър▒Бр░Хр▒Нр░Х, р░кр▒Бр░╖р▒Нр░кр░В, р░╡р░Ьр▒Нр░░р░╛р░Хр░╛р░░р░В
ЁЯФШ	р░мр░Яр░ир▒Н, р░░р▒Зр░бр░┐р░пр▒Л, р░░р▒Зр░бр░┐р░пр▒Л р░мр░Яр░ир▒Н
ЁЯФ▓	р░Ър░др▒Бр░░р░╕р▒Нр░░р░В, р░ир░▓р▒Бр░кр▒Б р░░р░Вр░Чр▒Б, р░ир░▓р▒Бр░кр▒Б р░░р░Вр░Чр▒Б р░Ър░др▒Бр░░р░╕р▒Нр░░р░В
ЁЯФ│	р░Ър░др▒Бр░░р░╕р▒Нр░░р░В, р░др▒Жр░▓р▒Бр░кр▒Б р░░р░Вр░Чр▒Б, р░др▒Жр░▓р▒Бр░кр▒Б р░░р░Вр░Чр▒Б р░Ър░др▒Бр░░р░╕р▒Нр░░р░В
ЁЯПБ	р░Хр▒Нр░░р▒Ар░б, р░Чр░│р▒Нр░▓ р░кр░др░╛р░Хр░В, р░Ьр▒Жр░Вр░бр░╛, р░░р▒Зр░╕р▒Бр░▓р▒Б
ЁЯЪй	р░др▒Нр░░р░┐р░нр▒Бр░Ьр░╛р░Хр░╛р░░ р░Ьр▒Жр░Вр░бр░╛, р░кр▒Лр░╕р▒Нр░Яр▒НтАМр░ир▒Б р░др▒Жр░▓р░┐р░пр░Ьр▒Зр░╕р▒З р░др▒Нр░░р░┐р░нр▒Бр░Ьр░╛р░Хр░╛р░░ р░Ьр▒Жр░Вр░бр░╛, р░кр▒Лр░╕р▒Нр░Яр▒НтАМр░кр▒И р░др▒Нр░░р░┐р░нр▒Бр░Ьр░╛р░Хр░╛р░░ р░Ьр▒Жр░Вр░бр░╛
ЁЯОМ	р░Ьр▒Жр░Вр░бр░╛р░▓р▒Б, р░╡р░┐р░░р▒Бр░жр▒Нр░з р░жр░┐р░╢р░▓р▒Нр░▓р▒Л р░ир░┐р░▓р░мр▒Жр░Яр▒Нр░Яр░┐р░и р░░р▒Жр░Вр░бр▒Б р░Ьр░кр░╛р░ир▒Н р░Ьр▒Жр░Вр░бр░╛р░▓р▒Б, р░╡р░┐р░░р▒Бр░жр▒Нр░з р░жр░┐р░╢р░▓р▒Нр░▓р▒Л р░ир░┐р░▓р░мр▒Жр░Яр▒Нр░Яр░┐р░и р░░р▒Жр░Вр░бр▒Б р░Ьр▒Жр░Вр░бр░╛р░▓р▒Б, р░╡р▒Зр░бр▒Бр░Х
ЁЯП┤	р░Ор░Чр░░р░бр░В, р░Ор░Чр▒Бр░░р▒Бр░др▒Бр░ир▒Нр░и р░ир░▓р▒Бр░кр▒Б р░Ьр▒Жр░Вр░бр░╛, р░Ьр▒Жр░Вр░бр░╛, р░ир░▓р▒Бр░кр▒Б
ЁЯП│тАНЁЯМИ	р░Зр░Вр░зр▒Нр░░р░зр░ир▒Бр░╕р▒Нр░╕р▒Б, р░Зр░Вр░зр▒Нр░░р░зр░ир▒Бр░╕р▒Нр░╕р▒Б р░кр░др░╛р░Хр░В, р░кр░др░╛р░Хр░В
ЁЯП┤тАНтШа	р░Ьр░╛р░▓р▒А р░░р▒Лр░Ьр░░р▒Н, р░жр▒Лр░кр░┐р░бр▒А, р░ир░┐р░зр░┐, р░кр▒Ир░░р▒Зр░Яр▒Н, р░╕р░ор▒Бр░жр▒Нр░░р░кр▒Бр░жр▒Кр░Вр░Чр░▓ р░Ьр▒Жр░Вр░бр░╛
┬йя╕П	р░Хр░╛р░кр▒Ар░░р▒Ир░Яр▒Н, р░Хр░╛р░кр▒Ар░░р▒Ир░Яр▒Н р░Ър░┐р░╣р▒Нр░ир░В, р░Ър░┐р░╣р▒Нр░ир░В
┬оя╕П	р░ор░╛р░░р▒Нр░Хр▒Н, р░░р░┐р░Ьр░┐р░╕р▒Нр░Яр░░р▒Нр░бр▒Н, р░░р░┐р░Ьр░┐р░╕р▒Нр░Яр░░р▒Нр░бр▒Н р░Яр▒Нр░░р▒Зр░бр▒Н р░ор░╛р░░р▒Нр░Хр▒Н
тА╝я╕П	р░Жр░╢р▒Нр░Ър░░р▒Нр░пр░╛р░░р▒Нр░ер░Хр░В, р░Жр░╢р▒Нр░Ър░░р▒Нр░пр░╛р░░р▒Нр░ер░Хр░В р░Чр▒Бр░░р▒Нр░др▒Бр░▓р▒Б, р░Чр▒Бр░░р▒Нр░др▒Б
тБЙя╕П	р░Жр░╢р▒Нр░Ър░░р▒Нр░пр░╛р░░р▒Нр░ер░Хр░В, р░Жр░╢р▒Нр░Ър░░р▒Нр░пр░╛р░░р▒Нр░ер░Хр░В р░кр▒Нр░░р░╢р▒Нр░ир░╛р░░р▒Нр░ер░Хр░В р░Чр▒Бр░░р▒Нр░др▒Б, р░Чр▒Бр░░р▒Нр░др▒Б, р░кр▒Нр░░р░╢р▒Нр░ир░╛р░░р▒Нр░ер░Хр░В
тДвя╕П	р░Яр▒Нр░░р▒Зр░бр▒Н, р░Яр▒Нр░░р▒Зр░бр▒Н р░ор░╛р░░р▒Нр░Хр▒Н р░Ър░┐р░╣р▒Нр░ир░В, р░ор░╛р░░р▒Нр░Хр▒Н
тД╣я╕П	р░╕р░ор░╛р░Ър░╛р░░ р░ор▒Вр░▓р░В, р░╕р░ор░╛р░Ър░╛р░░р░В
тЖФя╕П	р░Ор░бр░о, р░Ор░бр░о р░ор░░р░┐р░пр▒Б р░Хр▒Бр░бр░┐ р░мр░╛р░гр░В, р░Хр▒Бр░бр░┐, р░мр░╛р░гр░В
тЖХя╕П	р░Ор░Чр▒Бр░╡, р░Ор░Чр▒Бр░╡ р░ор░░р░┐р░пр▒Б р░жр░┐р░Чр▒Бр░╡ р░мр░╛р░гр░В, р░жр░┐р░Чр▒Бр░╡, р░мр░╛р░гр░В
тЖЦя╕П	р░Ор░Чр▒Бр░╡ р░Ор░бр░о р░мр░╛р░гр░В, р░жр░┐р░╢, р░мр░╛р░гр░В, р░╡р░╛р░пр▒Бр░╡р▒Нр░пр░В
тЖЧя╕П	р░Ир░╢р░╛р░ир▒Нр░пр░В, р░Ор░Чр▒Бр░╡ р░Хр▒Бр░бр░┐ р░ор▒Вр░▓ р░мр░╛р░гр░В, р░жр░┐р░╢, р░мр░╛р░гр░В
тЖШя╕П	р░Жр░Чр▒Нр░ир▒Зр░пр░В, р░жр░┐р░Чр▒Бр░╡ р░Хр▒Бр░бр░┐ р░ор▒Вр░▓ р░мр░╛р░гр░В, р░жр░┐р░╢, р░мр░╛р░гр░В
тЖЩя╕П	р░жр░┐р░Чр▒Бр░╡ р░Ор░бр░о р░мр░╛р░гр░В, р░жр░┐р░╢, р░ир▒Ир░░р▒Бр░др░┐, р░мр░╛р░гр░В
тЖйя╕П	р░Ор░бр░ор░╡р▒Ир░кр▒Б, р░Ор░бр░ор░╡р▒Ир░кр▒Б р░╡р░Вр░кр▒Б р░др░┐р░░р░┐р░Чр░┐р░и р░Хр▒Бр░бр░┐ р░мр░╛р░гр░В, р░Хр▒Бр░бр░┐, р░мр░╛р░гр░В
тЖкя╕П	р░Ор░бр░о, р░Хр▒Бр░бр░┐р░╡р▒Ир░кр▒Б, р░Хр▒Бр░бр░┐р░╡р▒Ир░кр▒Б р░╡р░Вр░кр▒Б р░др░┐р░░р░┐р░Чр░┐р░и р░Ор░бр░о р░мр░╛р░гр░В, р░мр░╛р░гр░В
тМЪя╕П	р░Чр░бр░┐р░пр░╛р░░р░В, р░Ър▒Зр░др░┐ р░Чр░бр░┐р░пр░╛р░░р░В, р░Ър▒Зр░пр░┐
тМЫя╕П	р░Ер░кр▒Нр░кр▒Бр░бр▒З р░кр▒Нр░░р░╛р░░р░Вр░нр░┐р░Вр░Ър░┐р░и р░Зр░╕р▒Бр░Х р░Чр░бр░┐р░пр░╛р░░р░В, р░Зр░╕р▒Бр░Х, р░Чр░бр░┐р░пр░╛р░░р░В
тМия╕П	р░Хр░Вр░кр▒Нр░пр▒Вр░Яр░░р▒Н, р░Хр▒Ар░мр▒Лр░░р▒Нр░бр▒Н, р░Яр▒Ир░кр░┐р░Вр░Чр▒Н
тППя╕П	р░Ор░Ьр▒Жр░Хр▒Нр░Яр▒Н р░Ър▒Зр░пр░┐ р░мр░Яр░ир▒Н, р░Чр▒Бр░░р▒Нр░др▒Б, р░мр░пр░Я
тП▒я╕П	р░╡р░╛р░Ър▒А, р░╕р▒Нр░Яр░╛р░кр▒Н, р░╕р▒Нр░Яр░╛р░кр▒НтАМр░╡р░╛р░Ър▒А
тП▓я╕П	р░Чр░бр░┐р░пр░╛р░░р░В, р░Яр▒Ир░ор░░р▒Н, р░Яр▒Ир░ор░░р▒Н р░Чр░бр░┐р░пр░╛р░░р░В
тП│я╕П	р░Зр░╕р▒Бр░Х, р░Зр░╕р▒Бр░Х р░Чр░бр░┐р░пр░╛р░░р░В, р░Чр░бр░┐р░пр░╛р░░р░В
тП╕я╕П	р░Чр▒Бр░░р▒Нр░др▒Б, р░ир░┐р░▓р░┐р░кр░┐р░╡р▒Зр░пр░бр░В, р░кр░╛р░Ьр▒Н р░мр░Яр░ир▒Н
тП╣я╕П	р░Жр░кр░┐р░╡р▒Зр░пр░бр░В, р░Жр░кр░┐р░╡р▒Зр░пр░┐ р░мр░Яр░ир▒Н, р░Чр▒Бр░░р▒Нр░др▒Б
тП║я╕П	р░Чр▒Бр░░р▒Нр░др▒Б, р░░р░┐р░Хр░╛р░░р▒Нр░бр▒Н, р░░р░┐р░Хр░╛р░░р▒Нр░бр▒Н р░мр░Яр░ир▒Н
тУВя╕П	р░Ор░ор▒Н, р░╡р▒Гр░др▒Нр░др░В, р░╡р▒Гр░др▒Нр░др░╛р░Хр░╛р░░р░Вр░▓р▒Л р░Ор░ор▒Н р░Ер░Хр▒Нр░╖р░░р░В
тЦкя╕П	р░Ър░др▒Бр░░р░╕р▒Нр░░р░В, р░Ър░┐р░ир▒Нр░и р░ир░▓р▒Бр░кр▒Б р░░р░Вр░Чр▒Б р░Ър░др▒Бр░░р░╕р▒Нр░░р░В, р░ир░▓р▒Бр░кр▒Б р░░р░Вр░Чр▒Б
тЦля╕П	р░Ър░др▒Бр░░р░╕р▒Нр░░р░В, р░Ър░┐р░ир▒Нр░и р░др▒Жр░▓р▒Бр░кр▒Б р░░р░Вр░Чр▒Б р░Ър░др▒Бр░░р░╕р▒Нр░░р░В, р░др▒Жр░▓р▒Бр░кр▒Б р░░р░Вр░Чр▒Б
тЧ╗я╕П	р░Ър░др▒Бр░░р░╕р▒Нр░░р░В, р░др▒Жр░▓р▒Бр░кр▒Б р░░р░Вр░Чр▒Б, р░ор░зр▒Нр░пр░╕р▒Нр░е р░др▒Жр░▓р▒Бр░кр▒Б р░░р░Вр░Чр▒Б р░Ър░др▒Бр░░р░╕р▒Нр░░р░В
тЧ╝я╕П	р░Ър░др▒Бр░░р░╕р▒Нр░░р░В, р░ир░▓р▒Бр░кр▒Б р░░р░Вр░Чр▒Б, р░ор░зр▒Нр░пр░╕р▒Нр░е р░ир░▓р▒Бр░кр▒Б р░░р░Вр░Чр▒Б р░Ър░др▒Бр░░р░╕р▒Нр░░р░В
тЧ╜я╕П	р░Ър░др▒Бр░░р░╕р▒Нр░░р░В, р░др▒Жр░▓р▒Бр░кр▒Б р░░р░Вр░Чр▒Б, р░ор░зр▒Нр░пр░╕р▒Нр░е р░Ър░┐р░ир▒Нр░и р░др▒Жр░▓р▒Бр░кр▒Б р░░р░Вр░Чр▒Б р░Ър░др▒Бр░░р░╕р▒Нр░░р░В
тЧ╛я╕П	р░Ър░др▒Бр░░р░╕р▒Нр░░р░В, р░ир░▓р▒Бр░кр▒Б р░░р░Вр░Чр▒Б, р░ор░зр▒Нр░пр░╕р▒Нр░е р░Ър░┐р░ир▒Нр░и р░ир░▓р▒Бр░кр▒Б р░░р░Вр░Чр▒Б р░Ър░др▒Бр░░р░╕р▒Нр░░р░В
тШАя╕П	р░Ор░Вр░б, р░Хр░┐р░░р░гр░╛р░▓р▒Б, р░кр▒Нр░░р░Хр░╛р░╢р░╡р░Вр░др░В, р░╕р▒Вр░░р▒Нр░пр▒Бр░бр▒Б
тШБя╕П	р░ор▒Зр░Шр░В, р░╡р░╛р░др░╛р░╡р░░р░гр░В
тШВя╕П	р░Чр▒Кр░бр▒Бр░Чр▒Б, р░╡р░░р▒Нр░╖р░В, р░╡р░╕р▒Нр░др▒Нр░░р░зр░╛р░░р░г
тШГя╕П	р░ор░Вр░Ър▒Б, р░ор░Вр░Ър▒Бр░др▒Л р░Хр░кр▒Нр░кр░мр░бр░┐р░и р░ор░Вр░Ър▒Бр░ор░ир░┐р░╖р░┐, р░ор░ир░┐р░╖р░┐
тШДя╕П	р░Ър▒Бр░Хр▒Нр░Х, р░др▒Лр░Х, р░др▒Лр░Х р░Ър▒Бр░Хр▒Нр░Х
тШОя╕П	р░Хр░╛р░▓р▒Н, р░Яр▒Жр░▓р░┐р░лр▒Лр░ир▒Н
тШСя╕П	р░Ор░Вр░кр░┐р░Х, р░кр▒Жр░Яр▒Нр░Яр▒Ж, р░мр▒Нр░пр░╛р░▓р▒Жр░Яр▒Н, р░мр▒Нр░пр░╛р░▓р▒Жр░Яр▒Н р░кр▒Жр░Яр▒Нр░Яр▒Жр░▓р▒Л р░др░ир░┐р░Цр▒А р░Чр▒Бр░░р▒Нр░др▒Б
тШФя╕П	р░Чр▒Кр░бр▒Бр░Чр▒Б, р░Ър▒Бр░Хр▒Нр░Х, р░╡р░╛р░и, р░╡р░╛р░ир░Ър▒Бр░Хр▒Нр░Хр░▓р░др▒Л р░Чр▒Кр░бр▒Бр░Чр▒Б
тШХя╕П	р░Хр░╛р░лр▒А, р░Яр▒А, р░кр░╛р░ир▒Ар░пр░В, р░╡р▒Зр░бр░┐, р░╡р▒Зр░бр░┐ р░кр░╛р░ир▒Ар░пр░В
тШШя╕П	р░Жр░Хр▒Б, р░Чр░░р░┐р░Х, р░ор▒Вр░бр▒Б р░Жр░Хр▒Бр░▓р▒Б р░Йр░ир▒Нр░и р░Чр░░р░┐р░Х
тШЭя╕П	р░Ър▒Вр░кр▒Бр░Я, р░Ър▒Вр░кр▒Бр░бр▒Б р░╡р▒Зр░▓р▒Б р░кр▒Ир░Хр░┐ р░Ър▒Вр░кр▒Бр░Я, р░╡р▒Зр░▓р▒Б
тШая╕П	р░Ер░кр░╛р░пр░Хр░░р░В, р░кр▒Бр░░р▒Нр░░р▒Ж, р░╡р▒Нр░пр░др▒Нр░пр░╕р▒Нр░д р░Ор░ор▒Бр░Хр░▓р▒Б
тШвя╕П	р░░р▒Зр░бр░┐р░пр▒Л р░зр░╛р░░р▒Нр░ор░┐р░Хр░д, р░░р▒Зр░бр░┐р░пр▒Лр░пр░╛р░Хр▒Нр░Яр░┐р░╡р▒Н
тШгя╕П	р░кр░░р▒Нр░пр░╛р░╡р░░р░г р░╣р░╛р░ир░┐р░Хр░░р░В, р░мр░пр▒Л р░╣р░Ьр░╛р░░р▒Нр░бр▒Н
тШжя╕П	р░Хр▒Нр░░р░╛р░╕р▒Н, р░Хр▒Нр░░р▒Ир░╕р▒Нр░др░╡р▒Бр░бр▒Б, р░ор░др░В, р░╕р░ир░╛р░др░и р░Хр▒Нр░░р░╛р░╕р▒Н
тШкя╕П	р░Зр░╕р▒Нр░▓р░╛р░В, р░ир░Хр▒Нр░╖р░др▒Нр░░р░В р░ор░░р░┐р░пр▒Б р░Ър░Вр░жр▒Нр░░р░╡р░Вр░Х, р░ор░др░В, р░ор▒Бр░╕р▒Нр░▓р░┐р░В
тШоя╕П	р░╢р░╛р░Вр░др░┐, р░╕р░Вр░зр░┐
тШпя╕П	р░Яр░╛р░╡р▒Л, р░ор░др░В, р░пр░╛р░Вр░Чр▒Н, р░пр░┐р░ир▒Н, р░пр░┐р░ир▒Н р░пр░╛р░Вр░Чр▒Н
тШ╕я╕П	р░Ър░Хр▒Нр░░р░В, р░зр░░р▒Нр░ор░Ър░Хр▒Нр░░р░В, р░мр▒Мр░жр▒Нр░зр▒Бр░бр▒Б, р░ор░др░В
тШ╣я╕П	р░Хр▒Лр░кр░В, р░Хр▒Лр░кр░Вр░Чр░╛ р░Йр░ир▒Нр░и р░ор▒Бр░Цр░В, р░ор▒Бр░Цр░В
тШ║я╕П	р░ир░╡р▒Нр░╡р▒Б, р░ир░╡р▒Нр░╡р▒Бр░др▒Бр░ир▒Нр░и р░ор▒Бр░Цр░В, р░ор▒Бр░Цр░В
тЩАя╕П	р░ор░╣р░┐р░│, р░ор░╣р░┐р░│ р░╕р░Вр░Хр▒Зр░др░В, р░╕р▒Нр░др▒Нр░░р▒А
тЩВя╕П	р░кр▒Бр░░р▒Бр░╖р▒Бр░бр▒Б, р░кр▒Бр░░р▒Бр░╖р▒Бр░▓ р░╕р░Вр░Хр▒Зр░др░В, р░ор░Чр░╛р░бр▒Б
тЩИя╕П	р░Ър░Хр▒Нр░░р░В, р░ор▒Зр░╖р░░р░╛р░╢р░┐
тЩЙя╕П	р░Ър░Хр▒Нр░░р░В, р░╡р▒Гр░╖р░нр░░р░╛р░╢р░┐
тЩКя╕П	р░Ър░Хр▒Нр░░р░В, р░ор░┐р░зр▒Бр░ир░░р░╛р░╢р░┐
тЩЛя╕П	р░Хр░░р▒Нр░Хр░╛р░Яр░Хр░░р░╛р░╢р░┐, р░Ър░Хр▒Нр░░р░В
тЩМя╕П	р░Ър░Хр▒Нр░░р░В, р░╕р░┐р░Вр░╣р░░р░╛р░╢р░┐
тЩНя╕П	р░Хр░ир▒Нр░пр░╛р░░р░╛р░╢р░┐, р░Ър░Хр▒Нр░░р░В
тЩОя╕П	р░Ър░Хр▒Нр░░р░В, р░др▒Бр░▓р░╛р░░р░╛р░╢р░┐
тЩПя╕П	р░Ър░Хр▒Нр░░р░В, р░╡р▒Гр░╢р▒Нр░Ър░┐р░Хр░░р░╛р░╢р░┐
тЩРя╕П	р░Ър░Хр▒Нр░░р░В, р░зр░ир▒Вр░░р░╛р░╢р░┐
тЩСя╕П	р░Ър░Хр▒Нр░░р░В, р░ор░Хр░░р░░р░╛р░╢р░┐
тЩТя╕П	р░Хр▒Бр░Вр░нр░░р░╛р░╢р░┐, р░Ър░Хр▒Нр░░р░В
тЩУя╕П	р░Ър░Хр▒Нр░░р░В, р░ор▒Ар░ир░░р░╛р░╢р░┐
тЩЯя╕П	р░Ър░жр░░р░Вр░Чр░В, р░Ър░жр░░р░Вр░Чр░Вр░▓р▒Л р░мр░Вр░Яр▒Б, р░ир░Хр░┐р░▓р▒А, р░ор░┐р░Чр░┐р░▓р░┐р░ир░жр░┐
тЩая╕П	р░кр▒Зр░Хр░╛р░Я, р░кр▒Зр░Хр░╛р░Яр░▓р▒Л р░╕р▒Нр░кр▒Зр░бр▒Н, р░╕р▒Вр░Яр▒Н, р░╕р▒Нр░кр▒Зр░бр▒Н
тЩгя╕П	р░Хр▒Нр░▓р░мр▒НтАМр░▓р▒Б, р░кр▒Зр░Хр░╛р░Я, р░кр▒Зр░Хр░╛р░Яр░▓р▒Л р░Хр▒Нр░▓р░мр▒Н, р░╕р▒Вр░Яр▒Н
тЩея╕П	р░кр▒Зр░Хр░╛р░Я, р░╕р▒Вр░Яр▒Н, р░╣р░╛р░░р▒Нр░Яр▒Н р░╕р▒Вр░Яр▒Н, р░╣р░╛р░░р▒Нр░Яр▒НтАМр░▓р▒Б
тЩжя╕П	р░бр▒Ир░ор░Вр░бр▒НтАМр░▓р▒Б, р░кр▒Зр░Хр░╛р░Я, р░кр▒Зр░Хр░╛р░Яр░▓р▒Л р░бр▒Ир░ор░Вр░бр▒Н, р░╕р▒Вр░Яр▒Н
тЩия╕П	р░ир▒Ар░░р▒Б, р░мр▒Бр░Чр▒Нр░Ч, р░╡р▒Зр░бр░┐, р░╡р▒Зр░бр░┐ р░ир▒Ар░Яр░┐р░Хр▒Кр░▓р░ир▒Бр░▓р▒Б
тЩ╗я╕П	р░кр▒Бр░ир░░р▒Бр░кр░пр▒Лр░Чр░В, р░░р▒Ар░╕р▒Ир░Хр▒Нр░▓р░┐р░Вр░Чр▒Н
тЩ╛я╕П	р░Ер░кр░░р░┐р░ор░┐р░др░В, р░Ер░кр░╛р░░р░д, р░╢р░╛р░╢р▒Нр░╡р░др░В, р░╕р░╛р░░р▒Нр░╡р░др▒Нр░░р░┐р░Хр░В
тЩ┐я╕П	р░Ър░Хр▒Нр░░р░╛р░▓ р░Хр▒Бр░░р▒Нр░Ър▒А, р░╡р░┐р░Хр░▓р░╛р░Вр░Чр▒Бр░▓р▒Б, р░╡р▒Ар░▓р▒Н р░Ър▒Жр░пр░┐р░░р▒Н
тЪТя╕П	р░Чр░бр▒Нр░бр░кр░╛р░░, р░╕р░╛р░зр░ир░В, р░╕р▒Бр░др▒Нр░др░┐, р░╕р▒Бр░др▒Нр░др░┐ р░ор░░р░┐р░пр▒Б р░Чр░бр▒Нр░бр░кр░╛р░░
тЪУя╕П	р░Чр▒Бр░░р▒Нр░др▒Б, р░▓р░Вр░Чр░░р▒Б, р░▓р░Вр░Чр░░р▒Б р░Чр▒Бр░░р▒Нр░др▒Б
тЪФя╕П	р░Жр░пр▒Бр░зр░В, р░Хр░др▒Нр░др▒Бр░▓р▒Б, р░╡р░┐р░░р▒Бр░жр▒Нр░з р░жр░┐р░╢р░▓р▒Нр░▓р▒Л р░Йр░Вр░Ър░бр░В, р░╡р░┐р░░р▒Бр░жр▒Нр░з р░жр░┐р░╢р░▓р▒Нр░▓р▒Л р░Йр░Вр░Ър░┐р░и р░░р▒Жр░Вр░бр▒Б р░Хр░др▒Нр░др▒Бр░▓р▒Б
тЪХя╕П	р░╡р▒Ир░жр▒Нр░п р░Ър░┐р░╣р▒Нр░ир░В, р░╡р▒Ир░жр▒Нр░пр░В, р░╡р▒Нр░пр░╛р░зр▒Бр░▓р░ир▒Б р░ир░пр░В р░Ър▒Зр░╕р▒З р░╡р▒Нр░пр░Хр▒Нр░др░┐, р░╕р░┐р░мр▒Нр░мр░Вр░жр░┐
тЪЦя╕П	р░Хр▒Кр░▓р░д, р░др░Хр▒Нр░Хр▒Жр░б, р░др▒Нр░░р░╛р░╕р▒Б, р░╕р░ор░╛р░ир░В
тЪЧя╕П	р░мр░Яр▒Нр░Яр░┐, р░░р░╕р░╛р░пр░ир░╢р░╛р░╕р▒Нр░др▒Нр░░р░В, р░╕р░╛р░зр░ир░В
тЪЩя╕П	р░Чр▒Зр░░р▒Н, р░╡р░┐р░бр░┐р░нр░╛р░Чр░В, р░╕р░╛р░зр░ир░В
тЪЫя╕П	р░Ер░гр▒Бр░╡р▒Б, р░ир░╛р░╕р▒Нр░др░┐р░Хр▒Бр░бр▒Б
тЪая╕П	р░ор▒Бр░Вр░жр▒Бр░Ьр░╛р░Чр▒Нр░░р░др▒Нр░д, р░╣р▒Жр░Ър▒Нр░Ър░░р░┐р░Х
тЪбя╕П	р░Ър░┐р░╣р▒Нр░ир░В, р░╡р░┐р░жр▒Нр░пр▒Бр░др▒Н, р░╡р░┐р░жр▒Нр░пр▒Бр░др▒Н р░Ър░┐р░╣р▒Нр░ир░В
тЪкя╕П	р░др▒Жр░▓р▒Бр░кр▒Б р░░р░Вр░Чр▒Б, р░др▒Жр░▓р▒Бр░кр▒Б р░░р░Вр░Чр▒Б р░╡р▒Гр░др▒Нр░др░В, р░╡р▒Гр░др▒Нр░др░В
тЪля╕П	р░ир░▓р▒Бр░кр▒Б р░░р░Вр░Чр▒Б, р░ир░▓р▒Бр░кр▒Б р░░р░Вр░Чр▒Б р░╡р▒Гр░др▒Нр░др░В, р░╡р▒Гр░др▒Нр░др░В
тЪ░я╕П	р░кр▒Жр░Яр▒Нр░Яр▒Ж, р░ор░░р░гр░В, р░╢р░╡р░В, р░╢р░╡р░кр▒Зр░Яр░┐р░Х
тЪ▒я╕П	р░Ер░Вр░др▒Нр░пр░Хр▒Нр░░р░┐р░пр░▓р▒Б, р░Ер░╕р▒Нр░ер░┐р░Хр░▓ р░кр░╛р░др▒Нр░░, р░кр░╛р░др▒Нр░░, р░ор░░р░гр░В
тЪ╜я╕П	р░лр▒Бр░Яр▒Н р░мр░╛р░▓р▒Н, р░╕р░╛р░Хр░░р▒Н р░мр░╛р░▓р▒Н
тЪ╛я╕П	р░Хр▒Нр░░р▒Ар░б, р░мр░╛р░▓р▒Н, р░мр▒Зр░╕р▒НтАМр░мр░╛р░▓р▒Н
тЫДя╕П	р░ор░Вр░Ър▒Б, р░ор░Вр░Ър▒Б р░ор░ир░┐р░╖р░┐, р░ор░ир░┐р░╖р░┐
тЫЕя╕П	р░ор░мр▒Нр░мр▒Б, р░ор░мр▒Нр░мр▒Бр░▓ р░Ър░╛р░Яр▒Б р░╕р▒Вр░░р▒Нр░пр▒Бр░бр▒Б, р░╕р▒Вр░░р▒Нр░пр▒Бр░бр▒Б
тЫИя╕П	р░ор▒Жр░░р▒Бр░кр▒Б, р░ор▒Жр░░р▒Бр░╕р▒Нр░др▒В р░╡р░╛р░и р░Хр▒Бр░░р▒Бр░╕р▒Нр░др▒Бр░ир▒Нр░и р░ор▒Зр░Шр░В, р░ор▒Зр░Шр░В, р░╡р░╛р░и
тЫПя╕П	р░Чр░бр▒Нр░бр░кр░╛р░░, р░др░╡р▒Нр░╡р░бр░В
тЫСя╕П	р░Хр░╛р░░р▒Нр░ор░┐р░Хр▒Бр░бр▒Б, р░Ьр░кр░╛р░ир▒Н р░Хр░╛р░░р▒Нр░ор░┐р░Хр▒Бр░бр▒Б р░зр░░р░┐р░Вр░Ър▒З р░Яр▒Лр░кр▒А, р░Яр▒Лр░кр▒А, р░░р░Хр▒Нр░╖р░г р░Хр░╛р░░р▒Нр░ор░┐р░Хр▒Бр░бр▒Б р░зр░░р░┐р░Вр░Ър▒З р░Яр▒Лр░кр▒А
тЫУя╕П	р░Чр▒Кр░▓р▒Бр░╕р▒Б, р░Чр▒Кр░▓р▒Бр░╕р▒Бр░▓р▒Б, р░Ър▒Жр░пр░┐р░ир▒Н
тЫФя╕П	р░кр▒Нр░░р░╡р▒Зр░╢р░В р░ир░┐р░╖р░┐р░жр▒Нр░зр░В р░Ър░┐р░╣р▒Нр░ир░В, р░кр▒Нр░░р░╡р▒Зр░╢р░В р░▓р▒Зр░жр▒Б
тЫйя╕П	р░Ьр░кр░ир▒Ар░пр▒Бр░▓ р░кр▒Нр░░р░╛р░░р▒Нр░ер░ир░╛ р░ор░Вр░жр░┐р░░р░В, р░Ьр░кр░╛р░ир▒Н, р░кр▒Нр░░р░╛р░░р▒Нр░ер░и, р░ор░Вр░жр░┐р░░р░В
тЫкя╕П	р░Ър░░р▒Нр░Ър░┐, р░Ър░░р▒Нр░Ър▒Н
тЫ░я╕П	р░кр░░р▒Нр░╡р░др░В
тЫ▒я╕П	р░Чр▒Кр░бр▒Бр░Чр▒Б, р░ор▒Ир░жр░╛р░ир░В, р░ор▒Ир░жр░╛р░ир░Вр░▓р▒Л р░Йр░ир▒Нр░и р░Чр▒Кр░бр▒Бр░Чр▒Б
тЫ▓я╕П	р░Ьр░кр░╛р░ир▒Н, р░лр▒Мр░Вр░Яр▒Жр░пр░┐р░ир▒Н, р░ор▒Нр░пр░╛р░кр▒Н
тЫ│я╕П	р░Чр▒Лр░▓р▒Нр░лр▒Н р░Ьр▒Жр░Вр░бр░╛, р░Ьр▒Жр░Вр░бр░╛
тЫ┤я╕П	р░Хр░Яр▒Нр░Яр▒Б, р░мр░▓р▒Нр░▓, р░мр░▓р▒Нр░▓ р░Хр░Яр▒Нр░Яр▒Б
тЫ╡я╕П	р░кр░бр░╡, р░кр▒Жр░жр▒Нр░ж р░кр░бр░╡, р░░р░┐р░╕р░╛р░░р▒Нр░Яр▒Н, р░╡р░╛р░╣р░ир░В, р░╕р░ор▒Бр░жр▒Нр░░р░В
тЫ╖я╕П	р░ор░Вр░Ър▒Б, р░╕р▒Нр░Хр▒Ар░пр░░р▒Н, р░╕р▒Нр░Хр▒Ар░пр░┐р░Вр░Чр▒Н, р░╕р▒Нр░Хр▒Ар░пр░┐р░Вр░Чр▒Н р░Ър▒Зр░╕р▒З р░╡р▒Нр░пр░Хр▒Нр░др░┐
тЫ╕я╕П	р░Рр░╕р▒Н, р░Рр░╕р▒Н р░╕р▒Нр░Хр▒Зр░Яр▒Н, р░╕р▒Нр░Хр▒Зр░Яр░┐р░Вр░Чр▒Н
тЫ╣я╕П	р░Жр░Я, р░мр░Вр░др░┐р░др▒Л р░Жр░бр▒Бр░др▒Бр░ир▒Нр░и р░╡р▒Нр░пр░Хр▒Нр░др░┐, р░мр░╛р░▓р▒Н, р░╡р▒Нр░пр░Хр▒Нр░др░┐
тЫ║я╕П	р░Жр░╢р▒Нр░░р░пр░В, р░Чр▒Бр░бр░╛р░░р░В
тЫ╜я╕П	р░кр▒Жр░Яр▒Нр░░р▒Лр░▓р▒Н, р░кр▒Жр░Яр▒Нр░░р▒Лр░▓р▒Н р░мр░Вр░Хр▒Н, р░мр░Вр░Хр▒Н
тЬВя╕П	р░Хр░др▒Нр░др▒Жр░░, р░╕р░╛р░зр░ир░В
тЬИя╕П	р░╡р░┐р░ор░╛р░ир░В
тЬЙя╕П	р░Зр░ор▒Жр░пр░┐р░▓р▒Н, р░Йр░др▒Нр░др░░р░В, р░Ор░ир▒Нр░╡р░▓р░кр▒Н
тЬМя╕П	р░╡р░┐р░Ьр░п р░╕р░Вр░Хр▒Зр░др░В, р░╡р░┐р░Ьр░пр░В, р░╕р░Вр░Хр▒Зр░др░В
тЬНя╕П	р░Ър▒Зр░пр░┐, р░╡р▒Нр░░р░╛р░пр░бр░В, р░╡р▒Нр░░р░╛р░╕р▒Нр░др▒Бр░ир▒Нр░и р░Ър▒Зр░пр░┐
тЬПя╕П	р░Чр▒Ар░пр░бр░В, р░кр▒Жр░ир▒Нр░╕р░┐р░▓р▒Н, р░╡р▒Нр░░р░╛р░пр░бр░В
тЬТя╕П	р░Хр░▓р░В, р░ир░▓р▒Бр░кр▒Б р░░р░Вр░Чр▒Б р░кр▒Жр░ир▒Нр░ир▒Б, р░кр░╛р░│р▒А
тЬФя╕П	р░Ор░Вр░кр░┐р░Х, р░Чр▒Бр░░р▒Нр░др▒Б, р░др░ир░┐р░Цр▒А, р░нр░╛р░░р▒А р░др░ир░┐р░Цр▒А р░Чр▒Бр░░р▒Нр░др▒Б
тЬЦя╕П	р░Чр▒Бр░гр░Хр░╛р░░р░В, р░нр░╛р░░р▒А р░Чр▒Бр░гр░Хр░╛р░░р░В x, р░░р░жр▒Нр░жр▒Б
тЬЭя╕П	р░Хр▒Нр░░р░╛р░╕р▒Н, р░Хр▒Нр░░р▒Ир░╕р▒Нр░др░╡р▒Бр░бр▒Б, р░ор░др░В, р░▓р░╛р░Яр░┐р░ир▒Н р░Хр▒Нр░░р░╛р░╕р▒Н
тЬбя╕П	р░бр▒Зр░╡р░┐р░бр▒Н, р░бр▒Зр░╡р░┐р░бр▒Н р░╕р▒Нр░Яр░╛р░░р▒Н, р░ор░др░В, р░пр▒Вр░жр▒Бр░бр▒Б
тЬ│я╕П	р░Ор░ир░┐р░ор░┐р░жр░┐, р░Ор░ир░┐р░ор░┐р░жр░┐ р░ор▒Кр░ир░▓р▒Б р░Чр░▓ р░пр░╛р░╕р▒Нр░Яр▒Жр░░р░┐р░╕р▒Нр░Хр▒Н, р░пр░╛р░╕р▒Нр░Яр▒Жр░░р░┐р░╕р▒Нр░Хр▒Н
тЬ┤я╕П	р░Ор░ир░┐р░ор░┐р░жр░┐, р░Ор░ир░┐р░ор░┐р░жр░┐ р░Хр▒Лр░гр░╛р░▓ р░ир░Хр▒Нр░╖р░др▒Нр░░р░В, р░др░╛р░░, р░ир░Хр▒Нр░╖р░др▒Нр░░р░В
тЭДя╕П	р░кр▒Кр░░, р░ор░Вр░Ър▒Б, р░ор░Вр░Ър▒Бр░др▒Л р░Ър▒Зр░пр░мр░бр░┐р░и р░кр▒Кр░░
тЭЗя╕П	р░Хр░╛р░Вр░др░┐, р░ор▒Жр░░р▒Бр░кр▒Б
тЭУя╕П	р░Чр▒Бр░░р▒Нр░др▒Б, р░кр▒Нр░░р░╢р▒Нр░и, р░кр▒Нр░░р░╢р▒Нр░и р░Чр▒Бр░░р▒Нр░др▒Б, р░╡р░┐р░░р░╛р░о р░Ър░┐р░╣р▒Нр░ир░В
тЭЧя╕П	р░Жр░╢р▒Нр░Ър░░р▒Нр░пр░╛р░░р▒Нр░ер░Хр░В, р░Жр░╢р▒Нр░Ър░░р▒Нр░пр░╛р░░р▒Нр░ер░Хр░В р░Чр▒Бр░░р▒Нр░др▒Б, р░Чр▒Бр░░р▒Нр░др▒Б
тЭгя╕П	р░Жр░╢р▒Нр░Ър░░р▒Нр░пр░В, р░Жр░╢р▒Нр░Ър░░р▒Нр░пр░╛р░░р▒Нр░ер░Хр░В р░Чр▒Бр░░р▒Нр░др▒Бр░др▒Л р░Йр░ир▒Нр░и р░нр░╛р░░р░ор▒Ир░и р░ир░Ч, р░ир░Ч, р░╣р▒Гр░жр░пр░В
тЭдя╕П	р░Ор░░р▒Бр░кр▒Б, р░Ор░░р▒Бр░кр▒Б р░░р░Вр░Чр▒Б р░╣р▒Гр░жр░пр░В, р░╣р▒Гр░жр░пр░В
тЮбя╕П	р░Хр▒Бр░бр░┐ р░мр░╛р░гр░В, р░др▒Вр░░р▒Нр░кр▒Б, р░жр░┐р░╢, р░мр░╛р░гр░В
тд┤я╕П	р░Хр▒Бр░бр░┐, р░кр▒Ир░Хр░┐, р░кр▒Ир░Хр░┐ р░╡р░Вр░кр▒Б р░др░┐р░░р░┐р░Чр░┐р░и р░Хр▒Бр░бр░┐ р░мр░╛р░гр░В, р░мр░╛р░гр░В
тд╡я╕П	р░Хр▒Нр░░р░┐р░Вр░жр░┐р░Хр░┐, р░Хр▒Нр░░р░┐р░Вр░жр░┐р░Хр░┐ р░╡р░Вр░кр▒Б р░др░┐р░░р░┐р░Чр░┐р░и р░Хр▒Бр░бр░┐ р░мр░╛р░гр░В, р░мр░╛р░гр░В
тмЕя╕П	р░Ор░бр░о р░мр░╛р░гр░В, р░жр░┐р░╢, р░кр░╢р▒Нр░Ър░┐р░ор░В, р░мр░╛р░гр░В
тмЖя╕П	р░Йр░др▒Нр░др░░р░В, р░Ор░Чр▒Бр░╡ р░мр░╛р░гр░В, р░жр░┐р░╢, р░мр░╛р░гр░В
тмЗя╕П	р░жр░Хр▒Нр░╖р░┐р░гр░В, р░жр░┐р░Чр▒Бр░╡ р░мр░╛р░гр░В, р░жр░┐р░╢, р░мр░╛р░гр░В
тмЫя╕П	р░Ър░др▒Бр░░р░╕р▒Нр░░р░В, р░ир░▓р▒Бр░кр▒Б р░░р░Вр░Чр▒Б, р░кр▒Жр░жр▒Нр░ж р░ир░▓р▒Бр░кр▒Б р░░р░Вр░Чр▒Б р░Ър░др▒Бр░░р░╕р▒Нр░░р░В
тмЬя╕П	р░Ър░др▒Бр░░р░╕р▒Нр░░р░В, р░др▒Жр░▓р▒Бр░кр▒Б р░░р░Вр░Чр▒Б, р░кр▒Жр░жр▒Нр░ж р░др▒Жр░▓р▒Бр░кр▒Б р░░р░Вр░Чр▒Б р░Ър░др▒Бр░░р░╕р▒Нр░░р░В
тнРя╕П	р░др▒Жр░▓р▒Нр░▓р░ир░┐, р░др▒Жр░▓р▒Нр░▓р░ир░┐ р░ир░Хр▒Нр░╖р░др▒Нр░░р░В, р░ир░Хр▒Нр░╖р░др▒Нр░░р░В
тнХя╕П	р░Ер░др▒Нр░пр░Вр░д р░нр░╛р░░р▒А р░╡р▒Гр░др▒Нр░др░В, р░╡р▒Гр░др▒Нр░др░В, р░╕р░░р▒Нр░Хр░┐р░▓р▒Н
уА░я╕П	р░Чр▒Бр░░р▒Нр░др▒Б, р░др░░р░Вр░Чр░В, р░др░░р░Вр░Чр░╛р░▓ р░Чр▒Бр░░р▒Нр░др▒Б
уА╜я╕П	р░Чр▒Бр░░р▒Нр░др▒Б, р░кр░╛р░Хр▒Нр░╖р░┐р░Х р░╕р░╡р░░р░г р░Чр▒Бр░░р▒Нр░др▒Б, р░кр░╛р░Хр▒Нр░╖р░┐р░Хр░В, р░нр░╛р░Чр░В
уКЧя╕П	р░Рр░бр░┐р░пр▒Лр░Чр▒Нр░░р░╛р░лр▒Н, р░Ьр░кр░ир▒Ар░╕р▒Н, р░Ьр░кр░ир▒Ар░╕р▒НтАМр░▓р▒Л "р░Ер░нр░┐р░ир░Вр░жр░ир░▓р▒Б" р░╕р▒Вр░Ър░┐р░Вр░Ър▒З р░мр░Яр░ир▒Н, тАЬр░Ер░нр░┐р░ир░Вр░жр░ир░▓р▒БтАЭ, чеЭ
уКЩя╕П	р░Рр░бр░┐р░пр▒Лр░Чр▒Нр░░р░╛р░лр▒Н, р░Ьр░кр░ир▒Ар░╕р▒Н, р░Ьр░кр░ир▒Ар░╕р▒НтАМр░▓р▒Л "р░░р░╣р░╕р▒Нр░пр░В" р░╕р▒Вр░Ър░┐р░Вр░Ър▒З р░мр░Яр░ир▒Н, тАЬр░░р░╣р░╕р▒Нр░пр░ВтАЭ, чзШ
ЁЯАДя╕П	р░Ор░░р▒Бр░кр▒Б р░бр▒Нр░░р░╛р░Чр░ир▒Н, р░бр▒Нр░░р░╛р░Чр░ир▒Н, р░кр▒Зр░Хр░ор▒Бр░Хр▒Нр░Хр░кр▒И р░Ор░░р▒Бр░кр▒Бр░░р░Вр░Чр▒Б р░бр▒Нр░░р░╛р░Чр░ир▒Н р░мр▒Кр░ор▒Нр░о, р░ор░╛р░╣р▒НтАМр░Ьр░╛р░Вр░Чр▒Н р░Жр░Яр░▓р▒Л р░Ор░░р▒Бр░кр▒Бр░░р░Вр░Чр▒Б р░бр▒Нр░░р░╛р░Чр░ир▒Н
ЁЯЕ░я╕П	р░Ер░Хр▒Нр░╖р░░р░В, р░О, р░О р░мр░Яр░ир▒Н (р░░р░Хр▒Нр░др░В р░░р░Хр░В)
ЁЯЕ▒я╕П	р░Ер░Хр▒Нр░╖р░░р░В, р░мр░┐, р░мр░┐ р░мр░Яр░ир▒Н (р░░р░Хр▒Нр░др░В р░░р░Хр░В)
ЁЯЕ╛я╕П	р░У, р░У р░мр░Яр░ир▒Н (р░░р░Хр▒Нр░др░В р░░р░Хр░В), р░У р░мр▒Нр░▓р░бр▒Н р░Чр▒Нр░░р▒Вр░кр▒Н, р░У р░░р░Хр░В, р░░р░Хр▒Нр░д р░╡р░░р▒Нр░Чр░В р░У
ЁЯЕ┐я╕П	р░кр░╛р░░р▒Нр░Хр░┐р░Вр░Чр▒Н р░╕р▒Нр░ер░▓р░В, р░кр░╛р░░р▒Нр░Хр▒Н р░Ър▒Зр░пр░бр░В, р░кр░┐ р░Ер░Хр▒Нр░╖р░░р░В, р░╡р░╛р░╣р░ир░╛р░▓р▒Б р░Жр░кр▒З р░╕р▒Нр░ер░▓р░В
ЁЯИВя╕П	р░Хр░Яр░Хр░╛р░ир░╛ р░╕р░╛, р░Ьр░кр░ир▒Ар░╕р▒Н р░кр░жр░В, р░Ьр░кр░ир▒Ар░╕р▒НтАМр░▓р▒Л "р░╕р▒Зр░╡р░╛ р░Ыр░╛р░░р▒Нр░Ьр▒А" р░╕р▒Вр░Ър░┐р░Вр░Ър▒З р░мр░Яр░ир▒Н
ЁЯМОя╕П	р░Ер░ор▒Жр░░р░┐р░Хр░╛, р░Ер░ор▒Жр░░р░┐р░Хр░╛р░ир▒Б р░Ър▒Вр░кр▒З р░Чр▒Нр░▓р▒Лр░мр▒Н, р░Ер░ор▒Жр░░р░┐р░Хр░╛р░╕р▒Н, р░нр▒Вр░Чр▒Лр░│р░В, р░нр▒Вр░ор░┐
ЁЯМХя╕П	р░Ър░Вр░жр▒Нр░░р▒Бр░бр▒Б, р░кр▒Вр░░р▒Нр░г р░Ър░Вр░жр▒Нр░░р▒Бр░бр▒Б, р░кр▒Мр░░р▒Нр░гр░ор░┐
ЁЯМЬя╕П	р░Ър░Вр░жр▒Нр░░р▒Бр░бр▒Б, р░Ър░┐р░╡р░░р░┐ р░ир░╛р░▓р▒Бр░Чр░╡ р░╡р░Вр░др▒Б р░Ър░Вр░жр▒Нр░░р▒Бр░ир░┐ р░ор▒Бр░Цр░В, р░ир░╛р░▓р▒Бр░Чр░╡, р░ор▒Бр░Цр░В
ЁЯМбя╕П	р░ер░░р▒Нр░ор░╛р░ор▒Ар░Яр░░р▒Н, р░╡р░╛р░др░╛р░╡р░░р░гр░В
ЁЯМдя╕П	р░Ър░┐р░ир▒Нр░и р░ор▒Зр░Шр░В, р░Ър░┐р░ир▒Нр░и р░ор▒Зр░Шр░В р░╡р▒Жр░ир▒Бр░Х р░Йр░ир▒Нр░и р░╕р▒Вр░░р▒Нр░пр▒Бр░бр▒Б, р░╕р▒Вр░░р▒Нр░пр▒Бр░бр▒Б
ЁЯМея╕П	р░кр▒Жр░жр▒Нр░ж р░ор▒Зр░Шр░В, р░кр▒Жр░жр▒Нр░ж р░ор▒Зр░Шр░В р░╡р▒Жр░ир▒Бр░Х р░Йр░ир▒Нр░и р░╕р▒Вр░░р▒Нр░пр▒Бр░бр▒Б, р░╕р▒Вр░░р▒Нр░пр▒Бр░бр▒Б
ЁЯМжя╕П	р░ор▒Зр░Шр░В, р░╡р░╛р░и, р░╡р░╛р░ир░▓р▒Л р░ор▒Зр░Шр░В р░╡р▒Жр░ир▒Бр░Х р░Йр░ир▒Нр░и р░╕р▒Вр░░р▒Нр░пр▒Бр░бр▒Б, р░╕р▒Вр░░р▒Нр░пр▒Бр░бр▒Б
ЁЯМзя╕П	р░ор▒Зр░Шр░В, р░╡р░╛р░и, р░╡р░╛р░и р░Хр▒Бр░░р▒Бр░╕р▒Нр░др▒Бр░ир▒Нр░и р░ор▒Зр░Шр░В
ЁЯМия╕П	р░ор░Вр░Ър▒Б, р░ор░Вр░Ър▒Бр░др▒Л р░Йр░ир▒Нр░и р░ор▒Зр░Шр░В, р░ор▒Зр░Шр░В
ЁЯМйя╕П	р░ор▒Жр░░р▒Бр░кр▒Б, р░ор▒Жр░░р▒Бр░╕р▒Нр░др▒Бр░ир▒Нр░и р░ор▒Зр░Шр░В, р░ор▒Зр░Шр░В
ЁЯМкя╕П	р░Чр░╛р░▓р░┐, р░╕р▒Бр░бр░┐, р░╕р▒Бр░бр░┐р░Чр░╛р░▓р░┐
ЁЯМля╕П	р░кр▒Кр░Ч, р░кр▒Кр░Чр░ор░Вр░Ър▒Б, р░ор░Вр░Ър▒Б
ЁЯМмя╕П	р░Чр░╛р░▓р░┐, р░Чр░╛р░▓р░┐ р░ор▒Бр░Цр░В, р░ор▒Бр░Цр░В
ЁЯМ╢я╕П	р░Шр░╛р░Яр▒Б, р░Шр░╛р░Яр▒Б р░ор░┐р░░р▒Нр░Ър░┐, р░ор░┐р░░р░к, р░ор▒Кр░Хр▒Нр░Х
ЁЯН╕я╕П	р░Хр░╛р░Хр▒НтАМр░Яр▒Жр░пр░┐р░▓р▒Н, р░Хр░╛р░Хр▒НтАМр░Яр▒Жр░пр░┐р░▓р▒Н р░Чр▒Нр░▓р░╛р░╕р▒Б, р░Хр░╛р░Хр▒НтАМр░Яр▒Жр░пр░┐р░▓р▒Н р░Чр▒Нр░▓р░╛р░╕р▒Н, р░мр░╛р░░р▒Н, р░░р▒Жр░╕р▒Нр░Яр░╛р░░р▒Жр░Вр░Яр▒Н
ЁЯН╜я╕П	р░Хр░др▒Нр░др░┐, р░кр░│р▒Нр░▓р▒Жр░В, р░кр░│р▒Нр░▓р▒Жр░Вр░др▒Л р░лр▒Лр░░р▒Нр░Хр▒Н р░ор░░р░┐р░пр▒Б р░Хр░др▒Нр░др░┐, р░лр▒Лр░░р▒Нр░Хр▒Н, р░╡р░Вр░Я
ЁЯОУя╕П	р░Яр▒Лр░кр▒А, р░кр░Яр▒Нр░Яр░нр░жр▒Нр░░р▒Бр░▓ р░Яр▒Лр░кр▒А, р░кр░Яр▒Нр░Яр░нр░жр▒Нр░░р▒Бр░▓р▒Б
ЁЯОЦя╕П	р░ор░┐р░▓р░┐р░Яр░░р▒А, р░ор░┐р░▓р░┐р░Яр░░р▒А р░ор▒Жр░бр░▓р▒Н, р░ор▒Жр░бр░▓р▒Н, р░╕р▒Ир░ир▒Нр░пр░В
ЁЯОЧя╕П	р░░р░┐р░мр▒Нр░мр░ир▒Н, р░░р░┐р░ор▒Ир░Вр░бр░░р▒Н, р░░р░┐р░ор▒Ир░Вр░бр░░р▒Н р░░р░┐р░мр▒Нр░мр░ир▒Н, р░╡р▒Зр░бр▒Бр░Х
ЁЯОЩя╕П	р░ор▒Ир░Хр▒Нр░░р▒Лр░лр▒Лр░ир▒Н, р░╕р░Вр░Чр▒Ар░др░В, р░╕р▒Нр░Яр▒Вр░бр░┐р░пр▒Л, р░╕р▒Нр░Яр▒Вр░бр░┐р░пр▒Л р░ор▒Ир░Хр▒Нр░░р▒Лр░лр▒Лр░ир▒Н
ЁЯОЪя╕П	р░▓р▒Жр░╡р░▓р▒Н, р░▓р▒Жр░╡р░▓р▒Н р░╕р▒Нр░▓р░пр░┐р░бр░░р▒Н, р░╕р░Вр░Чр▒Ар░др░В, р░╕р▒Нр░▓р░пр░┐р░бр░░р▒Н
ЁЯОЫя╕П	р░Хр░Вр░Яр▒Нр░░р▒Лр░▓р▒Н, р░ир░╛р░мр▒НтАМр░▓р▒Б, р░ир░┐р░пр░Вр░др▒Нр░░р░г, р░ир░┐р░пр░Вр░др▒Нр░░р░г р░ир░╛р░мр▒НтАМр░▓р▒Б
ЁЯОЮя╕П	р░лр░┐р░▓р▒Нр░ор▒Н, р░ор▒Вр░╡р▒А, р░░р▒Ар░▓р▒Б, р░╕р░┐р░ир░┐р░ор░╛, р░╕р░┐р░ир░┐р░ор░╛ р░░р▒Ар░▓р▒Б
ЁЯОЯя╕П	р░Яр░┐р░Хр▒Нр░Хр▒Жр░Яр▒Н, р░кр▒Нр░░р░╡р▒Зр░╢ р░Яр░┐р░Хр▒Нр░Хр▒Жр░Яр▒НтАМр░▓р▒Б, р░кр▒Нр░░р░╡р▒Зр░╢р░В
ЁЯОзя╕П	р░Зр░пр░░р▒НтАМр░лр▒Лр░ир▒Н, р░кр░╛р░Яр░▓р▒Б р░╡р░┐р░ир░бр░В, р░╡р░┐р░ир▒Лр░жр░В, р░╕р░Вр░Чр▒Ар░др░В, р░╣р▒Жр░бр▒НтАМр░лр▒Лр░ир▒Н
ЁЯОмя╕П	р░Хр▒Нр░▓р░╛р░кр▒Н р░Хр▒Кр░Яр▒Нр░Яр░бр░В, р░Хр▒Нр░▓р░╛р░кр▒Н р░мр▒Лр░░р▒Нр░бр▒Н, р░╡р░┐р░ир▒Лр░жр░В, р░╕р░ир▒Нр░ир░┐р░╡р▒Зр░╢р░В, р░╕р░┐р░ир░┐р░ор░╛
ЁЯОня╕П	р░др▒Кр░бр▒Бр░Чр▒Б, р░ор▒Бр░Цр░В, р░ор▒Бр░Цр░╛р░ир░┐р░Хр░┐ р░╡р▒Зр░╕р▒Бр░Хр▒Бр░ир▒З р░др▒Кр░бр▒Бр░Чр▒Бр░▓р▒Б
ЁЯОоя╕П	р░Хр░Вр░Яр▒Нр░░р▒Лр░▓р░░р▒Н, р░Чр▒Зр░ор▒Н, р░░р░┐р░ор▒Лр░Яр▒Н, р░╡р▒Ар░бр░┐р░пр▒Л р░Чр▒Зр░ор▒Н
ЁЯПВя╕П	р░Хр▒Нр░░р▒Ар░б, р░╕р▒Нр░ир▒Лр░мр▒Лр░░р▒Нр░бр░░р▒Н, р░╕р▒Нр░ир▒Лр░мр▒Лр░░р▒Нр░бр░┐р░Вр░Чр▒Н, р░╕р▒Нр░ир▒Лр░мр▒Лр░░р▒Нр░бр▒Н
ЁЯПДя╕П	р░Хр▒Нр░░р▒Ар░б, р░╕р░░р▒Нр░лр░┐р░Вр░Чр▒Н, р░╕р░░р▒Нр░лр▒Н р░Ър▒Зр░╕р▒Нр░др▒Бр░ир▒Нр░и р░╡р▒Нр░пр░Хр▒Нр░др░┐
ЁЯПЖя╕П	р░Яр▒Нр░░р▒Лр░лр▒А, р░мр░╣р▒Бр░ор░др░┐
ЁЯПКя╕П	р░Ир░д, р░Ир░др░Чр░╛р░бр▒Б, р░Хр▒Нр░░р▒Ар░б
ЁЯПЛя╕П	р░Ор░др▒Нр░др░бр░В, р░мр░░р▒Бр░╡р▒Б, р░╡р▒Жр░пр░┐р░Яр▒Н р░▓р░┐р░лр▒Нр░Яр░░р▒Н
ЁЯПМя╕П	р░Жр░Яр░Чр░╛р░бр▒Б, р░Чр▒Лр░▓р▒Нр░лр▒Н, р░Чр▒Лр░▓р▒Нр░лр▒Н р░Жр░Яр░Чр░╛р░бр▒Б, р░мр░╛р░▓р▒Н
ЁЯПНя╕П	р░ор▒Лр░Яр░░р▒НтАМр░╕р▒Ир░Хр░┐р░▓р▒Н, р░ор▒Лр░Яр░╛р░░р▒Б, р░░р▒Зр░╕р▒Бр░▓р▒Б, р░╡р░╛р░╣р░ир░В
ЁЯПОя╕П	р░Хр░╛р░░р▒Н, р░кр░Вр░жр▒Зр░▓р▒Б, р░░р▒Зр░╕р░┐р░Вр░Чр▒Н, р░░р▒Зр░╕р░┐р░Вр░Чр▒Н р░Хр░╛р░░р▒Н
ЁЯПФя╕П	р░Ър░▓р░┐, р░кр░░р▒Нр░╡р░др░В, р░ор░Вр░Ър▒Б, р░ор░Вр░Ър▒Бр░др▒Л р░Хр░кр▒Нр░кр░мр░бр░┐р░и р░кр░░р▒Нр░╡р░др░В
ЁЯПХя╕П	р░╢р░┐р░мр░┐р░░р░В
ЁЯПЦя╕П	р░Чр▒Кр░бр▒Бр░Чр▒Б, р░Чр▒Кр░бр▒Бр░Чр▒Б р░Йр░ир▒Нр░и р░╕р░ор▒Бр░жр▒Нр░░ р░др▒Ар░░р░В, р░╕р░ор▒Бр░жр▒Нр░░р░др▒Ар░░р░В
ЁЯПЧя╕П	р░ир░┐р░░р▒Нр░ор░╛р░гр░В, р░нр░╡р░и р░ир░┐р░░р▒Нр░ор░╛р░гр░В, р░нр░╡р░ир░В
ЁЯПШя╕П	р░Зр░Вр░Яр░┐ р░нр░╡р░ир░╛р░▓р▒Б, р░Зр░▓р▒Нр░▓р▒Б, р░нр░╡р░ир░В
ЁЯПЩя╕П	р░ир░Чр░░ р░жр▒Гр░╢р▒Нр░пр░В, р░ир░Чр░░р░В, р░нр░╡р░ир░В
ЁЯПЪя╕П	р░Зр░▓р▒Нр░▓р▒Б, р░ир░┐р░╡р░╕р░┐р░Вр░Ър░ир░┐, р░ир░┐р░╡р░╕р░┐р░Вр░Ър░ир░┐ р░нр░╡р░ир░В, р░нр░╡р░ир░В
ЁЯПЫя╕П	р░нр░╡р░ир░В, р░╕р░╛р░Вр░кр▒Нр░░р░жр░╛р░пр░Х р░нр░╡р░ир░В, р░╕р░╛р░Вр░кр▒Нр░░р░жр░╛р░пр░Хр░В
ЁЯПЬя╕П	р░Ор░бр░╛р░░р░┐
ЁЯПЭя╕П	р░Ор░бр░╛р░░р░┐, р░Ор░бр░╛р░░р░┐ р░жр▒Нр░╡р▒Ар░кр░В, р░жр▒Нр░╡р▒Ар░кр░В
ЁЯПЮя╕П	р░Ьр░╛р░др▒Ар░п р░кр░╛р░░р▒Нр░Хр▒Н, р░кр░╛р░░р▒Нр░Хр▒Н
ЁЯПЯя╕П	р░╕р▒Нр░Яр▒Зр░бр░┐р░пр░В
ЁЯПая╕П	р░Зр░Вр░Яр░┐ р░нр░╡р░ир░В, р░Зр░▓р▒Нр░▓р▒Б, р░нр░╡р░ир░В
ЁЯПня╕П	р░Хр░░р▒Нр░ор░╛р░Чр░╛р░░р░В, р░лр▒Нр░пр░╛р░Хр▒Нр░Яр░░р▒А, р░нр░╡р░ир░В
ЁЯП│я╕П	р░Ор░Чр░░р░бр░В, р░Ор░Чр▒Бр░░р▒Бр░др▒Бр░ир▒Нр░и р░др▒Жр░▓р▒Бр░кр▒Б р░Ьр▒Жр░Вр░бр░╛, р░Ьр▒Жр░Вр░бр░╛, р░др▒Жр░▓р▒Бр░кр▒Б
ЁЯП╡я╕П	р░Чр▒Бр░▓р░╛р░мр░┐ р░кр▒Бр░╡р▒Нр░╡р▒Б, р░░р░┐р░мр▒Нр░мр░ир▒Н, р░░р░┐р░мр▒Нр░мр░ир▒НтАМр░др▒Л р░др░пр░╛р░░р▒Б р░Ър▒Зр░╕р░┐р░и р░Чр▒Бр░▓р░╛р░мр░┐ р░кр▒Бр░╡р▒Нр░╡р▒Б
ЁЯП╖я╕П	р░Ър▒Ар░Яр▒А, р░▓р▒Зр░мр▒Бр░▓р▒Н
ЁЯРИя╕П	р░Ьр░Вр░др▒Бр░╡р▒Б, р░кр░┐р░▓р▒Нр░▓р░┐
ЁЯРХя╕П	р░Хр▒Бр░Хр▒Нр░Х, р░Хр▒Бр░Хр▒Нр░Х р░кр░┐р░▓р▒Нр░▓, р░Ьр░Вр░др▒Бр░╡р▒Б
ЁЯРЯя╕П	р░Ър▒Зр░к, р░Ьр░Вр░др▒Бр░╡р▒Б
ЁЯРжя╕П	р░Ьр░Вр░др▒Бр░╡р▒Б, р░кр░Хр▒Нр░╖р░┐
ЁЯР┐я╕П	р░Йр░бр▒Бр░д, р░Ър░┐р░кр▒НтАМр░ор░Вр░Хр▒Н
ЁЯСБя╕П	р░Хр░ир▒Нр░ир▒Б, р░╢р░░р▒Ар░░р░В
ЁЯСВя╕П	р░Ър▒Жр░╡р░┐, р░╢р░░р▒Ар░░р░В
ЁЯСЖя╕П	р░Ър▒Вр░кр▒Бр░Я, р░Ър▒Вр░кр▒Бр░бр▒Б р░╡р▒Зр░▓р▒Б р░кр▒Ир░Хр▒Жр░др▒Нр░др░Яр░В, р░╡р▒Зр░▓р▒Б
ЁЯСЗя╕П	р░Ър▒Вр░кр▒Бр░Я, р░Ър▒Вр░кр▒Бр░бр▒Б р░╡р▒Зр░▓р▒Б р░Хр░┐р░Вр░жр░┐р░Хр░┐ р░Ър▒Вр░кр▒Бр░Я, р░╡р▒Зр░▓р▒Б
ЁЯСИя╕П	р░Ор░бр░о, р░Ор░бр░о р░Ър▒Вр░кр▒Бр░бр▒Б р░╡р▒Зр░▓р▒Б, р░╡р▒Зр░▓р▒Б
ЁЯСЙя╕П	р░Хр▒Бр░бр░┐, р░Хр▒Бр░бр░┐ р░Ър▒Вр░кр▒Бр░бр▒Б р░╡р▒Зр░▓р▒Б, р░╡р▒Зр░▓р▒Б
ЁЯСНя╕П	р░Чр▒Бр░░р▒Нр░др▒Б, р░мр▒Кр░Яр░ир░┐ р░╡р▒Зр░▓р▒Б р░кр▒Ир░Хр░┐ р░Ър▒Вр░кр▒З р░Чр▒Бр░░р▒Нр░др▒Б, р░╡р▒Зр░▓р▒Б
ЁЯСОя╕П	р░Чр▒Бр░░р▒Нр░др▒Б, р░мр▒Кр░Яр░ир░┐ р░╡р▒Зр░▓р▒Б р░Хр░┐р░Вр░жр░┐р░Хр░┐ р░Ър▒Вр░кр▒З р░Чр▒Бр░░р▒Нр░др▒Б, р░╡р▒Зр░▓р▒Б
ЁЯСУя╕П	р░Хр░ир▒Нр░ир▒Б, р░Хр░│р▒Нр░▓р░Ьр▒Лр░│р▒Нр░▓р▒Б, р░Хр░│р▒Нр░▓р░жр▒Нр░жр░╛р░▓р▒Б, р░жр▒Бр░╕р▒Нр░др▒Бр░▓р▒Б
ЁЯСкя╕П	р░Хр▒Бр░Яр▒Бр░Вр░м р░╕р░нр▒Нр░пр▒Бр░▓р▒Б, р░Хр▒Бр░Яр▒Бр░Вр░мр░В
ЁЯС╜я╕П	р░Чр▒Нр░░р░╣р░╛р░Вр░др░░ р░╡р░╛р░╕р░┐, р░Чр▒Нр░░р░╣р░╛р░Вр░др░░р░╡р░╛р░╕р░┐
ЁЯТгя╕П	р░мр░╛р░Вр░мр▒Н, р░╡р░┐р░зр▒Нр░╡р░Вр░╕р░В
ЁЯТ░я╕П	р░бр░мр▒Нр░мр▒Б р░╕р░Вр░Ър░┐, р░зр░ир░В, р░╕р░Вр░Ър░┐
ЁЯТ│я╕П	р░Хр░╛р░░р▒Нр░бр▒Н, р░Хр▒Нр░░р▒Жр░бр░┐р░Яр▒Н, р░Хр▒Нр░░р▒Жр░бр░┐р░Яр▒Н р░Хр░╛р░░р▒Нр░бр▒Н, р░▓р░╛р░╡р░╛р░жр▒Зр░╡р▒А
ЁЯТ╗я╕П	р░▓р▒Нр░пр░╛р░кр▒НтАМр░Яр░╛р░кр▒Н р░Хр░Вр░кр▒Нр░пр▒Вр░Яр░░р▒Н, р░╡р▒Нр░пр░Хр▒Нр░др░┐р░Чр░д р░Хр░Вр░кр▒Нр░пр▒Вр░Яр░░р▒Н
ЁЯТ┐я╕П	р░Жр░кр▒Нр░Яр░┐р░Хр░▓р▒Н р░бр░┐р░╕р▒Нр░Хр▒Н, р░╕р░┐р░бр░┐
ЁЯУЛя╕П	р░Хр▒Нр░▓р░┐р░кр▒НтАМр░мр▒Лр░░р▒Нр░бр▒Н, р░мр▒Лр░░р▒Нр░бр▒Н
ЁЯУЪя╕П	р░Ър░жр▒Бр░╡р▒Б, р░кр▒Бр░╕р▒Нр░др░Хр░╛р░▓р▒Б
ЁЯУЯя╕П	р░кр▒Зр░Ьр░░р▒Н
ЁЯУдя╕П	р░Ер░╡р▒Бр░Яр▒НтАМр░мр░╛р░Хр▒Нр░╕р▒Н, р░Ер░╡р▒Бр░Яр▒НтАМр░мр░╛р░Хр▒Нр░╕р▒Н р░Яр▒Нр░░р▒З, р░Йр░др▒Нр░др░░р░В, р░Яр▒Нр░░р▒З, р░ор▒Жр░пр░┐р░▓р▒Н
ЁЯУея╕П	р░Зр░ир▒НтАМр░мр░╛р░Хр▒Нр░╕р▒Н, р░Зр░ир▒НтАМр░мр░╛р░Хр▒Нр░╕р▒Н р░Яр▒Нр░░р▒З, р░Йр░др▒Нр░др░░р░В, р░Яр▒Нр░░р▒З, р░ор▒Жр░пр░┐р░▓р▒Н
ЁЯУжя╕П	р░кр░╛р░░р▒Нр░╢р░┐р░▓р▒Н, р░кр▒Нр░пр░╛р░Хр▒Зр░Ьр▒А, р░мр░╛р░Хр▒Нр░╕р▒Н
ЁЯУкя╕П	р░лр▒Нр░▓р░╛р░Чр▒Н р░Хр▒Нр░░р░┐р░Вр░жр░┐р░Хр░┐ р░Йр░Вр░бр░┐, р░ор▒Вр░╕р░┐р░╡р▒Зр░╕р░┐р░и р░ор▒Жр░пр░┐р░▓р▒Н р░мр░╛р░Хр▒Нр░╕р▒Н, р░ор▒Жр░пр░┐р░▓р▒Н р░мр░╛р░Хр▒Нр░╕р▒Н р░Цр░╛р░│р▒Ар░Чр░╛ р░Йр░Вр░жр░┐, р░ор▒Жр░пр░┐р░▓р▒НтАМр░▓р▒Б р░Пр░╡р▒А р░░р░╛р░▓р▒Зр░жр▒Б
ЁЯУля╕П	р░лр▒Нр░▓р░╛р░Чр▒Н р░кр▒Ир░Хр░┐ р░Йр░Вр░бр░┐, р░ор▒Вр░╕р░┐р░╡р▒Зр░╕р░┐р░и р░ор▒Жр░пр░┐р░▓р▒Н р░мр░╛р░Хр▒Нр░╕р▒Н, р░ор▒Жр░пр░┐р░▓р▒Н р░мр░╛р░Хр▒Нр░╕р▒НтАМр░▓р▒Л р░ор▒Жр░пр░┐р░▓р▒НтАМр░▓р▒Б р░Йр░ир▒Нр░ир░╛р░пр░┐, р░ор▒Жр░пр░┐р░▓р▒Н р░╡р░Ър▒Нр░Ър░┐р░Вр░жр░┐
ЁЯУмя╕П	р░др▒Жр░░р░┐р░Ър░┐ р░Йр░Вр░жр░┐, р░лр▒Нр░▓р░╛р░Чр▒Н р░кр▒Ир░Хр░┐ р░Йр░Вр░бр░┐, р░др▒Жр░░р░┐р░Ър░┐р░и р░ор▒Жр░пр░┐р░▓р▒Н р░мр░╛р░Хр▒Нр░╕р▒Н, р░ор▒Жр░пр░┐р░▓р▒Н, р░ор▒Жр░пр░┐р░▓р▒Н р░мр░╛р░Хр▒Нр░╕р▒Н
ЁЯУня╕П	р░кр░Вр░кр░╡р░▓р░╕р░┐р░и р░ор▒Жр░пр░┐р░▓р▒НтАМр░▓р▒Б р░Пр░╡р▒А р░▓р▒Зр░╡р▒Б, р░лр▒Нр░▓р░╛р░Чр▒Н р░Хр▒Нр░░р░┐р░Вр░жр░┐р░Хр░┐ р░Йр░Вр░бр░┐, р░др▒Жр░░р░┐р░Ър░┐р░и р░ор▒Жр░пр░┐р░▓р▒Н р░мр░╛р░Хр▒Нр░╕р▒Н, р░ор▒Жр░пр░┐р░▓р▒Н р░мр░╛р░Хр▒Нр░╕р▒Н р░Цр░╛р░│р▒Ар░Чр░╛ р░Йр░Вр░жр░┐
ЁЯУ╖я╕П	р░Хр▒Жр░ор▒Жр░░р░╛, р░╡р▒Ар░бр░┐р░пр▒Л
ЁЯУ╣я╕П	р░Хр▒Жр░ор▒Жр░░р░╛, р░╡р▒Ар░бр░┐р░пр▒Л, р░╡р▒Ар░бр░┐р░пр▒Л р░Хр▒Жр░ор▒Жр░░р░╛
ЁЯУ║я╕П	р░Яр▒Ар░╡р▒А, р░Яр▒Жр░▓р░┐р░╡р░┐р░Ьр░ир▒Н, р░жр▒Вр░░р░жр░░р▒Нр░╢р░┐р░ир░┐
ЁЯУ╗я╕П	р░░р▒Зр░бр░┐р░пр▒Л, р░╡р▒Ар░бр░┐р░пр▒Л
ЁЯУ╜я╕П	р░кр▒Нр░░р▒Кр░Ьр▒Жр░Хр▒Нр░Яр░░р▒Н, р░╖р▒Вр░Яр░┐р░Вр░Чр▒Н, р░╕р░┐р░ир░┐р░ор░╛, р░╕р░┐р░ир░┐р░ор░╛ р░кр▒Нр░░р▒Кр░Ьр▒Жр░Хр▒Нр░Яр░░р▒Н
ЁЯФИя╕П	р░др░Хр▒Нр░Хр▒Бр░╡ р░╢р░мр▒Нр░жр░Вр░др▒Л р░╕р▒Нр░кр▒Ар░Хр░░р▒Н, р░╡р░╛р░▓р▒Нр░пр▒Вр░ор▒Н р░Йр░Вр░жр░┐, р░╡р░╛р░▓р▒Нр░пр▒Вр░ор▒Н р░Ър░┐р░╣р▒Нр░ир░В, р░╢р░мр▒Нр░жр░В р░Ър▒Зр░пр░┐
ЁЯФТя╕П	р░др░╛р░│р░ор▒Б, р░ор▒Вр░╕р░┐р░╡р▒Зр░╕р░┐р░и р░др░╛р░│р░ор▒Б, р░░р░Хр▒Нр░╖р░┐р░Вр░Ър░мр░бр░┐р░Вр░жр░┐, р░▓р░╛р░Хр▒Н р░Ър▒Зр░пр░мр░бр░┐р░Вр░жр░┐, р░╡р▒Зр░╕р░┐ р░Йр░ир▒Нр░и р░др░╛р░│р░В
ЁЯФУя╕П	р░др▒Жр░░р░┐р░Ър░┐ р░Йр░ир▒Нр░и р░др░╛р░│р░В, р░др▒Жр░░р░┐р░Ър░┐р░и р░др░╛р░│р░ор▒Б, р░░р░Хр▒Нр░╖р░┐р░Вр░Ър░мр░бр░▓р▒Зр░жр▒Б, р░▓р░╛р░Хр▒Н р░др▒Ар░╕р░┐р░╡р▒Зр░пр░мр░бр░┐р░Вр░жр░┐
ЁЯХЙя╕П	р░Ур░В, р░ор░др░В, р░╣р░┐р░Вр░жр▒Б
ЁЯХКя╕П	р░Ор░Чр░░р░бр░В, р░кр░Хр▒Нр░╖р░┐, р░кр░╛р░╡р▒Бр░░р░В, р░╢р░╛р░Вр░др░┐
ЁЯХРя╕П	р░Тр░Вр░Яр░┐р░Чр░Вр░Я р░╕р▒Вр░Ър░┐р░Вр░Ър▒З р░Чр░бр░┐р░пр░╛р░░р░В, р░Тр░Хр░Яр░┐, р░Чр░Вр░Я, р░Чр░бр░┐р░пр░╛р░░р░В
ЁЯХСя╕П	р░Чр░Вр░Я, р░Чр░бр░┐р░пр░╛р░░р░В, р░░р▒Жр░Вр░бр▒Б, р░░р▒Жр░Вр░бр▒Б р░Чр░Вр░Яр░▓р▒Б р░╕р▒Вр░Ър░┐р░Вр░Ър▒З р░Чр░бр░┐р░пр░╛р░░р░В
ЁЯХТя╕П	р░Чр░Вр░Я, р░Чр░бр░┐р░пр░╛р░░р░В, р░ор▒Вр░бр▒Б, р░ор▒Вр░бр▒Б р░Чр░Вр░Яр░▓р▒Б р░╕р▒Вр░Ър░┐р░Вр░Ър▒З р░Чр░бр░┐р░пр░╛р░░р░В
ЁЯХУя╕П	р░Чр░Вр░Я, р░Чр░бр░┐р░пр░╛р░░р░В, р░ир░╛р░▓р▒Бр░Чр▒Б, р░ир░╛р░▓р▒Бр░Чр▒Б р░Чр░Вр░Яр░▓р▒Б р░╕р▒Вр░Ър░┐р░Вр░Ър▒З р░Чр░бр░┐р░пр░╛р░░р░В
ЁЯХФя╕П	р░Рр░жр▒Б, р░Рр░жр▒Б р░Чр░Вр░Яр░▓р▒Б р░╕р▒Вр░Ър░┐р░Вр░Ър▒З р░Чр░бр░┐р░пр░╛р░░р░В, р░Чр░Вр░Я, р░Чр░бр░┐р░пр░╛р░░р░В
ЁЯХХя╕П	р░Жр░░р▒Б, р░Жр░░р▒Б р░Чр░Вр░Яр░▓р▒Б р░╕р▒Вр░Ър░┐р░Вр░Ър▒З р░Чр░бр░┐р░пр░╛р░░р░В, р░Чр░Вр░Я, р░Чр░бр░┐р░пр░╛р░░р░В
ЁЯХЦя╕П	р░Пр░бр▒Б, р░Пр░бр▒Б р░Чр░Вр░Яр░▓р▒Б р░╕р▒Вр░Ър░┐р░Вр░Ър▒З р░Чр░бр░┐р░пр░╛р░░р░В, р░Чр░Вр░Я, р░Чр░бр░┐р░пр░╛р░░р░В
ЁЯХЧя╕П	р░Ор░ир░┐р░ор░┐р░жр░┐, р░Ор░ир░┐р░ор░┐р░жр░┐ р░Чр░Вр░Яр░▓р▒Б р░╕р▒Вр░Ър░┐р░Вр░Ър▒З р░Чр░бр░┐р░пр░╛р░░р░В, р░Чр░Вр░Я, р░Чр░бр░┐р░пр░╛р░░р░В
ЁЯХШя╕П	р░Чр░Вр░Я, р░Чр░бр░┐р░пр░╛р░░р░В, р░др▒Кр░ор▒Нр░ор░┐р░жр░┐, р░др▒Кр░ор▒Нр░ор░┐р░жр░┐ р░Чр░Вр░Яр░▓р▒Б р░╕р▒Вр░Ър░┐р░Вр░Ър▒З р░Чр░бр░┐р░пр░╛р░░р░В
ЁЯХЩя╕П	р░Чр░Вр░Я, р░Чр░бр░┐р░пр░╛р░░р░В, р░кр░жр░┐, р░кр░жр░┐ р░Чр░Вр░Яр░▓р▒Б р░╕р▒Вр░Ър░┐р░Вр░Ър▒З р░Чр░бр░┐р░пр░╛р░░р░В
ЁЯХЪя╕П	р░Чр░Вр░Я, р░Чр░бр░┐р░пр░╛р░░р░В, р░кр░жр░Хр▒Кр░Вр░бр▒Б, р░кр░жр░Хр▒Кр░Вр░бр▒Б р░Чр░Вр░Яр░▓р▒Б р░╕р▒Вр░Ър░┐р░Вр░Ър▒З р░Чр░бр░┐р░пр░╛р░░р░В
ЁЯХЫя╕П	р░Чр░Вр░Я, р░Чр░бр░┐р░пр░╛р░░р░В, р░кр░ир▒Нр░ир▒Жр░Вр░бр▒Б, р░кр░ир▒Нр░ир▒Жр░Вр░бр▒Б р░Чр░Вр░Яр░▓р▒Б р░╕р▒Вр░Ър░┐р░Вр░Ър▒З р░Чр░бр░┐р░пр░╛р░░р░В
ЁЯХпя╕П	р░Хр▒Кр░╡р▒Нр░╡р▒Кр░др▒Нр░др░┐, р░жр▒Ар░кр░В, р░╡р▒Жр░▓р▒Бр░Чр▒Б
ЁЯХ░я╕П	р░Чр░бр░┐р░пр░╛р░░р░В, р░ор░┐р░жр▒Нр░жр▒Ж, р░ор░┐р░жр▒Нр░жр▒Ж р░ор▒Ар░ж р░кр▒Жр░Яр▒Нр░Яр▒З р░Чр░бр░┐р░пр░╛р░░р░В
ЁЯХ│я╕П	р░░р░Вр░зр▒Нр░░р░В
ЁЯХ┤я╕П	р░Чр░╛р░▓р▒Нр░▓р▒Л р░др▒Зр░▓р▒Бр░др▒Бр░ир▒Нр░и р░╕р▒Вр░Яр▒Б р░мр▒Вр░Яр▒Б р░╡р▒Зр░╕р▒Бр░Хр▒Бр░ир▒Нр░и р░╡р▒Нр░пр░╛р░кр░╛р░░р░╡р▒Зр░др▒Нр░д, р░╡р▒Нр░пр░╛р░кр░╛р░░р░╡р▒Зр░др▒Нр░д, р░╕р▒Вр░Яр▒Б р░мр▒Вр░Яр▒Б
ЁЯХ╡я╕П	р░Ер░кр░░р░╛р░з р░кр░░р░┐р░╢р▒Лр░зр░Хр▒Бр░бр▒Б, р░Чр▒Вр░вр░Ър░╛р░░р░┐, р░ир▒Зр░░ р░кр░░р░┐р░╢р▒Лр░зр░Хр▒Бр░бр▒Б, р░кр░░р░┐р░╢р▒Лр░зр░Хр▒Бр░бр▒Б
ЁЯХ╢я╕П	р░Хр░│р▒Нр░▓р░жр▒Нр░жр░╛р░▓р▒Б, р░Ър░▓р▒Бр░╡, р░Ър░▓р▒Бр░╡ р░Хр░│р▒Нр░▓р░жр▒Нр░жр░╛р░▓р▒Б
ЁЯХ╖я╕П	р░Хр▒Ар░Яр░Хр░В, р░╕р░╛р░▓р▒Ар░бр▒Б
ЁЯХ╕я╕П	р░Чр▒Вр░бр▒Б, р░╕р░╛р░▓р▒Ар░бр▒Б, р░╕р░╛р░▓р▒Ар░бр▒Б р░Чр▒Вр░бр▒Б
ЁЯХ╣я╕П	р░Чр▒Зр░ор▒Н, р░Ьр░╛р░пр▒НтАМр░╕р▒Нр░Яр░┐р░Хр▒Н, р░╡р▒Ар░бр░┐р░пр▒Л р░Чр▒Зр░ор▒Н
ЁЯЦЗя╕П	р░Хр▒Нр░▓р░┐р░кр▒НтАМр░▓р▒Б, р░кр▒Зр░кр░░р▒Н, р░ор▒Бр░бр░┐ р░кр░бр░Яр░В, р░ор▒Бр░бр░┐ р░кр░бр░┐ р░Йр░ир▒Нр░и р░кр▒Зр░кр░░р▒Н р░Хр▒Нр░▓р░┐р░кр▒НтАМр░▓р▒Б
ЁЯЦКя╕П	р░Хр░▓р░В, р░мр░╛р░▓р▒Н р░кр░╛р░пр░┐р░Вр░Яр▒Н
ЁЯЦЛя╕П	р░Хр░▓р░В, р░кр▒Жр░ир▒Н, р░лр▒Мр░Вр░Яр▒Жр░пр░┐р░ир▒Н, р░лр▒Мр░Вр░Яр▒Жр░пр░┐р░ир▒Н р░кр▒Жр░ир▒Н
ЁЯЦМя╕П	р░кр▒Жр░пр░┐р░Вр░Яр▒Н, р░кр▒Жр░пр░┐р░Вр░Яр▒Н р░мр▒Нр░░р░╖р▒Н, р░мр▒Нр░░р░╖р▒Н
ЁЯЦНя╕П	р░Хр▒Нр░░р▒Зр░пр░╛р░ир▒Н, р░░р░Вр░Чр▒Б р░кр▒Жр░ир▒Нр░╕р░┐р░▓р▒Н
ЁЯЦРя╕П	р░Ър▒Зр░пр░┐, р░╡р▒Зр░│р▒Нр░▓р▒Б, р░╡р▒Зр░│р▒Нр░▓р▒Б р░др▒Жр░░р░┐р░Ър░┐ р░кр▒Ир░Хр░┐ р░Ор░др▒Нр░др░┐р░и р░Ър▒Зр░пр░┐
ЁЯЦея╕П	р░Хр░Вр░кр▒Нр░пр▒Вр░Яр░░р▒Н, р░бр▒Жр░╕р▒Нр░Хр▒НтАМр░Яр░╛р░кр▒Н, р░бр▒Жр░╕р▒Нр░Хр▒НтАМр░Яр░╛р░кр▒Н р░Хр░Вр░кр▒Нр░пр▒Вр░Яр░░р▒Н
ЁЯЦия╕П	р░кр▒Нр░░р░┐р░Вр░Яр░░р▒Н, р░ор▒Бр░жр▒Нр░░р░г
ЁЯЦ▒я╕П	р░Хр░Вр░кр▒Нр░пр▒Вр░Яр░░р▒Н, р░Хр░Вр░кр▒Нр░пр▒Вр░Яр░░р▒Н р░ор▒Мр░╕р▒Н, р░Хр░░р▒Нр░╕р░░р▒Н, р░ор▒Мр░╕р▒Н
ЁЯЦ▓я╕П	р░Яр▒Нр░░р░╛р░Хр▒НтАМр░мр░╛р░▓р▒Н, р░кр░╛р░пр░┐р░Вр░Яр░░р▒Н, р░ор▒Мр░╕р▒Н
ЁЯЦ╝я╕П	р░Ър░┐р░др▒Нр░░р░В, р░Ър░┐р░др▒Нр░░р░В р░Йр░ир▒Нр░и р░лр▒Нр░░р▒Зр░ор▒Н, р░лр▒Нр░░р▒Зр░ор▒Н
ЁЯЧВя╕П	р░Зр░Вр░бр▒Жр░Хр▒Нр░╕р▒Н, р░Хр░╛р░░р▒Нр░бр▒Н, р░Хр░╛р░░р▒Нр░бр▒Н р░Зр░Вр░бр▒Жр░Хр▒Нр░╕р▒Н р░бр░┐р░╡р▒Ир░бр░░р▒НтАМр░▓р▒Б, р░бр░┐р░╡р▒Ир░бр░░р▒НтАМр░▓р▒Б, р░╕р▒Вр░Ър░┐р░Х
ЁЯЧГя╕П	р░Хр░╛р░░р▒Нр░бр▒Н, р░Хр░╛р░░р▒Нр░бр▒Н р░лр▒Ир░▓р▒Н р░кр▒Жр░Яр▒Нр░Яр▒Ж, р░кр▒Жр░Яр▒Нр░Яр▒Ж, р░лр▒Ир░▓р▒Н
ЁЯЧДя╕П	р░Хр▒Нр░пр░╛р░мр░┐р░ир▒Жр░Яр▒Н, р░лр▒Ир░▓р▒Н, р░лр▒Ир░▓р▒Н р░Хр▒Нр░пр░╛р░мр░┐р░ир▒Жр░Яр▒Н
ЁЯЧСя╕П	р░Ър▒Жр░др▒Нр░д р░мр▒Бр░Яр▒Нр░Я, р░кр░ир░┐р░Хр░┐ р░░р░╛р░жр▒Б
ЁЯЧТя╕П	р░ир▒Лр░Яр▒Н, р░кр▒Нр░пр░╛р░бр▒Н, р░╕р▒Нр░кр▒Ир░░р░▓р▒Н, р░╕р▒Нр░кр▒Ир░░р░▓р▒Н р░ир▒Лр░Яр▒Н р░кр▒Нр░пр░╛р░бр▒Н
ЁЯЧУя╕П	р░Хр▒Нр░пр░╛р░▓р▒Жр░Вр░бр░░р▒Н, р░╕р▒Нр░кр▒Ир░░р░▓р▒Н, р░╕р▒Нр░кр▒Ир░░р░▓р▒Н р░Хр▒Нр░пр░╛р░▓р▒Жр░Вр░бр░░р▒Н
ЁЯЧЬя╕П	р░Хр▒Бр░жр░┐р░Вр░кр▒Б, р░╡р▒Ир░╕р▒Н, р░╕р░╛р░зр░ир░В
ЁЯЧЭя╕П	р░Хр▒Нр░▓р▒В, р░др░╛р░│р░В р░Ър▒Жр░╡р░┐, р░кр░╛р░др░Хр░╛р░▓р░В, р░кр░╛р░др░Хр░╛р░▓р░В р░др░╛р░│р░В р░Ър▒Жр░╡р░┐
ЁЯЧбя╕П	р░Жр░пр▒Бр░зр░В, р░Хр░др▒Нр░др░┐, р░мр░╛р░Хр▒Б
ЁЯЧгя╕П	р░др░▓, р░ир▒Ар░б, р░ор░╛р░Яр▒Нр░▓р░╛р░бр░Яр░В, р░ор░╛р░Яр▒Нр░▓р░╛р░бр▒Бр░др▒Бр░ир▒Нр░и р░др░▓, р░ор░╛р░Яр▒Нр░▓р░╛р░бр▒Бр░др▒Бр░ир▒Нр░ир░╛р░░р▒Б, р░ор▒Бр░Цр░В
ЁЯЧия╕П	р░Ор░бр░о р░бр▒Ир░▓р░╛р░Чр▒Н р░мр▒Бр░бр░Ч, р░бр▒Ир░▓р░╛р░Чр▒Н, р░мр▒Бр░бр░Ч
ЁЯЧпя╕П	р░Хр▒Лр░кр░В, р░Хр▒Лр░кр░Вр░др▒Л р░Йр░ир▒Нр░и р░Хр▒Бр░бр░┐ р░мр▒Бр░бр░Ч, р░мр▒Бр░бр░Ч
ЁЯЧ│я╕П	р░кр▒Жр░Яр▒Нр░Яр▒Ж, р░мр░╛р░Хр▒Нр░╕р▒Н, р░мр▒Нр░пр░╛р░▓р▒Жр░Яр▒Н, р░мр▒Нр░пр░╛р░▓р▒Жр░Яр▒НтАМр░др▒Л р░мр▒Нр░пр░╛р░▓р▒Жр░Яр▒Н р░мр░╛р░Хр▒Нр░╕р▒Н
ЁЯЧ║я╕П	р░кр▒Нр░░р░кр░Вр░Ър░В, р░кр▒Нр░░р░кр░Вр░Ър░кр░Яр░В, р░ор▒Нр░пр░╛р░кр▒Н
ЁЯШРя╕П	р░П р░нр░╛р░╡р░В р░▓р▒Зр░ир░┐ р░ор▒Бр░Цр░В, р░др░Яр░╕р▒Нр░е р░ор▒Бр░Цр░В, р░др░Яр░╕р▒Нр░ер░В, р░ор▒Бр░Цр░В
ЁЯЪЗя╕П	р░ор▒Жр░Яр▒Нр░░р▒Л, р░ор▒Жр░Яр▒Нр░░р▒Л р░░р▒Ир░▓р▒Б, р░░р▒Ир░▓р▒Б
ЁЯЪНя╕П	р░мр░╕р▒Нр░╕р▒Б, р░ор▒Бр░Вр░жр▒Б, р░ор▒Бр░Вр░жр▒Бр░╡р▒Ир░кр▒Б р░╡р░╕р▒Нр░др▒Бр░ир▒Нр░и р░мр░╕р▒Нр░╕р▒Б
ЁЯЪСя╕П	р░Ер░Вр░мр▒Бр░▓р▒Жр░ир▒Нр░╕р▒Н, р░╡р░╛р░╣р░ир░В
ЁЯЪФя╕П	р░кр▒Лр░▓р▒Ар░╕р▒Б, р░ор▒Бр░Вр░жр▒Б, р░ор▒Бр░Вр░жр▒Бр░╡р▒Ир░кр▒Б р░╡р░╕р▒Нр░др▒Бр░ир▒Нр░и р░кр▒Лр░▓р▒Ар░╕р▒Б р░╡р░╛р░╣р░ир░В, р░╡р░╛р░╣р░ир░В
ЁЯЪШя╕П	р░Хр░╛р░░р▒Б, р░ор▒Бр░Вр░жр▒Б, р░ор▒Бр░Вр░жр▒Бр░╡р▒Ир░кр▒Б р░╡р░╕р▒Нр░др▒Бр░ир▒Нр░и р░Хр░╛р░░р▒Б
ЁЯЪня╕П	р░И р░кр▒Нр░░р░╛р░Вр░др░Вр░▓р▒Л р░кр▒Кр░Ч р░др▒Нр░░р░╛р░Чр░░р░╛р░жр▒Б, р░кр▒Кр░Ч р░др▒Нр░░р░╛р░Чр░░р░╛р░жр▒Б, р░кр▒Кр░Ч р░др▒Нр░░р░╛р░Чр░░р░╛р░жр▒Б р░Ър░┐р░╣р▒Нр░ир░В
ЁЯЪ▓я╕П	р░╕р▒Ир░Хр░┐р░▓р▒Н, р░╕р▒Ир░Хр░┐р░▓р▒НтАМр░▓р░Хр▒Б р░ор░╛р░др▒Нр░░р░ор▒З р░Ер░ир▒Бр░ор░др░┐ р░Йр░Вр░жр░┐
ЁЯЪ╣я╕П	р░кр▒Бр░░р▒Бр░╖р▒Бр░▓ р░╡р░┐р░╢р▒Нр░░р░╛р░Вр░др░┐ р░Чр░жр░┐, р░кр▒Бр░░р▒Бр░╖р▒Бр░▓р▒Б
ЁЯЪ║я╕П	р░╕р▒Нр░др▒Нр░░р▒Ар░▓ р░╡р░┐р░╢р▒Нр░░р░╛р░Вр░др░┐ р░Чр░жр░┐, р░╕р▒Нр░др▒Нр░░р▒Ар░▓р▒Б
ЁЯЪ╝я╕П	р░Ър░┐р░ир▒Нр░и р░кр░┐р░▓р▒Нр░▓р░▓р░Хр▒Б р░Ер░ир▒Бр░╡р▒Ир░и р░Чр░жр░┐, р░Ър░┐р░ир▒Нр░и р░кр░┐р░▓р▒Нр░▓р░▓р▒Б
ЁЯЫЛя╕П	р░▓р▒Нр░пр░╛р░Вр░кр▒Н, р░╕р▒Лр░лр░╛, р░╕р▒Лр░лр░╛ р░ор░░р░┐р░пр▒Б р░▓р▒Нр░пр░╛р░Вр░кр▒Н
ЁЯЫНя╕П	р░мр▒Нр░пр░╛р░Чр▒Н, р░╖р░╛р░кр░┐р░Вр░Чр▒Н, р░╖р░╛р░кр░┐р░Вр░Чр▒НтАМр░Хр░┐ р░╡р░╛р░бр▒З р░мр▒Нр░пр░╛р░Чр▒Бр░▓р▒Б
ЁЯЫОя╕П	р░мр▒Жр░▓р▒Н, р░╕р░░р▒Нр░╡р░░р▒Н, р░╕р░░р▒Нр░╡р░░р▒НтАМр░ир░┐ р░кр░┐р░▓р░╡р░бр░╛р░ир░┐р░Хр░┐ р░╡р░╛р░бр▒З р░мр▒Жр░▓р▒Н
ЁЯЫПя╕П	р░ир░┐р░жр▒Нр░░, р░кр░░р▒Бр░кр▒Б, р░╣р▒Лр░Яр░▓р▒Н
ЁЯЫая╕П	р░░р▒Жр░Вр░Ър░┐, р░╕р░╛р░зр░ир░В, р░╕р▒Бр░др▒Нр░др░┐, р░╕р▒Бр░др▒Нр░др░┐ р░ор░░р░┐р░пр▒Б р░░р▒Жр░Вр░Ър░┐
ЁЯЫбя╕П	р░Жр░пр▒Бр░зр░В, р░Хр░╡р░Ър░В, р░░р░Хр▒Нр░╖р░г
ЁЯЫвя╕П	р░Ър░ор▒Бр░░р▒Б, р░Ър░ор▒Бр░░р▒Б р░бр▒Нр░░р░ор▒Н, р░бр▒Нр░░р░ор▒Н, р░кр▒Ар░кр░╛
ЁЯЫгя╕П	р░░р░╣р░жр░╛р░░р░┐, р░╣р▒Ир░╡р▒З
ЁЯЫдя╕П	р░Яр▒Нр░░р░╛р░Хр▒Н, р░░р▒Ир░▓р▒Б, р░░р▒Ир░▓р▒Нр░╡р▒З р░Яр▒Нр░░р░╛р░Хр▒Н
ЁЯЫея╕П	р░кр░бр░╡, р░ор▒Лр░Яр░╛р░░р▒Б, р░ор▒Лр░Яр░╛р░░р▒Б р░кр░бр░╡
ЁЯЫйя╕П	р░Ър░┐р░ир▒Нр░и, р░Ър░┐р░ир▒Нр░и р░╡р░┐р░ор░╛р░ир░В, р░╡р░┐р░ор░╛р░ир░В
ЁЯЫ░я╕П	р░Ер░Вр░др░░р░┐р░Хр▒Нр░╖р░В, р░╕р░╛р░Яр░┐р░▓р▒Ир░Яр▒Н
ЁЯЫ│я╕П	р░Ур░б, р░кр▒Нр░░р░пр░╛р░гр░В, р░кр▒Нр░░р░пр░╛р░гр░┐р░Хр▒Бр░▓ р░Ур░б
