üèª	—Å–≤—ñ—Ç–ª–∏–π —Ç–æ–Ω —à–∫—ñ—Ä–∏, —Ç–æ–Ω, —Ñ—ñ—Ü–ø–∞—Ç—Ä—ñ–∫, —à–∫—ñ—Ä–∞
üèº	–ø–æ–º—ñ—Ä–Ω–æ —Å–≤—ñ—Ç–ª–∏–π —Ç–æ–Ω —à–∫—ñ—Ä–∏, –ø–æ–º—ñ—Ä–Ω–æ-—Å–≤—ñ—Ç–ª–∏–π —Ç–æ–Ω —à–∫—ñ—Ä–∏, —Ç–æ–Ω, —Ñ—ñ—Ü–ø–∞—Ç—Ä—ñ–∫, —à–∫—ñ—Ä–∞
üèΩ	–ø–æ–º—ñ—Ä–Ω–∏–π —Ç–æ–Ω —à–∫—ñ—Ä–∏, —Å–µ—Ä–µ–¥–Ω—ñ–π —Ç–æ–Ω —à–∫—ñ—Ä–∏, —Ç–æ–Ω, —Ñ—ñ—Ü–ø–∞—Ç—Ä—ñ–∫, —à–∫—ñ—Ä–∞
üèæ	–ø–æ–º—ñ—Ä–Ω–æ —Ç–µ–º–Ω–∏–π —Ç–æ–Ω —à–∫—ñ—Ä–∏, –ø–æ–º—ñ—Ä–Ω–æ-—Ç–µ–º–Ω–∏–π —Ç–æ–Ω —à–∫—ñ—Ä–∏, —Ç–æ–Ω, —Ñ—ñ—Ü–ø–∞—Ç—Ä—ñ–∫, —à–∫—ñ—Ä–∞
üèø	—Ç–µ–º–Ω–∏–π —Ç–æ–Ω —à–∫—ñ—Ä–∏, —Ç–æ–Ω, —Ñ—ñ—Ü–ø–∞—Ç—Ä—ñ–∫, —à–∫—ñ—Ä–∞
üòÄ	–æ–±–ª–∏—á—á—è, —É—Å–º—ñ—à–∫–∞, —à–∏—Ä–æ–∫–æ –≤—Å–º—ñ—Ö–Ω–µ–Ω–µ –æ–±–ª–∏—á—á—è, —à–∏—Ä–æ–∫–æ —É—Å–º—ñ—Ö–Ω–µ–Ω–µ –æ–±–ª–∏—á—á—è
üòÅ	–æ–±–ª–∏—á—á—è, –æ—Å—è–π–Ω–æ –≤—Å–º—ñ—Ö–Ω–µ–Ω–µ –æ–±–ª–∏—á—á—è –π –æ—á—ñ, –æ—Å—è–π–Ω–æ —É—Å–º—ñ—Ö–Ω–µ–Ω–µ –æ–±–ª–∏—á—á—è –∑ —É—Å–º—ñ—Ö–Ω–µ–Ω–∏–º–∏ –æ—á–∏–º–∞, –æ—Å—è–π–Ω–æ —É—Å–º—ñ—Ö–Ω–µ–Ω–µ –æ–±–ª–∏—á—á—è –π –æ—á—ñ, –æ—á—ñ, —É—Å–º—ñ—à–∫–∞
üòÇ	–æ–±–ª–∏—á—á—è, –æ–±–ª–∏—á—á—è –≤ —Å–ª—å–æ–∑–∞—Ö —Ä–∞–¥–æ—Å—Ç—ñ, –æ–±–ª–∏—á—á—è –∑—ñ —Å–ª—å–æ–∑–∞–º–∏ —Ä–∞–¥–æ—Å—Ç—ñ, —Ä–∞–¥—ñ—Å—Ç—å, —Å–ª—å–æ–∑–∏, —Å–º—ñ—Ö
ü§£	–∫–∞—á–∞—î—Ç—å—Å—è –≤—ñ–¥ —Å–º—ñ—Ö—É, –æ–±–ª–∏—á—á—è, —Ä–µ–≥—ñ—Ç, —Å–º—ñ—Ö
üòÉ	–≤—ñ–¥–∫—Ä–∏—Ç–∏–π, –æ–±–ª–∏—á—á—è, –ø–æ—Å–º—ñ—à–∫–∞, —Ä–æ—Ç, —à–∏—Ä–æ–∫–æ –≤—Å–º—ñ—Ö–Ω–µ–Ω–µ –æ–±–ª–∏—á—á—è –∑ –æ—á–∏—â–∞–º–∏, —à–∏—Ä–æ–∫–æ —É—Å–º—ñ—Ö–Ω–µ–Ω–µ –æ–±–ª–∏—á—á—è –∑ –≤–µ–ª–∏–∫–∏–º–∏ –æ—á–∏–º–∞, —à–∏—Ä–æ–∫–æ —É—Å–º—ñ—Ö–Ω–µ–Ω–µ –æ–±–ª–∏—á—á—è –∑ –æ—á–∏—â–∞–º–∏
üòÑ	–≤—ñ–¥–∫—Ä–∏—Ç–∏–π, –æ–±–ª–∏—á—á—è, –æ—á—ñ, –ø–æ—Å–º—ñ—à–∫–∞, —Ä–æ—Ç, —É—Å–º—ñ—Ö–Ω–µ–Ω–µ –æ–±–ª–∏—á—á—è –∑ –≤—ñ–¥–∫—Ä–∏—Ç–∏–º —Ä–æ—Ç–æ–º —ñ –ø—Ä–∏–º—Ä—É–∂–µ–Ω–∏–º–∏ –æ—á–∏–º–∞, —à–∏—Ä–æ–∫–æ –≤—Å–º—ñ—Ö–Ω–µ–Ω–µ –æ–±–ª–∏—á—á—è –∑ –ø—Ä–∏–º—Ä—É–∂–µ–Ω–∏–º–∏ –æ—á–∏–º–∞, —à–∏—Ä–æ–∫–æ —É—Å–º—ñ—Ö–Ω–µ–Ω–µ –æ–±–ª–∏—á—á—è –∑—ñ –∑–º—Ä—É–∂–µ–Ω–∏–º–∏ –æ—á–∏–º–∞
üòÖ	–≤—ñ–¥–∫—Ä–∏—Ç–∏–π, –æ–±–ª–∏—á—á—è, –ø–æ—Å–º—ñ—à–∫–∞, –ø—ñ—Ç, —É—Å–º—ñ—Ö–Ω–µ–Ω–µ –æ–±–ª–∏—á—á—è –∑ –≤—ñ–¥–∫—Ä–∏—Ç–∏–º —Ä–æ—Ç–æ–º —ñ —Ö–æ–ª–æ–¥–Ω–∏–º –ø–æ—Ç–æ–º, —Ö–æ–ª–æ–¥–Ω–∏–π, —à–∏—Ä–æ–∫–æ –≤—Å–º—ñ—Ö–Ω–µ–Ω–µ –æ–±–ª–∏—á—á—è –∑ –ø–æ—Ç–æ–º
üòÜ	–≤—ñ–¥–∫—Ä–∏—Ç–∏–π, –∑–∞–¥–æ–≤–æ–ª–µ–Ω–∏–π, –æ–±–ª–∏—á—á—è, –ø–æ—Å–º—ñ—à–∫–∞, —Ä–æ—Ç, —Å–º—ñ—Ö, —É—Å–º—ñ—Ö–Ω–µ–Ω–µ –æ–±–ª–∏—á—á—è –∑ –≤—ñ–¥–∫—Ä–∏—Ç–∏–º —Ä–æ—Ç–æ–º —ñ –º—ñ—Ü–Ω–æ –∑–∞–ø–ª—é—â–µ–Ω–∏–º–∏ –æ—á–∏–º–∞, —à–∏—Ä–æ–∫–æ –≤—Å–º—ñ—Ö–Ω–µ–Ω–µ –∑–∞–º—Ä—É–∂–µ–Ω–µ –æ–±–ª–∏—á—á—è
üòâ	–æ–±–ª–∏—á—á—è, –æ–±–ª–∏—á—á—è, —â–æ –ø—ñ–¥–º–æ—Ä–≥—É—î, –ø—ñ–¥–º–æ—Ä–≥—É–≤–∞–Ω–Ω—è
üòä	–æ–±–ª–∏—á—á—è, –æ—á—ñ, –ø–æ—Å–º—ñ—à–∫–∞, —Ä—É–º‚Äô—è–Ω–µ—Ü—å, —É—Å–º—ñ—Ö–Ω–µ–Ω–µ –æ–±–ª–∏—á—á—è –∑ –ø—Ä–∏–º—Ä—É–∂–µ–Ω–∏–º–∏ –æ—á–∏–º–∞, —É—Å–º—ñ—Ö–Ω–µ–Ω–µ –æ–±–ª–∏—á—á—è –π –æ—á—ñ
üòã	–º–º–º, –Ω—è–º-–Ω—è–º, –æ–±–ª–∏–∑—É—î—Ç—å—Å—è, –æ–±–ª–∏—á—á—è, –ø–æ—Å–º—ñ—à–∫–∞, —Å–º–∞–∫—É—î, —Å–º–∞—á–Ω–æ, —É—Å–º—ñ—Ö–Ω–µ–Ω–µ –æ–±–ª–∏—á—á—è, —â–æ –æ–±–ª–∏–∑—É—î –≥—É–±–∏
üòé	–∫—Ä—É—Ç–∏–π, –æ–±–ª–∏—á—á—è, –æ–∫—É–ª—è—Ä–∏, –æ—á—ñ, –ø–æ–≥–æ–¥–∞, –ø–æ—Å–º—ñ—à–∫–∞, —Å–æ–Ω—Ü–µ, —Å–æ–Ω—Ü–µ–∑–∞—Ö–∏—Å–Ω—ñ, —Ç–µ–º–Ω—ñ –æ–∫—É–ª—è—Ä–∏, —É—Å–º—ñ—Ö–Ω–µ–Ω–µ –æ–±–ª–∏—á—á—è –≤ —Ç–µ–º–Ω–∏—Ö –æ–∫—É–ª—è—Ä–∞—Ö, —è—Å–∫—Ä–∞–≤–æ
üòç	–∫–æ—Ö–∞–Ω–Ω—è, –æ–±–ª–∏—á—á—è, –æ—á—ñ, –ø–æ—Å–º—ñ—à–∫–∞, —Å–µ—Ä—Ü–µ, —É—Å–º—ñ—Ö–Ω–µ–Ω–µ –æ–±–ª–∏—á—á—è –∑ –æ—á–∞–º–∏-—Å–µ—Ä—Ü—è–º–∏, —É—Å–º—ñ—Ö–Ω–µ–Ω–µ –æ–±–ª–∏—á—á—è –∑ –æ—á–∏–º–∞ —É —Ñ–æ—Ä–º—ñ —Å–µ—Ä–¥–µ—Ü—å
üòò	–æ–±–ª–∏—á—á—è, –æ–±–ª–∏—á—á—è, —â–æ –Ω–∞–¥—Å–∏–ª–∞—î —Ü—ñ–ª—É–Ω–æ–∫, –ø–æ—Ü—ñ–ª—É–Ω–æ–∫, —Å–µ—Ä—Ü–µ
ü•∞	–∑–∞–∫–æ—Ö–∞–Ω—ñ—Å—Ç—å, –∑–∞–∫–æ—Ö–∞—Ç–∏—Å—è, –∫–æ—Ö–∞–Ω–Ω—è, –ª—é–±–æ–≤, –Ω—ñ–∂–Ω—ñ—Å—Ç—å, —É—Å–º—ñ—Ö–Ω–µ–Ω–µ –æ–±–ª–∏—á—á—è —ñ–∑ —Å–µ—Ä–¥–µ—á–∫–∞–º–∏
üòó	–æ–±–ª–∏—á—á—è, –æ–±–ª–∏—á—á—è, —â–æ —Ü—ñ–ª—É—î
üòô	–æ–±–ª–∏—á—á—è, –æ–±–ª–∏—á—á—è –∑ –ø—Ä–∏–º—Ä—É–∂–µ–Ω–∏–º–∏ –æ—á–∏–º–∞, —â–æ —Ü—ñ–ª—É—î, –æ—á—ñ, –ø–æ—Å–º—ñ—à–∫–∞, –ø–æ—Ü—ñ–ª—É–Ω–æ–∫
üòö	–∑–∞–∫—Ä–∏—Ç—ñ, –æ–±–ª–∏—á—á—è, –æ–±–ª–∏—á—á—è –∑ –∑–∞–∫—Ä–∏—Ç–∏–º–∏ –æ—á–∏–º–∞, —â–æ —Ü—ñ–ª—É—î, –æ–±–ª–∏—á—á—è —ñ–∑ –∑–∞–∫—Ä–∏—Ç–∏–º–∏ –æ—á–∏–º–∞, —â–æ —Ü—ñ–ª—É—î, –æ—á—ñ, –ø–æ—Ü—ñ–ª—É–Ω–æ–∫
üôÇ	–æ–±–ª–∏—á—á—è, –ø–æ—Å–º—ñ—à–∫–∞, —Ç—Ä–æ—Ö–∏ –≤—Å–º—ñ—Ö–Ω–µ–Ω–µ –æ–±–ª–∏—á—á—è, —Ç—Ä–æ—Ö–∏ —É—Å–º—ñ—Ö–Ω–µ–Ω–µ –æ–±–ª–∏—á—á—è
ü§ó	–æ–±–ª–∏—á—á—è, –æ–±—ñ–π–º–∞—Ç–∏—Å—è, —â–∞—Å–ª–∏–≤–µ –æ–±–ª–∏—á—á—è –∑ —Ä—É–∫–∞–º–∏, —â–æ –æ–±—ñ–π–º–∞—é—Ç—å
ü§©	–∑—ñ—Ä–∫–∞, –æ–±–ª–∏—á—á—è, –æ—á—ñ, –æ—á—ñ-–∑—ñ—Ä–æ—á–∫–∏, –ø–æ—Å–º—ñ—à–∫–∞
ü§î	–æ–±–ª–∏—á—á—è, –æ–±–ª–∏—á—á—è –≤ —Ä–æ–∑–¥—É–º–∞—Ö
ü§®	–Ω–µ–¥–æ–≤—ñ—Ä–∞, –æ–±–ª–∏—á—á—è –∑ –ø—ñ–¥–Ω—è—Ç–∏–º–∏ –±—Ä–æ–≤–∞–º–∏, —Å–∫–µ–ø—Ç–∏—á–Ω–∏–π
üòë	–±–µ–∑ –µ–º–æ—Ü—ñ–π, –Ω–µ–≤–∏—Ä–∞–∑–Ω–∏–π, –æ–±–ª–∏—á—á—è, –æ–±–ª–∏—á—á—è –±–µ–∑ –µ–º–æ—Ü—ñ–π
üò∂	–±–µ–∑–∑–≤—É—á–Ω–æ, –æ–±–ª–∏—á—á—è, –æ–±–ª–∏—á—á—è –±–µ–∑ —Ä–æ—Ç–∞, —Ä–æ—Ç, —Ç–∏—Ö–æ
üôÑ	–∑–∞–∫–æ—á—É–≤–∞—Ç–∏, –æ–±–ª–∏—á—á—è, –æ–±–ª–∏—á—á—è —ñ–∑ –∑–∞–∫–æ—á–µ–Ω–∏–º–∏ –æ—á–∏–º–∞, –æ—á—ñ
üòè	–æ–±–ª–∏—á—á—è, —Å–∞–º–æ–≤–¥–æ–≤–æ–ª–µ–Ω–µ –æ–±–ª–∏—á—á—è
üò£	–∑–∞–≤–∑—è—Ç–µ –æ–±–ª–∏—á—á—è, –Ω–µ–≤—ñ–¥—Å—Ç—É–ø–Ω–µ –æ–±–ª–∏—á—á—è, –æ–±–ª–∏—á—á—è
üò•	c—É–º–Ω–µ, –∞–ª–µ –≤—Ç—ñ—à–µ–Ω–µ –æ–±–ª–∏—á—á—è, –æ–±–ª–∏—á—á—è, –ø–æ–ª–µ–≥—à–µ–Ω–Ω—è, —Ä–æ–∑—á–∞—Ä–æ–≤–∞–Ω–µ, –∞–ª–µ –∑–∞—Å–ø–æ–∫–æ—î–Ω–µ –æ–±–ª–∏—á—á—è, —Ä–æ–∑—á–∞—Ä—É–≤–∞–Ω–Ω—è, —Ñ—É—Ö
üòÆ	–≤—ñ–¥–∫—Ä–∏—Ç–∏–π, –∑–¥–∏–≤–æ–≤–∞–Ω–µ –æ–±–ª–∏—á—á—è –∑ –≤—ñ–¥–∫—Ä–∏—Ç–∏–º —Ä–æ—Ç–æ–º, –æ–±–ª–∏—á—á—è, –æ–±–ª–∏—á—á—è –∑ –≤—ñ–¥–∫—Ä–∏—Ç–∏–º —Ä–æ—Ç–æ–º, —Ä–æ—Ç, —Å–ø—ñ–≤—á—É—Ç—Ç—è
ü§ê	–±–ª–∏—Å–∫–∞–≤–∫–∞, –æ–±–ª–∏—á—á—è, –æ–±–ª–∏—á—á—è –∑ –∑–∞—Å—Ç—ñ–±–∫–æ—é –∑–∞–º—ñ—Å—Ç—å —Ä–æ—Ç–∞, –æ–±–ª–∏—á—á—è —ñ–∑ –∑–∞—Å—Ç—ñ–±–∫–æ—é –∑–∞–º—ñ—Å—Ç—å —Ä–æ—Ç–∞, —Ä–æ—Ç
üòØ	–≤—Ä–∞–∂–µ–Ω–∏–π, –∑–¥–∏–≤–æ–≤–∞–Ω–µ —ñ –∑–±–µ–Ω—Ç–µ–∂–µ–Ω–µ –æ–±–ª–∏—á—á—è –∑ –±—Ä–æ–≤–∞–º–∏, –∑–¥–∏–≤–æ–≤–∞–Ω–∏–π, –æ–±–ª–∏—á—á—è, –ø—Ä–∏–≥–æ–ª–æ–º—à–µ–Ω–∏–π
üò™	–∑–∞—Å–ø–∞–Ω–µ –æ–±–ª–∏—á—á—è, –æ–±–ª–∏—á—á—è, —Å–æ–Ω
üò´	–æ–±–ª–∏—á—á—è, —Å—Ç–æ–º–ª–µ–Ω–µ –æ–±–ª–∏—á—á—è, —Å—Ç–æ–º–ª–µ–Ω–∏–π
üò¥	–æ–±–ª–∏—á—á—è, –æ–±–ª–∏—á—á—è, —â–æ —Å–ø–∏—Ç—å
üòå	–∑–∞—Å–ø–æ–∫–æ—î–Ω–µ –æ–±–ª–∏—á—á—è, –æ–±–ª–∏—á—á—è
üòõ	–æ–±–ª–∏—á—á—è, –æ–±–ª–∏—á—á—è –∑ –≤–∏—Å—É–Ω—É—Ç–∏–º —è–∑–∏–∫–æ–º, —è–∑–∏–∫
üòú	–∂–∞—Ä—Ç, –æ–±–ª–∏—á—á—è, –æ–±–ª–∏—á—á—è –∑ –≤–∏—Å—É–Ω—É—Ç–∏–º —è–∑–∏–∫–æ–º, —â–æ –ø—ñ–¥–º–æ—Ä–≥—É—î, –æ–±–ª–∏—á—á—è, —â–æ –ø—ñ–¥–º–æ—Ä–≥—É—î —ñ –ø–æ–∫–∞–∑—É—î —è–∑–∏–∫–∞, –æ—á—ñ, –ø—ñ–¥–º–æ—Ä–≥—É–≤–∞–Ω–Ω—è, —è–∑–∏–∫
üòù	–∂–∞—Ö–ª–∏–≤–∏–π, –æ–±–ª–∏—á—á—è, –æ–±–ª–∏—á—á—è –∑ –≤–∏—Å—É–Ω—É—Ç–∏–º —è–∑–∏–∫–æ–º —ñ –∑–∞–ø–ª—é—â–µ–Ω–∏–º–∏ –æ—á–∏–º–∞, –æ—á—ñ, —Å–º–∞–∫, —è–∑–∏–∫
ü§§	–æ–±–ª–∏—á—á—è, –æ–±–ª–∏—á—á—è, —â–æ –ø—É—Å–∫–∞—î —Å–ª–∏–Ω—É, —Å–ª–∏–Ω–∞
üòí	–Ω–µ–≤–¥–æ–≤–æ–ª–µ–Ω–µ –æ–±–ª–∏—á—á—è, –Ω–µ–∑–∞–¥–æ–≤–æ–ª–µ–Ω–µ –æ–±–ª–∏—á—á—è, –Ω–µ–∑–∞–¥–æ–≤–æ–ª–µ–Ω–∏–π, –Ω–µ—â–∞—Å–ª–∏–≤–∏–π, –æ–±–ª–∏—á—á—è
üòì	–æ–±–ª–∏—á—á—è, –æ–±–ª–∏—á—á—è –∑ –∫—Ä–∞–ø–ª—è–º–∏ —Ö–æ–ª–æ–¥–Ω–æ–≥–æ –ø–æ—Ç—É, –ø–æ–Ω—É—Ä–µ–Ω–µ –æ–±–ª–∏—á—á—è –≤ –ø–æ—Ç—É, –ø—ñ—Ç, —Ö–æ–ª–æ–¥–Ω–∏–π
üòî	–∑–∞–¥—É–º–ª–∏–≤–∏–π, –∑–∞–º–∏—Å–ª–µ–Ω–µ –æ–±–ª–∏—á—á—è, –æ–±–ª–∏—á—á—è, —Ä–æ–∑–¥—É–º–∏, —Å—É–º–Ω–µ –∑–∞–º–∏—Å–ª–µ–Ω–µ –æ–±–ª–∏—á—á—è
üòï	–æ–±–ª–∏—á—á—è, —Å–ø–∞–Ω—Ç–µ–ª–∏—á–µ–Ω–µ –æ–±–ª–∏—á—á—è, —Å–ø–∞–Ω—Ç–µ–ª–∏—á–µ–Ω–∏–π
üôÉ	–¥–æ–≥–æ—Ä–∏ –Ω–æ–≥–∞–º–∏, –æ–±–ª–∏—á—á—è, –æ–±–ª–∏—á—á—è –¥–æ–≥–æ—Ä–∏ –¥–Ω–æ–º, –æ–±–ª–∏—á—á—è –¥–æ–≥–æ—Ä–∏ –¥—Ä–∏“ë–æ–º
ü§ë	–æ–±–ª–∏—á—á—è, –æ–±–ª–∏—á—á—è –∑ –≥—Ä—ñ—à–º–∏ –∑–∞–º—ñ—Å—Ç—å –æ—á–µ–π —Ç–∞ —è–∑–∏–∫–∞, —Ä–æ—Ç
üò≤	–≤—Ä–∞–∂–µ–Ω–µ –æ–±–ª–∏—á—á—è, –∑–¥–∏–≤–æ–≤–∞–Ω–∏–π, –æ–±–ª–∏—á—á—è, —à–æ–∫–æ–≤–∞–Ω–∏–π
üôÅ	–Ω–∞—Ö–º—É—Ä–µ–Ω–∏–π, –æ–±–ª–∏—á—á—è, —Å—É–º–Ω–∏–π, —Ç—Ä–æ—Ö–∏ –ø–æ—Ö–º—É—Ä–µ –æ–±–ª–∏—á—á—è
üòñ	–∑–±–µ–Ω—Ç–µ–∂–µ–Ω–µ –æ–±–ª–∏—á—á—è, –∑–±–µ–Ω—Ç–µ–∂–µ–Ω–∏–π, –æ–±–ª–∏—á—á—è
üòû	–æ–±–ª–∏—á—á—è, —Ä–æ–∑—á–∞—Ä–æ–≤–∞–Ω–µ –æ–±–ª–∏—á—á—è, —Ä–æ–∑—á–∞—Ä–æ–≤–∞–Ω–∏–π
üòü	–æ–±–ª–∏—á—á—è, —Å—Ç—É—Ä–±–æ–≤–∞–Ω–µ –æ–±–ª–∏—á—á—è, —Å—Ç—É—Ä–±–æ–≤–∞–Ω–∏–π
üò§	–≤–∏–≥—Ä–∞—à, –æ–±–ª–∏—á—á—è, –æ–±–ª–∏—á—á—è, —â–æ —Å–µ—Ä–¥–∏—Ç–æ –≤–∏–¥–∏—Ö–∞—î, —Ç—Ä—ñ—É–º—Ñ
üò¢	–æ–±–ª–∏—á—á—è, –æ–±–ª–∏—á—á—è, —â–æ –ø–ª–∞—á–µ, —Å–ª—å–æ–∑–∞, —Å—É–º–Ω–∏–π
üò≠	–æ–±–ª–∏—á—á—è, –æ–±–ª–∏—á—á—è, —â–æ –≥—É—á–Ω–æ —Ä–∏–¥–∞—î, –ø–ª–∞—á, —Ä–∏–¥–∞–Ω–Ω—è, —Å–ª—å–æ–∑–∞, —Å—É–º–Ω–∏–π
üò¶	–≤—ñ–¥–∫—Ä–∏—Ç–∏–π, –Ω–∞—Ö–º—É—Ä–µ–Ω–∏–π, –æ–±–ª–∏—á—á—è, –ø–æ—Ö–º—É—Ä–µ –æ–±–ª–∏—á—á—è –∑ –≤—ñ–¥–∫—Ä–∏—Ç–∏–º —Ä–æ—Ç–æ–º, —Ä–æ—Ç
üòß	–æ–±–ª–∏—á—á—è, —Å—Ç—Ä–∞–∂–¥–∞–Ω–Ω—è, —Å—Ç—Ä–∞–∂–¥–µ–Ω–Ω–µ –æ–±–ª–∏—á—á—è
üò®	–±–æ—è–∑–∫–∏–π, –Ω–∞–ª—è–∫–∞–Ω–µ –æ–±–ª–∏—á—á—è, –Ω–∞–ª—è–∫–∞–Ω–∏–π, –æ–±–ª–∏—á—á—è, —Å—Ç—Ä–∞—Ö
üò©	–≤—Ç–æ–º–ª–µ–Ω–µ –æ–±–ª–∏—á—á—è, –∑–∞–º—É—á–µ–Ω–µ –æ–±–ª–∏—á—á—è, –∑–º–æ—Ä–µ–Ω–∏–π, –æ–±–ª–∏—á—á—è, —Å—Ç–æ–º–ª–µ–Ω–∏–π
ü§Ø	–≥–æ–ª–æ–≤–∞, —â–æ –≤–∏–±—É—Ö–∞—î, —à–æ–∫–æ–≤–∞–Ω–∏–π
üò¨	–∫—Ä–∏–≤–ª—è–Ω–Ω—è, –æ–±–ª–∏—á—á—è, –æ–±–ª–∏—á—á—è –∑ –≥—Ä–∏–º–∞—Å–æ—é, —Å–∫—Ä–∏–≤–ª–µ–Ω–µ –æ–±–ª–∏—á—á—è
üò∞	–≤—ñ–¥–∫—Ä–∏—Ç–∏–π, –∑–∞–Ω–µ–ø–æ–∫–æ—î–Ω–µ –æ–±–ª–∏—á—á—è –∑ –ø–æ—Ç–æ–º, –æ–±–ª–∏—á—á—è, –æ–±–ª–∏—á—á—è —É —Ö–æ–ª–æ–¥–Ω–æ–º—É –ø–æ—Ç—É –∑ –≤—ñ–¥–∫—Ä–∏—Ç–∏–º —Ä–æ—Ç–æ–º, –ø—ñ—Ç, —Ä–æ—Ç, —Å–∏–Ω—ñ–π, —Ö–æ–ª–æ–¥–Ω–æ
üò±	–±–æ—è–∑–∫–∏–π, –∫—Ä–∏–∫, –Ω–∞–ª—è–∫–∞–Ω–∏–π, –æ–±–ª–∏—á—á—è, –æ–±–ª–∏—á—á—è, —â–æ –∫—Ä–∏—á–∏—Ç—å —ñ–∑ –ø–µ—Ä–µ–ª—è–∫—É, —Å—Ç—Ä–∞—Ö
ü•µ	–≥–∞—Ä—è—á–µ, –∂–∞—Ä, –ø–∞–ª–∞—Ç–∏, —Ä–æ–∑–ø–∞—à—ñ–ª–µ –æ–±–ª–∏—á—á—è, —Å–æ–Ω—è—á–Ω–∏–π —É–¥–∞—Ä, —Å–ø–µ–∫–∞, —á–µ—Ä–≤–æ–Ω–µ –ª–∏—Ü–µ
ü•∂	–±—É—Ä—É–ª—å–∫–∞, –∑–∞–º–µ—Ä–∑–ª–µ –æ–±–ª–∏—á—á—è, –∑—É–± –Ω–∞ –∑—É–±, –º–æ—Ä–æ–∑, —Å–∏–Ω—î –ª–∏—Ü–µ, —Ö–æ–ª–æ–¥
üò≥	–∑–∞—à–∞—Ä—ñ–ª–µ –æ–±–ª–∏—á—á—è, –æ–±–ª–∏—á—á—è, –æ–±–ª–∏—á—á—è —ñ–∑ —à–∏—Ä–æ–∫–æ –≤—ñ–¥–∫—Ä–∏—Ç–∏–º–∏ –æ—á–∏–º–∞ —Ç–∞ –∑–∞—à–∞—Ä—ñ–ª–∏–º–∏ —â–æ–∫–∞–º–∏, –ø—Ä–∏—Å–æ—Ä–æ–º–ª–µ–Ω–∏–π
ü§™	–±–æ–∂–µ–≤—ñ–ª—å–Ω–µ –æ–±–ª–∏—á—á—è, –≤–µ–ª–∏–∫–∏–π, –º–∞–ª–∏–π, –æ–∫–æ
üòµ	–∑–∞–ø–∞–º–æ—Ä–æ—á–µ–Ω–µ –æ–±–ª–∏—á—á—è, –∑–∞–ø–∞–º–æ—Ä–æ—á–µ–Ω–∏–π, –æ–±–ª–∏—á—á—è
üò°	–≥–Ω—ñ–≤, –∑–ª–∏–π, –Ω–µ–≤–¥–æ–≤–æ–ª–µ–Ω–∏–π, –æ–±–ª–∏—á—á—è, –æ–±–ª–∏—á—á—è, —â–æ –¥—É—î—Ç—å—Å—è, —Å–µ—Ä–¥–∏—Ç–∏–π, —á–µ—Ä–≤–æ–Ω–∏–π
üò†	–∑–ª–∏–π, –æ–±–ª–∏—á—á—è, —Å–µ—Ä–¥–∏—Ç–µ –æ–±–ª–∏—á—á—è, —Å–µ—Ä–¥–∏—Ç–∏–π
ü§¨	–æ–±–ª–∏—á—á—è —ñ–∑ —Å–∏–º–≤–æ–ª–∞–º–∏ –≤ —Ä–æ—Ç—ñ, –ø—ñ—Ç–Ω—ñ—î
üò∑	–ª—ñ–∫–∞—Ä, –º–∞—Å–∫–∞, –º–µ–¥–∏—Ü–∏–Ω–∞, –æ–±–ª–∏—á—á—è –≤ –º–µ–¥–∏—á–Ω—ñ–π –º–∞—Å—Ü—ñ, —Ö–≤–æ—Ä–∏–π, —Ö–æ–ª–æ–¥–Ω–∏–π
ü§í	–æ–±–ª–∏—á—á—è, –æ–±–ª–∏—á—á—è –∑ —Ç–µ—Ä–º–æ–º–µ—Ç—Ä–æ–º, —Ç–µ—Ä–º–æ–º–µ—Ç—Ä, —Ö–≤–æ—Ä–∏–π
ü§ï	–æ–±–ª–∏—á—á—è, –æ–±–ª–∏—á—á—è –∑ –≥–æ–ª–æ–≤–Ω–æ—é –ø–æ–≤ º—è–∑–∫–æ—é, –ø–æ–≤‚Äô—è–∑–∫–∞, –ø–æ—Ä–∞–Ω–µ–Ω–∏–π, —Ä–∞–Ω–∞
ü§¢	–±–ª—é–≤–æ—Ç–∞, –Ω—É–¥–æ—Ç–∞, –æ–±–ª–∏—á—á—è, –æ–±–ª–∏—á—á—è, —è–∫–µ –Ω—É–¥–∏—Ç—å
ü§Æ	–±–ª—é–≤–æ—Ç–∞, –Ω—É–¥–æ—Ç–∞, –æ–±–ª–∏—á—á—è, —â–æ –±–ª—é—î
ü§ß	–∞–ø—á—Ö–∏, –æ–±–ª–∏—á—á—è, –æ–±–ª–∏—á—á—è, —â–æ —á—Ö–∞—î, —Ö–≤–æ—Ä–æ–±–∞, —á—Ö–∞–Ω–Ω—è
üòá	–∞–Ω–≥–µ–ª, –±–µ–∑–Ω–µ–≤–∏–Ω–Ω—ñ—Å—Ç—å, –∫–∞–∑–∫–∞, –Ω—ñ–º–±, –æ–±–ª–∏—á—á—è, –ø–æ—Å–º—ñ—à–∫–∞, —É—Å–º—ñ—Ö–Ω–µ–Ω–µ –æ–±–ª–∏—á—á—è –∑ –Ω—ñ–º–±–æ–º, —Ñ–∞–Ω—Ç–∞–∑—ñ—è
ü§†	–∫–∞–ø–µ–ª—é—Ö, –∫–æ–≤–±–æ–π, –æ–±–ª–∏—á—á—è, –æ–±–ª–∏—á—á—è —É –∫–æ–≤–±–æ–π—Å—å–∫–æ–º—É –∫–∞–ø–µ–ª—é—Å—ñ, —à–∏—Ä–æ–∫–æ —É—Å–º—ñ—Ö–Ω–µ–Ω–µ –æ–±–ª–∏—á—á—è —É –∫–æ–≤–±–æ–π—Å—å–∫–æ–º—É –∫–∞–ø–µ–ª—é—Å—ñ
ü•≥	–≤–µ—á—ñ—Ä–∫–∞, –¥—É–¥–∫–∞, –∫–æ–≤–ø–∞–∫, —Å–≤—è—Ç–∫–æ–≤–µ –æ–±–ª–∏—á—á—è, —Å–≤—è—Ç–∫—É–≤–∞–Ω–Ω—è
ü•¥	–∑–∞–ø–∞–º–æ—Ä–æ—á–µ–Ω–∏–π, –∫—Ä–∏–≤—É–ª—è—Å—Ç–∏–π —Ä–æ—Ç, –æ–¥—É—Ä–º–∞–Ω–µ–Ω–∏–π, –æ—á–º–∞–Ω—ñ–ª–µ –æ–±–ª–∏—á—á—è, –æ—à–∞–ª—ñ–ª–∏–π, –ø–µ—Ä–µ–∫–æ—à–µ–Ω—ñ –æ—á—ñ
ü•∫	–±–ª–∞–≥–∞–ª—å–Ω–µ –æ–±–ª–∏—á—á—è, –±–ª–∞–≥–∞—Ç–∏, –≤–∏–ø—Ä–æ—à—É–≤–∞—Ç–∏, –º–æ–ª–∏—Ç–∏, –ø—Ä–æ—Å–∏—Ç–∏
ü§•	–±—Ä–µ—Ö–Ω—è, –æ–±–ª–∏—á—á—è, –æ–±–ª–∏—á—á—è, —â–æ –±—Ä–µ—à–µ, –ø—ñ–Ω–æ–∫–∫—ñ–æ
ü§´	–æ–±–ª–∏—á—á—è, —â–æ —Ü–∏–∫–∞—î, —Ç–∏—Ö–æ, —Ç—Å—Å—Å
ü§≠	–æ–±–ª–∏—á—á—è, —â–æ –ø—Ä–∏–∫—Ä–∏–≤–∞—î —Ä–æ—Ç–∞ —Ä—É–∫–æ—é, –æ–π
üßê	–æ–±–ª–∏—á—á—è –≤ –º–æ–Ω–æ–∫–ª—ñ, –æ–±–ª–∏—á—á—è –∑ –º–æ–Ω–æ–∫–ª–µ–º, –ø–∞–Ω–æ–≤–∏—Ç–∏–π
ü§ì	–¥–æ–π–¥–∞, –¥–æ–∫–∞, –æ–±–ª–∏—á—á—è, –æ–±–ª–∏—á—á—è –≤—Å–µ–∑–Ω–∞–π–∫–∞, –æ–±–ª–∏—á—á—è –∑–∞—É—á–∫–∏, —É–Ω—ñ–∫—É–º
üòà	–∫–∞–∑–∫–∞, –æ–±–ª–∏—á—á—è, –ø–æ—Å–º—ñ—à–∫–∞, —Ä—ñ–∂–∫–∏, —É—Å–º—ñ—Ö–Ω–µ–Ω–µ –æ–±–ª–∏—á—á—è –∑ —Ä–æ–≥–∞–º–∏, —Ñ–∞–Ω—Ç–∞–∑—ñ—è
üëø	–¥–µ–º–æ–Ω, –¥–∏—è–≤–æ–ª, –∫–∞–∑–∫–∞, –æ–±–ª–∏—á—á—è, —Å–µ—Ä–¥–∏—Ç–µ –æ–±–ª–∏—á—á—è –∑ —Ä–æ–≥–∞–º–∏, —Ñ–∞–Ω—Ç–∞–∑—ñ—è
ü§°	–∫–ª–æ—É–Ω, –æ–±–ª–∏—á—á—è, –æ–±–ª–∏—á—á—è –∫–ª–æ—É–Ω–∞
üëπ	–≤–µ–ª–µ—Ç–µ–Ω—å-–ª—é–¥–æ–∂–µ—Ä, –∫–∞–∑–∫–∞, –º–æ–Ω—Å—Ç—Ä, –æ–±–ª–∏—á—á—è, —Å—Ç–≤–æ—Ä—ñ–Ω–Ω—è, —Ñ–∞–Ω—Ç–∞–∑—ñ—è, —è–ø–æ–Ω—Å—å–∫–∏–π
üë∫	–≥–æ–±–ª—ñ–Ω, –∫–∞–∑–∫–∞, –º–æ–Ω—Å—Ç—Ä, –æ–±–ª–∏—á—á—è, —Å—Ç–≤–æ—Ä—ñ–Ω–Ω—è, —Ñ–∞–Ω—Ç–∞–∑—ñ—è, —è–ø–æ–Ω—Å—å–∫–∏–π
üíÄ	–∫–∞–∑–∫–∞, –º–æ–Ω—Å—Ç—Ä, –æ–±–ª–∏—á—á—è, —Å–º–µ—Ä—Ç—å, —Ç—ñ–ª–æ, —á–µ—Ä–µ–ø
üëª	–∫–∞–∑–∫–∞, –º–æ–Ω—Å—Ç—Ä, –æ–±–ª–∏—á—á—è, –ø—Ä–∏–≤–∏–¥, —Å—Ç–≤–æ—Ä—ñ–Ω–Ω—è, —Ñ–∞–Ω—Ç–∞–∑—ñ—è
üëæ	–∫–∞–∑–∫–∞, –∫–æ—Å–º–æ—Å, –º–æ–Ω—Å—Ç—Ä, –Ω–ª–æ, –æ–±–ª–∏—á—á—è, –ø–æ–∑–∞–∑–µ–º–Ω–∏–π, –ø—Ä–∏–±—É–ª–µ—Ü—å, —Å—Ç–≤–æ—Ä—ñ–Ω–Ω—è, —Ñ–∞–Ω—Ç–∞–∑—ñ—è, —ñ–Ω—à–æ–ø–ª–∞–Ω–µ—Ç–Ω–∏–π –º–æ–Ω—Å—Ç—Ä
ü§ñ	–º–æ–Ω—Å—Ç—Ä, –æ–±–ª–∏—á—á—è, –æ–±–ª–∏—á—á—è —Ä–æ–±–æ—Ç–∞
üí©	–µ–∫—Å–∫—Ä–µ–º–µ–Ω—Ç–∏, –∂–∞—Ä—Ç, –∫–∞–∫–∞, —É—Å—ñ—Ö–Ω–µ–Ω–∞ –∫—É–ø–∞ –ª–∞–π–Ω–∞
üò∫	–≤—ñ–¥–∫—Ä–∏—Ç–∏–π, –∫—ñ—Ç, –æ–±–ª–∏—á—á—è, –ø–æ—Å–º—ñ—à–∫–∞, —Ä–æ—Ç, —à–∏—Ä–æ–∫–æ –≤—Å–º—ñ—Ö–Ω–µ–Ω–∞ –∫–æ—Ç—è—á–∞ –º–æ—Ä–¥–∞, —à–∏—Ä–æ–∫–æ —É—Å–º—ñ—Ö–Ω–µ–Ω–∞ –∫–æ—Ç—è—á–∞ –º–æ—Ä–¥–∞
üò∏	–∫—ñ—Ç, –æ–±–ª–∏—á—á—è, –æ—á—ñ, —É—Å–º—ñ—à–∫–∞, —à–∏—Ä–æ–∫–æ —É—Å–º—ñ—Ö–Ω–µ–Ω–∞ –∫–æ—Ç—è—á–∞ –º–æ—Ä–¥–∞ –∑ —É—Å–º—ñ—Ö–Ω–µ–Ω–∏–º–∏ –æ—á–∏–º–∞
üòπ	–∫–æ—Ç—è—á–∞ –º–æ—Ä–¥–∞, —â–æ –ø–ª–∞—á–µ –≤—ñ–¥ —Å–º—ñ—Ö—É, –∫—ñ—Ç, –æ–±–ª–∏—á—á—è, —Ä–∞–¥—ñ—Å—Ç—å, —Å–ª—å–æ–∑–∞
üòª	–∫–æ—Ö–∞–Ω–Ω—è, –∫—ñ—Ç, –æ–±–ª–∏—á—á—è, –æ—á—ñ, –ø–æ—Å–º—ñ—à–∫–∞, —Å–µ—Ä—Ü–µ, —É—Å–º—ñ—Ö–Ω–µ–Ω–∞ –∫–æ—Ç—è—á–∞ –º–æ—Ä–¥–∞ –∑ –æ—á–∏–º–∞ —É —Ñ–æ—Ä–º—ñ —Å–µ—Ä—Ü—è, —É—Å–º—ñ—Ö–Ω–µ–Ω–∞ –º–æ—Ä–¥–∞ –∫–æ—Ç–∞ –∑ –æ—á–∏–º–∞-—Å–µ—Ä—Ü—è–º–∏
üòº	–∫—Ä–∏–≤–∏–π, –∫—ñ—Ç, –æ–±–ª–∏—á—á—è, –ø–æ—Å–º—ñ—à–∫–∞, —Å–∞–º–æ–≤–¥–æ–≤–æ–ª–µ–Ω–∞ –∫–æ—Ç—è—á–∞ –º–æ—Ä–¥–∞, —ñ—Ä–æ–Ω—ñ—á–Ω–∏–π
üòΩ	–∑–∞–∫—Ä–∏—Ç—ñ, –∫–æ—Ç—è—á–∞ –º–æ—Ä–¥–∞, —â–æ —Ü—ñ–ª—É—î, –∫—ñ—Ç, –æ–±–ª–∏—á—á—è, –æ—á—ñ, –ø–æ—Ü—ñ–ª—É–Ω–æ–∫
üôÄ	–≤–∏—Å–Ω–∞–∂–µ–Ω–∏–π, –∑–¥–∏–≤—É–≤–∞–Ω–Ω—è, –∫–æ—Ç—è—á–∞ –º–æ—Ä–¥–∞, —â–æ –∫—Ä–∏—á–∏—Ç—å —ñ–∑ –ø–µ—Ä–µ–ª—è–∫—É, –∫—ñ—Ç, –æ–±–ª–∏—á—á—è, –æ—É
üòø	–∫–æ—Ç—è—á–∞ –º–æ—Ä–¥–∞, —â–æ –ø–ª–∞—á–µ, –∫—ñ—Ç, –æ–±–ª–∏—á—á—è, –ø–ª–∞—á, —Å–ª—å–æ–∑–∞, —Å—É–º–Ω–∏–π
üòæ	–∫—ñ—Ç, –Ω–∞—Å—É–ø–ª–µ–Ω–∏–π, –Ω–µ–≤–¥–æ–≤–æ–ª–µ–Ω–∞ –∫–æ—Ç—è—á–∞ –º–æ—Ä–¥–∞, –æ–±–ª–∏—á—á—è
üôà	–±–∞—á–∏—Ç–∏, –±–∞—á—É, –∂–µ—Å—Ç, –∑–∞–±–æ—Ä–æ–Ω–µ–Ω–æ, –∑–ª–æ, –º–∞–≤–ø–∞, –º–∞–≤–ø–∞, —â–æ –Ω–µ –±–∞—á–∏—Ç—å, –Ω–µ, –Ω—ñ, –æ–±–ª–∏—á—á—è
üôâ	–∂–µ—Å—Ç, –∑–∞–±–æ—Ä–æ–Ω–µ–Ω–æ, –∑–ª–æ, –º–∞–≤–ø–∞, –º–∞–≤–ø–∞, —â–æ –Ω–µ —á—É—î, –Ω–µ, –Ω—ñ, –æ–±–ª–∏—á—á—è, —á—É—Ç–∏, —á—É—é
üôä	–≥–æ–≤–æ—Ä–∏—Ç–∏, –≥–æ–≤–æ—Ä—é, –∂–µ—Å—Ç, –∑–∞–±–æ—Ä–æ–Ω–µ–Ω–æ, –∑–ª–æ, –º–∞–≤–ø–∞, –º–∞–≤–ø–∞, —â–æ –Ω–µ –≥–æ–≤–æ—Ä–∏—Ç—å, –Ω–µ, –Ω—ñ, –æ–±–ª–∏—á—á—è
üë∂	–¥–∏—Ç–∏–Ω–∞, –Ω–µ–º–æ–≤–ª—è
üßí	–≥–µ–Ω–¥–µ—Ä–Ω–æ-–Ω–µ–π—Ç—Ä–∞–ª—å–Ω–∏–π, –¥–∏—Ç–∏–Ω–∞, –º–∞–ª–µ—á–∞, –Ω–µ–æ–∑–Ω–∞—á–µ–Ω–æ—ó —Å—Ç–∞—Ç—ñ
üë¶	–º–∞–ª–µ—á–∞, —Ö–ª–æ–ø–µ—Ü—å, —Ö–ª–æ–ø—á–∏–∫
üëß	–¥—ñ–≤–∞, –¥—ñ–≤—á–∏–Ω–∞, –¥—ñ–≤—á–∏–Ω–∫–∞, –∑–æ–¥—ñ–∞–∫
üßë	–≥–µ–Ω–¥–µ—Ä–Ω–æ-–Ω–µ–π—Ç—Ä–∞–ª—å–Ω–∏–π, –¥–æ—Ä–æ—Å–ª–∏–π, –ª—é–¥–∏–Ω–∞, –Ω–µ–æ–∑–Ω–∞—á–µ–Ω–æ—ó —Å—Ç–∞—Ç—ñ
üë±	–±—ñ–ª—è–≤–∏–π, –ª—é–¥–∏–Ω–∞ –∑ –±—ñ–ª—è–≤–∏–º –≤–æ–ª–æ—Å—Å—è–º, –ª—é–¥–∏–Ω–∞ –∑—ñ —Å–≤—ñ—Ç–ª–∏–º –≤–æ–ª–æ—Å—Å—è–º, –ª—é–¥–∏–Ω–∞: –±—ñ–ª—è–≤–µ –≤–æ–ª–æ—Å—Å—è
üë®	–¥–æ—Ä–æ—Å–ª–∏–π, —á–æ–ª–æ–≤—ñ–∫
üë±‚Äç‚ôÇ	–±–ª–æ–Ω–¥–∏–Ω, –±—ñ–ª—è–≤–∏–π, —á–æ–ª–æ–≤—ñ–∫, —á–æ–ª–æ–≤—ñ–∫ —ñ–∑ –±—ñ–ª—è–≤–∏–º –≤–æ–ª–æ—Å—Å—è–º, —á–æ–ª–æ–≤—ñ–∫: –±—ñ–ª—è–≤–µ –≤–æ–ª–æ—Å—Å—è
üßî	–±–æ—Ä–æ–¥–∞, –ª—é–¥–∏–Ω–∞, –ª—é–¥–∏–Ω–∞ –∑ –±–æ—Ä–æ–¥–æ—é, —á–æ–ª–æ–≤—ñ–∫: –±–æ—Ä–æ–¥–∞
üë©	–¥–æ—Ä–æ—Å–ª–∞, –∂—ñ–Ω–∫–∞
üë±‚Äç‚ôÄ	–±–ª–æ–Ω–¥–∏–Ω–∫–∞, –±—ñ–ª—è–≤–∫–∞, –∂—ñ–Ω–∫–∞, –∂—ñ–Ω–∫–∞ –∑ –±—ñ–ª—è–≤–∏–º –≤–æ–ª–æ—Å—Å—è–º, –∂—ñ–Ω–∫–∞: –±—ñ–ª—è–≤–µ –≤–æ–ª–æ—Å—Å—è
üßì	–≥–µ–Ω–¥–µ—Ä–Ω–æ-–Ω–µ–π—Ç—Ä–∞–ª—å–Ω–∏–π, –¥–æ—Ä–æ—Å–ª–∏–π, –ª—é–¥–∏–Ω–∞ –ø–æ—Ö–∏–ª–æ–≥–æ –≤—ñ–∫—É, –ª—ñ—Ç–Ω—è –ª—é–¥–∏–Ω–∞, –Ω–µ–æ–∑–Ω–∞—á–µ–Ω–æ—ó —Å—Ç–∞—Ç—ñ, —Å—Ç–∞—Ä–∏–π, —Å—Ç–∞—Ä—à–∞ –ª—é–¥–∏–Ω–∞
üë¥	–¥–æ—Ä–æ—Å–ª–∏–π, —Å—Ç–∞—Ä–∏–π, —Å—Ç–∞—Ä–∏–π —á–æ–ª–æ–≤—ñ–∫, —á–æ–ª–æ–≤—ñ–∫
üëµ	–¥–æ—Ä–æ—Å–ª–∞, –∂—ñ–Ω–∫–∞, —Å—Ç–∞—Ä–∞, —Å—Ç–∞—Ä–∞ –∂—ñ–Ω–∫–∞
üë®‚Äç‚öï	–ª—ñ–∫–∞—Ä, –º–µ–¥–±—Ä–∞—Ç, –º–µ–¥–∏–∫, –º–µ–¥–∏—á–Ω–∏–π –ø—Ä–∞—Ü—ñ–≤–Ω–∏–∫, –æ—Ö–æ—Ä–æ–Ω–∞ –∑–¥–æ—Ä–æ–≤ º—è, —á–æ–ª–æ–≤—ñ–∫
üë©‚Äç‚öï	–∂—ñ–Ω–∫–∞, –ª—ñ–∫–∞—Ä, –º–µ–¥–∏–∫, –º–µ–¥–∏—á–Ω–∞ –ø—Ä–∞—Ü—ñ–≤–Ω–∏—Ü—è, –º–µ–¥—Å–µ—Å—Ç—Ä–∞, –æ—Ö–æ—Ä–æ–Ω–∞ –∑–¥–æ—Ä–æ–≤ º—è
üë®‚Äçüéì	–∞–±—ñ—Ç—É—Ä—ñ—î–Ω—Ç, –≤–∏–ø—É—Å–∫–Ω–∏–∫, —Å—Ç—É–¥–µ–Ω—Ç, —á–æ–ª–æ–≤—ñ–∫
üë©‚Äçüéì	–∞–±—ñ—Ç—É—Ä—ñ—î–Ω—Ç–∫–∞, –≤–∏–ø—É—Å–∫–Ω–∏—Ü—è, –∂—ñ–Ω–∫–∞, —Å—Ç—É–¥–µ–Ω—Ç–∫–∞
üë®‚Äçüè´	–≤–∏–∫–ª–∞–¥–∞—á, –≤—á–∏—Ç–µ–ª—å, –ø—Ä–æ—Ñ–µ—Å–æ—Ä, —É—á–∏—Ç–µ–ª—å, —á–æ–ª–æ–≤—ñ–∫, —ñ–Ω—Å—Ç—Ä—É–∫—Ç–æ—Ä
üë©‚Äçüè´	–≤–∏–∫–ª–∞–¥–∞—á–∫–∞, –≤—á–∏—Ç–µ–ª—å–∫–∞, –∂—ñ–Ω–∫–∞, –ø—Ä–æ—Ñ–µ—Å–æ—Ä, —É—á–∏—Ç–µ–ª—å–∫–∞, —ñ–Ω—Å—Ç—Ä—É–∫—Ç–æ—Ä
üë®‚Äç‚öñ	–ø—Ä–∞–≤–æ—Å—É–¥–¥—è, —Å—É–¥–¥—è, —Ç–µ—Ä–µ–∑–∏, —á–æ–ª–æ–≤—ñ–∫
üë©‚Äç‚öñ	–∂—ñ–Ω–∫–∞, –∂—ñ–Ω–∫–∞-—Å—É–¥–¥—è, —Å—É–¥–¥—è, —Ç–µ—Ä–µ–∑–∏ –ø—Ä–∞–≤–æ—Å—É–¥–¥—è
üë®‚Äçüåæ	–≥–æ—Å–ø–æ–¥–∞—Ä, —Å–∞–¥—ñ–≤–Ω–∏–∫, —Ñ–µ—Ä–º–µ—Ä, —á–æ–ª–æ–≤—ñ–∫
üë©‚Äçüåæ	–≥–æ—Å–ø–æ–¥–∞—Ä–∫–∞, –∂—ñ–Ω–∫–∞, —Å–∞–¥—ñ–≤–Ω–∏—Ü—è, —Ñ–µ—Ä–º–µ—Ä–∫–∞
üë®‚Äçüç≥	–∫—É–ª—ñ–Ω–∞—Ä, –∫—É—Ö–∞—Ä, —á–æ–ª–æ–≤—ñ–∫, —à–µ—Ñ-–∫—É—Ö–∞—Ä
üë©‚Äçüç≥	–∂—ñ–Ω–∫–∞, –∫—É–ª—ñ–Ω–∞—Ä–∫–∞, –∫—É—Ö–∞—Ä–∫–∞, —à–µ—Ñ-–∫—É—Ö–∞—Ä–∫–∞
üë®‚Äçüîß	–≤–æ–¥–æ–ø—Ä–æ–≤—ñ–¥–Ω–∏–∫, –µ–ª–µ–∫—Ç—Ä–∏–∫, –µ–ª–µ–∫—Ç—Ä–æ—Ç–µ—Ö–Ω—ñ–∫, –º–µ—Ö–∞–Ω—ñ–∫, —Ñ–∞—Ö—ñ–≤–µ—Ü—å, —á–æ–ª–æ–≤—ñ–∫
üë©‚Äçüîß	–∂—ñ–Ω–∫–∞-–µ–ª–µ–∫—Ç—Ä–æ—Ç–µ—Ö–Ω—ñ–∫, –∂—ñ–Ω–∫–∞-–º–µ—Ö–∞–Ω—ñ–∫, –∂—ñ–Ω–∫–∞-—Å–∞–Ω—Ç–µ—Ö–Ω—ñ–∫, –∂—ñ–Ω–∫–∞-—Ñ–∞—Ö—ñ–≤–µ—Ü—å, –º–∞–π—Å—Ç—Ä–∏–Ω—è
üë®‚Äçüè≠	–∫–æ–Ω–≤–µ—î—Ä, –ø—Ä–æ–º–∏—Å–ª–æ–≤–∏–π, —Ä–æ–±—ñ—Ç–Ω–∏–∫, —Ç—Ä—É–¥—ñ–≤–Ω–∏–∫, —Ñ–∞–±—Ä–∏–∫–∞, —á–æ–ª–æ–≤—ñ–∫
üë©‚Äçüè≠	–∂—ñ–Ω–∫–∞, –∫–æ–Ω–≤–µ—î—Ä, –ø—Ä–æ–º–∏—Å–ª–æ–≤–∏–π, —Ä–æ–±—ñ—Ç–Ω–∏—Ü—è, —Ç—Ä—É–¥—ñ–≤–Ω–∏—Ü—è, —Ñ–∞–±—Ä–∏–∫–∞
üë®‚Äçüíº	–º–µ–Ω–µ–¥–∂–µ—Ä, –æ—Ñ—ñ—Å, –æ—Ñ—ñ—Å–Ω–∏–π –ø—Ä–∞—Ü—ñ–≤–Ω–∏–∫, —Å–ª—É–∂–±–æ–≤–µ—Ü—å, —á–æ–ª–æ–≤—ñ–∫
üë©‚Äçüíº	–∂—ñ–Ω–∫–∞, –º–µ–Ω–µ–¥–∂–µ—Ä, –æ—Ñ—ñ—Å, –æ—Ñ—ñ—Å–Ω–∞ –ø—Ä–∞—Ü—ñ–≤–Ω–∏—Ü—è, —Å–ª—É–∂–±–æ–≤–∫–∞
üë®‚Äçüî¨	–±—ñ–æ–ª–æ–≥, –Ω–∞—É–∫–æ–≤–µ—Ü—å, –Ω–∞—É–∫–æ–≤–∏–π –¥—ñ—è—á, —Ñ—ñ–∑–∏–∫, —Ö—ñ–º—ñ–∫, —á–æ–ª–æ–≤—ñ–∫, —ñ–Ω–∂–µ–Ω–µ—Ä
üë©‚Äçüî¨	–∂—ñ–Ω–∫–∞, –∂—ñ–Ω–∫–∞-–±—ñ–æ–ª–æ–≥, –∂—ñ–Ω–∫–∞-–Ω–∞—É–∫–æ–≤–µ—Ü—å, –∂—ñ–Ω–∫–∞-—Ñ—ñ–∑–∏–∫, –∂—ñ–Ω–∫–∞-—Ö—ñ–º—ñ–∫, –∂—ñ–Ω–∫–∞-—ñ–Ω–∂–µ–Ω–µ—Ä, –Ω–∞—É–∫–æ–≤–µ—Ü—å
üë®‚Äçüíª	–≤–∏–Ω–∞—Ö—ñ–¥–Ω–∏–∫, –∫–æ–¥—É–≤–∞–ª—å–Ω–∏–∫, —Ä–æ–∑—Ä–æ–±–Ω–∏–∫, —Ç–µ—Ö–Ω–æ–ª–æ–≥, —Ç–µ—Ö–Ω—ñ–∫-–ø—Ä–æ–≥—Ä–∞–º—ñ—Å—Ç, —á–æ–ª–æ–≤—ñ–∫
üë©‚Äçüíª	–≤–∏–Ω–∞—Ö—ñ–¥–Ω–∏—Ü—è, –∂—ñ–Ω–∫–∞, –∂—ñ–Ω–∫–∞-—Ç–µ—Ö–Ω–æ–ª–æ–≥, –∫–æ–¥—É–≤–∞–ª—å–Ω–∏—Ü—è, —Ç–µ—Ö–Ω—ñ–∫-–ø—Ä–æ–≥—Ä–∞–º—ñ—Å—Ç
üë®‚Äçüé§	–∞—Ä—Ç–∏—Å—Ç, –≤–∏–∫–æ–Ω–∞–≤–µ—Ü—å, –ø—ñ—Å–Ω—è—Ä, —Å–æ–ª—ñ—Å—Ç, —Å–ø—ñ–≤–∞–∫, —á–æ–ª–æ–≤—ñ–∫
üë©‚Äçüé§	–∞—Ä—Ç–∏—Å—Ç–∫–∞, –≤–∏–∫–æ–Ω–∞–≤–∏—Ü—è, –∑—ñ—Ä–∫–∞, —Å–æ–ª—ñ—Å—Ç–∫–∞, —Å–ø—ñ–≤–∞—á–∫–∞
üë®‚Äçüé®	–∂–∏–≤–æ–ø–∏—Å–µ—Ü—å, –º–∞–ª—è—Ä, –º–∏—Ç–µ—Ü—å, –ø–∞–ª—ñ—Ç—Ä–∞, —Ö—É–¥–æ–∂–Ω–∏–∫
üë©‚Äçüé®	–∂—ñ–Ω–∫–∞-–º–∏—Ç–µ—Ü—å, –º–∞–ª—è—Ä–∫–∞, –ø–∞–ª—ñ—Ç—Ä–∞, —Ö—É–¥–æ–∂–Ω–∏—Ü—è
üë®‚Äç‚úà	–∞–≤—ñ–∞—Ç–æ—Ä, –ª—å–æ—Ç—á–∏–∫, –ª—ñ—Ç–∞–∫, –ø—ñ–ª–æ—Ç, —á–æ–ª–æ–≤—ñ–∫
üë©‚Äç‚úà	–∂—ñ–Ω–∫–∞-–∞–≤—ñ–∞—Ç–æ—Ä, –∂—ñ–Ω–∫–∞-–ø—ñ–ª–æ—Ç, –ª—å–æ—Ç—á–∏—Ü—è, –ª—ñ—Ç–∞–∫, –ø—ñ–ª–æ—Ç
üë®‚ÄçüöÄ	–∞—Å—Ç—Ä–æ–Ω–∞–≤—Ç, –∫–æ—Å–º–æ–Ω–∞–≤—Ç, –∫–æ—Å–º–æ—Å, —Ä–∞–∫–µ—Ç–∞, —á–æ–ª–æ–≤—ñ–∫
üë©‚ÄçüöÄ	–∞—Å—Ç—Ä–æ–Ω–∞–≤—Ç–∫–∞, –∂—ñ–Ω–∫–∞, –∫–æ—Å–º–æ–Ω–∞–≤—Ç–∫–∞, —Ä–∞–∫–µ—Ç–∞
üë®‚Äçüöí	–≤–æ–≥–Ω–µ–±–æ—Ä–µ—Ü—å, –ø–æ–∂–µ–∂–Ω–∏–π –∞–≤—Ç–æ–º–æ–±—ñ–ª—å, –ø–æ–∂–µ–∂–Ω–∏–∫, —á–æ–ª–æ–≤—ñ–∫
üë©‚Äçüöí	–∂—ñ–Ω–∫–∞, –∂—ñ–Ω–∫–∞-–≤–æ–≥–Ω–µ–±–æ—Ä–µ—Ü—å, –∂—ñ–Ω–∫–∞-–ø–æ–∂–µ–∂–Ω–∏–∫, –ø–æ–∂–µ–∂–Ω–∏–π –∞–≤—Ç–æ–º–æ–±—ñ–ª—å
üëÆ	–∫–æ–ø, –æ—Ñ—ñ—Ü–µ—Ä –ø–æ–ª—ñ—Ü—ñ—ó, –ø–æ–ª—ñ—Ü—ñ—è, –ø—Ä–∞—Ü—ñ–≤–Ω–∏–∫ –ø–æ–ª—ñ—Ü—ñ—ó, —Å–ø—ñ–≤—Ä–æ–±—ñ—Ç–Ω–∏–∫
üëÆ‚Äç‚ôÇ	–ø–æ–ª—ñ—Ü–µ–π—Å—å–∫–∏–π, –ø–æ–ª—ñ—Ü—ñ—è, —á–æ–ª–æ–≤—ñ–∫
üëÆ‚Äç‚ôÄ	–∂—ñ–Ω–∫–∞, –∂—ñ–Ω–∫–∞-–ø–æ–ª—ñ—Ü–µ–π—Å—å–∫–∏–π, –ø–æ–ª—ñ—Ü–µ–π—Å—å–∫–∏–π, –ø–æ–ª—ñ—Ü—ñ—è
üïµ‚Äç‚ôÇ	–¥–µ—Ç–µ–∫—Ç–∏–≤, —Å–∏—â–∏–∫, —á–æ–ª–æ–≤—ñ–∫, —á–æ–ª–æ–≤—ñ–∫-–¥–µ—Ç–µ–∫—Ç–∏–≤, —à–ø–∏–≥—É–Ω, —à–ø–∏–∫
üïµ‚Äç‚ôÄ	–¥–µ—Ç–µ–∫—Ç–∏–≤, –∂—ñ–Ω–∫–∞, –∂—ñ–Ω–∫–∞-–¥–µ—Ç–µ–∫—Ç–∏–≤, –∂—ñ–Ω–∫–∞-—Å–∏—â–∏–∫, —à–ø–∏–≥—É–Ω–∫–∞
üíÇ	–≤–∞—Ä—Ç–∞, –∫–∞—Ä–∞—É–ª, –æ—Ö–æ—Ä–æ–Ω–∞, —Å—Ç–æ—Ä–æ–∂–∞, —á–∞—Ç–∏
üíÇ‚Äç‚ôÇ	–≤–∞—Ä—Ç–æ–≤–∏–π, –≤–∞—Ä—Ç—ñ–≤–Ω–∏–∫, –æ—Ö–æ—Ä–æ–Ω–µ—Ü—å, —Å—Ç—Ä–∞–∂, —á–∞—Ç–æ–≤–∏–π
üíÇ‚Äç‚ôÄ	–≤–∞—Ä—Ç–æ–≤–∞, –≤–∞—Ä—Ç—ñ–≤–Ω–∏—Ü—è, –∂—ñ–Ω–∫–∞-–æ—Ö–æ—Ä–æ–Ω–µ—Ü—å, –∂—ñ–Ω–∫–∞-—Å—Ç—Ä–∞–∂, —á–∞—Ç–æ–≤–∞
üë∑	–±—É–¥—ñ–≤–µ–ª—å–Ω–∏–∫, –±—É–¥—ñ–≤–Ω–∏—Ü—Ç–≤–æ, –∫–∞—Å–∫–∞, —Ä–æ–±—ñ—Ç–Ω–∏–∫
üë∑‚Äç‚ôÇ	–±—É–¥—ñ–≤–µ–ª—å–Ω–∏–∫, –±—É–¥—ñ–≤–Ω–∏—Ü—Ç–≤–æ, —Ä–æ–±—ñ—Ç–Ω–∏–∫, —á–æ–ª–æ–≤—ñ–∫, —á–æ–ª–æ–≤—ñ–∫-–±—É–¥—ñ–≤–µ–ª—å–Ω–∏–∫
üë∑‚Äç‚ôÄ	–±—É–¥—ñ–≤–µ–ª—å–Ω–∏–∫, –±—É–¥—ñ–≤–Ω–∏—Ü—Ç–≤–æ, –∂—ñ–Ω–∫–∞, –∂—ñ–Ω–∫–∞-–±—É–¥—ñ–≤–µ–ª—å–Ω–∏–∫, —Ä–æ–±—ñ—Ç–Ω–∏–∫
ü§¥	–∫–æ—Ä–æ–ª–µ–≤–∏—á, –ø—Ä–∏–Ω—Ü
üë∏	–∫–∞–∑–∫–æ–≤–∞, –∫–æ—Ä–æ–ª—ñ–≤–Ω–∞, –ø—Ä–∏–Ω—Ü–µ—Å–∞, —á–∞—Ä—ñ–≤–Ω–∞
üë≥	–ª—é–¥–∏–Ω–∞ –≤ —Ç—é—Ä–±–∞–Ω—ñ, —Ç—é—Ä–±–∞–Ω, —á–æ–ª–æ–≤—ñ–∫
üë≥‚Äç‚ôÇ	—Ç—é—Ä–±–∞–Ω, —á–æ–ª–æ–≤—ñ–∫, —á–æ–ª–æ–≤—ñ–∫ —É —Ç—é—Ä–±–∞–Ω—ñ
üë≥‚Äç‚ôÄ	–∂—ñ–Ω–∫–∞, –∂—ñ–Ω–∫–∞ –≤ —Ç—é—Ä–±–∞–Ω—ñ, —Ç—é—Ä–±–∞–Ω
üë≤	–≥—É–∞ –ø—ñ –º–∞–æ, –∫—Ä—É–≥–ª–∞, —á–æ–ª–æ–≤—ñ–∫, —á–æ–ª–æ–≤—ñ–∫ —É –∫–∏—Ç–∞–π—Å—å–∫—ñ–π —à–∞–ø—Ü—ñ, —à–∞–ø–æ—á–∫–∞
üßï	–∂—ñ–Ω–∫–∞ –≤ —Ö—É—Å—Ç–∏–Ω—ñ, –º–∞–Ω—Ç–∏–ª—å—è, —Ç–∏—Ö–ª—è, —Ö—É—Å—Ç–∏–Ω–∞, —Ö—ñ–¥–∂–∞–±
ü§µ	–Ω–∞—Ä–µ—á–µ–Ω–∏–π, —Å–º–æ–∫—ñ–Ω–≥, —á–æ–ª–æ–≤—ñ–∫, —á–æ–ª–æ–≤—ñ–∫ —É —Å–º–æ–∫—ñ–Ω–≥—É
üë∞	–≤–µ—Å—ñ–ª–ª—è, –Ω–∞—Ä–µ—á–µ–Ω–∞, –Ω–∞—Ä–µ—á–µ–Ω–∞ –∑ —Ñ–∞—Ç–æ—é, —Ñ–∞—Ç–∞
ü§∞	–≤–∞–≥—ñ—Ç–Ω–∞, –≤–∞–≥—ñ—Ç–Ω–∞ –∂—ñ–Ω–∫–∞, –∂—ñ–Ω–∫–∞
ü§±	–≥–æ–¥—É–≤–∞–Ω–Ω—è, –≥—Ä—É–¥–∏, –≥—Ä—É–¥–Ω–µ –≤–∏–≥–æ–¥–æ–≤—É–≤–∞–Ω–Ω—è, –Ω–µ–º–æ–≤–ª—è
üëº	–∞–Ω–≥–µ–ª, –∫–∞–∑–∫–∞, –Ω–µ–º–æ–≤–ª—è, –æ–±–ª–∏—á—á—è, —Ñ–∞–Ω—Ç–∞–∑—ñ—è, —è–Ω–≥–æ–ª—è—Ç–∫–æ
üéÖ	–ú–æ—Ä–æ–∑, –°–∞–Ω—Ç–∞ –ö–ª–∞—É—Å, –°–∞–Ω—Ç–∞-–ö–ª–∞—É—Å, –¥—ñ–¥, –∫–∞–∑–∫–∞, —Ä—ñ–∑–¥–≤–æ, —Å–≤—è—Ç–∫—É–≤–∞–Ω–Ω—è, —Ñ–∞–Ω—Ç–∞–∑—ñ—è
ü§∂	–ü–∞–Ω—ñ –ö–ª–∞—É—Å, –∂—ñ–Ω–∫–∞, —Ä—ñ–∑–¥–≤–æ, —Å–∞–Ω—Ç–∞-–∫–ª–∞—É—Å
ü¶∏	–≥–µ—Ä–æ–π, –≥–µ—Ä–æ—ó–Ω—è, –¥–æ–±—Ä–æ, —Å—É–ø–µ—Ä–≥–µ—Ä–æ–π, —Å—É–ø–µ—Ä—Å–∏–ª–∞
ü¶∏‚Äç‚ôÄ	–≥–µ—Ä–æ–π, –¥–æ–±—Ä–æ, –∂—ñ–Ω–∫–∞, –∂—ñ–Ω–∫–∞-—Å—É–ø–µ—Ä–≥–µ—Ä–æ–π, —Å—É–ø–µ—Ä, —Å—É–ø–µ—Ä–≤—É–º–µ–Ω
ü¶∏‚Äç‚ôÇ	–≥–µ—Ä–æ–π, –¥–æ–±—Ä–æ, —Å—É–ø–µ—Ä, —Å—É–ø–µ—Ä–º–µ–Ω, —Å—É–ø–µ—Ä—Å–∏–ª–∞, —á–æ–ª–æ–≤—ñ–∫, —á–æ–ª–æ–≤—ñ–∫-—Å—É–ø–µ—Ä–≥–µ—Ä–æ–π
ü¶π	–∑–ª–æ, –∑–ª–æ–¥—ñ–π, –∑–ª–æ—á–∏–Ω–µ—Ü—å, —Å—É–ø–µ—Ä–∑–ª–æ–¥—ñ–π, —Å—É–ø–µ—Ä—Å–∏–ª–∞
ü¶π‚Äç‚ôÄ	–∂—ñ–Ω–∫–∞, –∑–ª–æ, –∑–ª–æ–¥—ñ–π, –∑–ª–æ—á–∏–Ω–µ—Ü—å, —Å—É–ø–µ—Ä–ª–∏—Ö–æ–¥—ñ–π–∫–∞, —Å—É–ø–µ—Ä—Å–∏–ª–∞
ü¶π‚Äç‚ôÇ	–∑–ª–æ, –∑–ª–æ–¥—ñ–π, –∑–ª–æ—á–∏–Ω–µ—Ü—å, —Å—É–ø–µ—Ä–ª–∏—Ö–æ–¥—ñ–π, —Å—É–ø–µ—Ä—Å–∏–ª–∞, —á–æ–ª–æ–≤—ñ–∫
üßô	–≤—ñ–¥—å–º–∞, –º–∞–≥, —á–∞–∫–ª—É–Ω, —á–∞–∫–ª—É–Ω–∫–∞, —á–∞—Ä–æ–¥—ñ–π
üßô‚Äç‚ôÄ	–≤—ñ–¥—å–º–∞, —á–∞–∫–ª—É–Ω–∫–∞, —á–∞—Ä–æ–¥—ñ–π–∫–∞
üßô‚Äç‚ôÇ	—á–∞–∫–ª—É–Ω, —á–∞—Ä–æ–¥—ñ–π
üßö	–û–±–µ—Ä–æ–Ω, –ü–∞–∫, –¢–∏—Ç–∞–Ω—ñ—è, —Ñ–µ—è
üßö‚Äç‚ôÄ	–¢–∏—Ç–∞–Ω—ñ—è, –∂—ñ–Ω–∫–∞-—Ñ–µ—è
üßö‚Äç‚ôÇ	–û–±–µ—Ä–æ–Ω, –ü–∞–∫, —á–æ–ª–æ–≤—ñ–∫-—Ñ–µ—è
üßõ	–î—Ä–∞–∫—É–ª–∞, –≤–∞–º–ø—ñ—Ä, –Ω–µ–∂–∏—Ç—å
üßõ‚Äç‚ôÄ	–∂—ñ–Ω–∫–∞-–≤–∞–º–ø—ñ—Ä, –Ω–µ–∂–∏—Ç—å
üßõ‚Äç‚ôÇ	–î—Ä–∞–∫—É–ª–∞, –Ω–µ–º–µ—Ä—Ç–≤–∏–π, —á–æ–ª–æ–≤—ñ–∫-–≤–∞–º–ø—ñ—Ä
üßú	–∂—ñ–Ω–∫–∞-—Ä—É—Å–∞–ª–∫–∞, –∫–∞–∑–∫–æ–≤–∞ –≤–æ–¥—è–Ω–∞ —ñ—Å—Ç–æ—Ç–∞, —Ä—É—Å–∞–ª–∫–∞, —á–æ–ª–æ–≤—ñ–∫-—Ä—É—Å–∞–ª–∫–∞
üßú‚Äç‚ôÄ	–∂—ñ–Ω–∫–∞-—Ä—É—Å–∞–ª–∫–∞, —Ä—É—Å–∞–ª–∫–∞
üßú‚Äç‚ôÇ	–¢—Ä–∏—Ç–æ–Ω, —á–æ–ª–æ–≤—ñ–∫-—Ä—É—Å–∞–ª–∫–∞
üßù	–µ–ª—å—Ñ, –º–∞–≥—ñ—á–Ω–∏–π
üßù‚Äç‚ôÄ	–∂—ñ–Ω–∫–∞-–µ–ª—å—Ñ, —á–∞—Ä—ñ–≤–Ω–∞
üßù‚Äç‚ôÇ	—á–∞—Ä—ñ–≤–Ω–∏–π, —á–æ–ª–æ–≤—ñ–∫-–µ–ª—å—Ñ
üßû	–¥–∂–∏–Ω
üßû‚Äç‚ôÄ	–¥–∂–∏–Ω, –∂—ñ–Ω–∫–∞-–¥–∂–∏–Ω
üßû‚Äç‚ôÇ	–¥–∂–∏–Ω, —á–æ–ª–æ–≤—ñ–∫-–¥–∂–∏–Ω
üßü	–∑–æ–º–±—ñ, –Ω–µ–∂–∏—Ç—å, —Ö–æ–¥—è—á–∏–π –º—Ä–µ—Ü—å
üßü‚Äç‚ôÄ	–∂—ñ–Ω–∫–∞-–∑–æ–º–±—ñ, –Ω–µ–∂–∏—Ç—å, —Ö–æ–¥—è—á–∏–π –º—Ä–µ—Ü—å
üßü‚Äç‚ôÇ	–Ω–µ–∂–∏—Ç—å, —Ö–æ–¥—è—á–∏–π –º—Ä–µ—Ü—å, —á–æ–ª–æ–≤—ñ–∫-–∑–æ–º–±—ñ
üôç	–∂–µ—Å—Ç, –Ω–∞—Ö–º—É—Ä–µ–Ω–∏–π, –ø–æ—Ö–º—É—Ä–∞ –ª—é–¥–∏–Ω–∞
üôç‚Äç‚ôÇ	–∑–∞—Å–º—É—á–µ–Ω–∏–π, –ø–æ—Ö–º—É—Ä–∏–π —á–æ–ª–æ–≤—ñ–∫, —Ä–æ–∑—á–∞—Ä—É–≤–∞–Ω–Ω—è, —á–æ–ª–æ–≤—ñ–∫
üôç‚Äç‚ôÄ	–∂—ñ–Ω–∫–∞, –∑–∞—Å–º—É—á–µ–Ω–∞, –ø–æ—Ö–º—É—Ä–∞ –∂—ñ–Ω–∫–∞, —Ä–æ–∑—á–∞—Ä—É–≤–∞–Ω–Ω—è
üôé	–∂–µ—Å—Ç, –∑–ª–∏–π, –ª—é–¥–∏–Ω–∞, —â–æ –¥—É—î—Ç—å—Å—è
üôé‚Äç‚ôÇ	–∑–ª—ñ—Å—Ç—å, —Å–µ—Ä–¥–∏—Ç—å—Å—è, —á–æ–ª–æ–≤—ñ–∫, —á–æ–ª–æ–≤—ñ–∫, —â–æ –¥—É—î—Ç—å—Å—è
üôé‚Äç‚ôÄ	–∂—ñ–Ω–∫–∞, –∂—ñ–Ω–∫–∞, —â–æ –¥—É—î—Ç—å—Å—è, –∑–ª—ñ—Å—Ç—å, —Å–µ—Ä–¥–∏—Ç—å—Å—è
üôÖ	–∂–µ—Å—Ç, –∑–∞–±–æ—Ä–æ–Ω–µ–Ω–æ, –ª—é–¥–∏–Ω–∞, —â–æ –∂–µ—Å—Ç–æ–º –ø–æ–∫–∞–∑—É—î ¬´–Ω—ñ¬ª, –Ω–µ, –Ω—ñ, —Ä—É–∫–∞
üôÖ‚Äç‚ôÇ	–∑–∞–±–æ—Ä–æ–Ω–∞, –ø—Ä–æ—Ç–∏, —á–æ–ª–æ–≤—ñ–∫, —á–æ–ª–æ–≤—ñ–∫, —â–æ –∂–µ—Å—Ç–æ–º –ø–æ–∫–∞–∑—É—î ¬´–Ω—ñ¬ª
üôÖ‚Äç‚ôÄ	–∂—ñ–Ω–∫–∞, –∂—ñ–Ω–∫–∞, —â–æ –∂–µ—Å—Ç–æ–º –ø–æ–∫–∞–∑—É—î ¬´–Ω—ñ¬ª, –∑–∞–±–æ—Ä–æ–Ω–∞, –ø—Ä–æ—Ç–∏
üôÜ	O‚Äô–∫–µ–π, –∂–µ—Å—Ç, –ª—é–¥–∏–Ω–∞, —â–æ –∂–µ—Å—Ç–æ–º –ø–æ–∫–∞–∑—É—î ¬´–æ–∫–µ–π¬ª, —Ä—É–∫–∞
üôÜ‚Äç‚ôÇ	–¥–æ–±—Ä–µ, –∑–≥–æ–¥–∞, –æ–∫, —á–æ–ª–æ–≤—ñ–∫, —á–æ–ª–æ–≤—ñ–∫, —â–æ –∂–µ—Å—Ç–æ–º –ø–æ–∫–∞–∑—É—î ¬´–æ–∫–µ–π¬ª
üôÜ‚Äç‚ôÄ	–¥–æ–±—Ä–µ, –∂—ñ–Ω–∫–∞, –∂—ñ–Ω–∫–∞, —â–æ –∂–µ—Å—Ç–æ–º –ø–æ–∫–∞–∑—É—î ¬´–æ–∫–µ–π¬ª, –∑–≥–æ–¥–∞, –æ–∫
üíÅ	–¥–æ–ø–æ–º–æ–≥–∞, –ª—é–¥–∏–Ω–∞, —â–æ –ø—Ä–æ—Å—Ç—è–≥–∞—î —Ä—É–∫—É –¥–æ–ø–æ–º–æ–≥–∏, –ø—Ä–∞—Ü—ñ–≤–Ω–∏–∫ –¥–æ–≤—ñ–¥–∫–æ–≤–æ–≥–æ –±—é—Ä–æ, —Ä—É–∫–∞, —ñ–Ω—Ñ–æ—Ä–º–∞—Ü—ñ—è
üíÅ‚Äç‚ôÇ	–≤—ñ–¥–ø–æ–≤—ñ–¥–∞—Ç–∏, –Ω–µ—Å—Ç—Ä–∏–º–∞–Ω—ñ—Å—Ç—å, —Ç—è–≥–Ω—É—Ç–∏ —Ä—É–∫—É, —á–æ–ª–æ–≤—ñ–∫, —á–æ–ª–æ–≤—ñ–∫ —Ç—è–≥–Ω–µ —Ä—É–∫—É, —á–æ–ª–æ–≤—ñ–∫, —â–æ –ø—Ä–æ—Å—Ç—è–≥–∞—î —Ä—É–∫—É –¥–æ–ø–æ–º–æ–≥–∏
üíÅ‚Äç‚ôÄ	–≤—ñ–¥–ø–æ–≤—ñ–¥–∞—Ç–∏, –∂—ñ–Ω–∫–∞, –∂—ñ–Ω–∫–∞ —Ç—è–≥–Ω–µ —Ä—É–∫—É, –∂—ñ–Ω–∫–∞, —â–æ –ø—Ä–æ—Å—Ç—è–≥–∞—î —Ä—É–∫—É –¥–æ–ø–æ–º–æ–≥–∏, –Ω–µ—Å—Ç—Ä–∏–º–∞–Ω—ñ—Å—Ç—å, —Ç—è–≥–Ω—É—Ç–∏ —Ä—É–∫—É
üôã	–∂–µ—Å—Ç, –ª—é–¥–∏–Ω–∞ –∑ –ø—ñ–¥–Ω—è—Ç–æ—é —Ä—É–∫–æ—é, –ø—ñ–¥–Ω—è—Ç–∞, —Ä—É–∫–∞, —â–∞—Å–ª–∏–≤–∏–π
üôã‚Äç‚ôÇ	–ø—ñ–¥–Ω—è—Ç–∞ —Ä—É–∫–∞, —Ä—É–∫–∞, —á–æ–ª–æ–≤—ñ–∫, —á–æ–ª–æ–≤—ñ–∫ —ñ–∑ –ø—ñ–¥–Ω—è—Ç–æ—é —Ä—É–∫–æ—é
üôã‚Äç‚ôÄ	–∂—ñ–Ω–∫–∞, –∂—ñ–Ω–∫–∞ –∑ –ø—ñ–¥–Ω—è—Ç–æ—é —Ä—É–∫–æ—é, –ø—ñ–¥–Ω—è—Ç–∞ —Ä—É–∫–∞, —Ä—É–∫–∞
üôá	–≤–∏–±–∞—á, –≤–∏–±–∞—á–µ–Ω–Ω—è, –∂–µ—Å—Ç, –ª—é–¥–∏–Ω–∞, —â–æ –≤–∫–ª–æ–Ω—è—î—Ç—å—Å—è, —É–∫–ª—ñ–Ω
üôá‚Äç‚ôÇ	–≤–∏–±–∞—á–µ–Ω–Ω—è, –ø–æ–≤–∞–≥–∞, –ø–æ–∫–æ—Ä–∞, —á–æ–ª–æ–≤—ñ–∫, —á–æ–ª–æ–≤—ñ–∫, —â–æ –≤–∫–ª–æ–Ω—è—î—Ç—å—Å—è
üôá‚Äç‚ôÄ	–≤–∏–±–∞—á–µ–Ω–Ω—è, –∂—ñ–Ω–∫–∞, –∂—ñ–Ω–∫–∞, —â–æ –≤–∫–ª–æ–Ω—è—î—Ç—å—Å—è, –ø–æ–≤–∞–≥–∞, –ø–æ–∫–æ—Ä–∞
ü§¶	–ª—é–¥–∏–Ω–∞, —â–æ –ø—ñ–¥–Ω–æ—Å–∏—Ç—å –¥–æ–ª–æ–Ω—é –¥–æ –æ–±–ª–∏—á—á—è, –æ–±–ª–∏—á—á—è, —Ä–æ–∑–¥—Ä–∞—Ç—É–≤–∞–Ω–Ω—è, —Ä–æ–∑—á–∞—Ä—É–≤–∞–Ω–Ω—è, —Ä—É–∫–∞
ü§¶‚Äç‚ôÇ	—Ä—É–∫–∞, —Å–æ—Ä–æ–º, —Ñ–µ–π—Å–ø–∞–ª–º, —á–æ–ª–æ–≤—ñ–∫, —á–æ–ª–æ–≤—ñ–∫, —â–æ –ø—ñ–¥–Ω–æ—Å–∏—Ç—å –¥–æ–ª–æ–Ω—é –¥–æ –æ–±–ª–∏—á—á—è
ü§¶‚Äç‚ôÄ	–∂—ñ–Ω–∫–∞, –∂—ñ–Ω–∫–∞, —â–æ –ø—ñ–¥–Ω–æ—Å–∏—Ç—å –¥–æ–ª–æ–Ω—é –¥–æ –æ–±–ª–∏—á—á—è, —Ä—É–∫–∞, —Å–æ—Ä–æ–º, —Ñ–µ–π—Å–ø–∞–ª–º
ü§∑	–±–∞–π–¥—É–∂—ñ—Å—Ç—å, –∑–Ω–∏–∑—É–≤–∞–Ω–Ω—è, –ª—é–¥–∏–Ω–∞, —â–æ –∑–Ω–∏–∑—É—î –ø–ª–µ—á–∏–º–∞, –Ω–µ–≤—ñ–¥–æ–º—ñ—Å—Ç—å, —Å—É–º–Ω—ñ–≤
ü§∑‚Äç‚ôÇ	–∑–Ω–∏–∑—É—î –ø–ª–µ—á–∏–º–∞, –Ω–µ –∑–Ω–∞—é, —Ä–æ–∑–≥—É–±–ª–µ–Ω—ñ—Å—Ç—å, —á–æ–ª–æ–≤—ñ–∫, —á–æ–ª–æ–≤—ñ–∫, —â–æ –∑–Ω–∏–∑—É—î –ø–ª–µ—á–∏–º–∞
ü§∑‚Äç‚ôÄ	–∂—ñ–Ω–∫–∞, –∂—ñ–Ω–∫–∞, —â–æ –∑–Ω–∏–∑—É—î –ø–ª–µ—á–∏–º–∞, –∑–Ω–∏–∑—É—î –ø–ª–µ—á–∏–º–∞, –Ω–µ –∑–Ω–∞—é, —Ä–æ–∑–≥—É–±–ª–µ–Ω—ñ—Å—Ç—å
üíÜ	–ª—é–¥–∏–Ω–∞, —è–∫—ñ–π —Ä–æ–±–ª—è—Ç—å –º–∞—Å–∞–∂ –≥–æ–ª–æ–≤–∏, –º–∞—Å–∞–∂, —Å–∞–ª–æ–Ω
üíÜ‚Äç‚ôÇ	–º–∞—Å–∞–∂, –æ–±–ª–∏—á—á—è, —Ä–æ–∑—Å–ª–∞–±–ª–µ–Ω–Ω—è, —á–æ–ª–æ–≤—ñ–∫, —á–æ–ª–æ–≤—ñ–∫, —è–∫–æ–º—É —Ä–æ–±–ª—è—Ç—å –º–∞—Å–∞–∂ –≥–æ–ª–æ–≤–∏
üíÜ‚Äç‚ôÄ	–∂—ñ–Ω–∫–∞, –∂—ñ–Ω–∫–∞, —è–∫—ñ–π —Ä–æ–±–ª—è—Ç—å –º–∞—Å–∞–∂ –≥–æ–ª–æ–≤–∏, –º–∞—Å–∞–∂, –æ–±–ª–∏—á—á—è, —Ä–æ–∑—Å–ª–∞–±–ª–µ–Ω–Ω—è
üíá	–∫—Ä–∞—Å–∞, –ª—é–¥–∏–Ω–∞, —è–∫—ñ–π —Ä–æ–±–ª—è—Ç—å —Å—Ç—Ä–∏–∂–∫—É, –ø–µ—Ä—É–∫–∞—Ä, —Å–∞–ª–æ–Ω
üíá‚Äç‚ôÇ	–≤–æ–ª–æ—Å—Å—è, —Å—Ç—Ä–∏–∂–∫–∞, —á–æ–ª–æ–≤—ñ–∫, —á–æ–ª–æ–≤—ñ–∫, —è–∫–æ–º—É —Ä–æ–±–ª—è—Ç—å —Å—Ç—Ä–∏–∂–∫—É
üíá‚Äç‚ôÄ	–≤–æ–ª–æ—Å—Å—è, –∂—ñ–Ω–∫–∞, –∂—ñ–Ω–∫–∞, —è–∫—ñ–π —Ä–æ–±–ª—è—Ç—å —Å—Ç—Ä–∏–∂–∫—É, —Å—Ç—Ä–∏–∂–∫–∞
üö∂	–ª—é–¥–∏–Ω–∞, —â–æ –π–¥–µ –ø—ñ—à–∫–∏, —ñ—Ç–∏
üö∂‚Äç‚ôÇ	–≥—É–ª—è—Ç–∏, –π—Ç–∏, –ø—Ä–æ–≥—É–ª—è–Ω–∫–∞, —á–æ–ª–æ–≤—ñ–∫, —á–æ–ª–æ–≤—ñ–∫, —â–æ –π–¥–µ –ø—ñ—à–∫–∏
üö∂‚Äç‚ôÄ	–≥—É–ª—è—Ç–∏, –∂—ñ–Ω–∫–∞, –∂—ñ–Ω–∫–∞, —â–æ –π–¥–µ –ø—ñ—à–∫–∏, –π—Ç–∏, –ø—Ä–æ–≥—É–ª—è–Ω–∫–∞
üèÉ	–±—ñ–≥, –ª—é–¥–∏–Ω–∞, —â–æ –±—ñ–∂–∏—Ç—å, –º–∞—Ä–∞—Ñ–æ–Ω
üèÉ‚Äç‚ôÇ	–±—ñ–≥, –≤—Ç–µ—á–∞, —Å–ø–æ—Ä—Ç, —á–æ–ª–æ–≤—ñ–∫, —á–æ–ª–æ–≤—ñ–∫, —â–æ –±—ñ–∂–∏—Ç—å
üèÉ‚Äç‚ôÄ	–±—ñ–≥, –≤—Ç–µ—á–∞, –∂—ñ–Ω–∫–∞, –∂—ñ–Ω–∫–∞, —â–æ –±—ñ–∂–∏—Ç—å, —Å–ø–æ—Ä—Ç
üíÉ	–∂—ñ–Ω–∫–∞, –∂—ñ–Ω–∫–∞, —â–æ —Ç–∞–Ω—Ü—é—î, —Ç–∞–Ω–µ—Ü—å
üï∫	—Ç–∞–Ω—Ü—ñ, —á–æ–ª–æ–≤—ñ–∫, —á–æ–ª–æ–≤—ñ–∫, —â–æ —Ç–∞–Ω—Ü—é—î
üëØ	–≤—É—Ö–∞, –¥—ñ–≤—á–∏–Ω–∞, –∂—ñ–Ω–∫–∞, –∫—Ä–æ–ª–∏–∫, –ª—é–¥–∏ –∑ –∫—Ä–æ–ª—è—á–∏–º–∏ –≤—É—Ö–∞–º–∏, —Ç–∞–Ω—Ü—ñ–≤–Ω–∏—Ü—è
üëØ‚Äç‚ôÇ	–≤–µ—á—ñ—Ä–∫–∞, –∑–∞—è—á—ñ –≤—É—à–∫–∞, —Ä–æ–∑–≤–∞–≥–∏, —á–æ–ª–æ–≤—ñ–∫–∏, —á–æ–ª–æ–≤—ñ–∫–∏ –∑ –∫—Ä–æ–ª—è—á–∏–º–∏ –≤—É—Ö–∞–º–∏
üëØ‚Äç‚ôÄ	–≤–µ—á—ñ—Ä–∫–∞, –∂—ñ–Ω–∫–∏, –∂—ñ–Ω–∫–∏ –∑ –∫—Ä–æ–ª—è—á–∏–º–∏ –≤—É—Ö–∞–º–∏, –∑–∞—è—á—ñ –≤—É—à–∫–∞, —Ä–æ–∑–≤–∞–≥–∏
üßñ	–ª—é–¥–∏–Ω–∞ –≤ –ª–∞–∑–Ω—ñ, –ª—é–¥–∏–Ω–∞ –≤ –ø–∞—Ä–∫–æ–º—É –ø—Ä–∏–º—ñ—â–µ–Ω–Ω—ñ, –ø–∞—Ä–æ–≤–∞ –∫—ñ–º–Ω–∞—Ç–∞, —Å–∞—É–Ω–∞
üßñ‚Äç‚ôÄ	–∂—ñ–Ω–∫–∞ –≤ –ª–∞–∑–Ω—ñ, –∂—ñ–Ω–∫–∞ –≤ –ø–∞—Ä–∫–æ–º—É –ø—Ä–∏–º—ñ—â–µ–Ω–Ω—ñ, –ø–∞—Ä–æ–≤–∞ –∫—ñ–º–Ω–∞—Ç–∞, —Å–∞—É–Ω–∞
üßñ‚Äç‚ôÇ	–ø–∞—Ä–æ–≤–∞ –∫—ñ–º–Ω–∞—Ç–∞, —Å–∞—É–Ω–∞, —á–æ–ª–æ–≤—ñ–∫ —É –ª–∞–∑–Ω—ñ, —á–æ–ª–æ–≤—ñ–∫ —É –ø–∞—Ä–∫–æ–º—É –ø—Ä–∏–º—ñ—â–µ–Ω–Ω—ñ
üßó	–ª—é–¥–∏–Ω–∞, —â–æ –ª—ñ–∑–µ —Å–∫–µ–ª–µ—é, —Å–∫–µ–ª–µ–ª–∞–∑
üßó‚Äç‚ôÄ	–∂—ñ–Ω–∫–∞-—Å–∫–µ–ª–µ–ª–∞–∑, —Å–∫–µ–ª–µ–ª–∞–∑
üßó‚Äç‚ôÇ	—Å–∫–µ–ª–µ–ª–∞–∑, —á–æ–ª–æ–≤—ñ–∫-—Å–∫–µ–ª–µ–ª–∞–∑
üßò	–π–æ–≥–∞, –ª—é–¥–∏–Ω–∞ –≤ –ø–æ–∑—ñ –ª–æ—Ç–æ—Å–∞, –º–µ–¥–∏—Ç–∞—Ü—ñ—è
üßò‚Äç‚ôÄ	–∂—ñ–Ω–∫–∞ –≤ –ø–æ–∑—ñ –ª–æ—Ç–æ—Å–∞, –π–æ–≥–∞, –º–µ–¥–∏—Ç–∞—Ü—ñ—è
üßò‚Äç‚ôÇ	–π–æ–≥–∞, –º–µ–¥–∏—Ç–∞—Ü—ñ—è, —á–æ–ª–æ–≤—ñ–∫ —É –ø–æ–∑—ñ –ª–æ—Ç–æ—Å–∞
üõÄ	–≤–∞–Ω–Ω–∞, –∫—É–ø–∞—Ç–∏—Å—è, –ª—é–¥–∏–Ω–∞, —â–æ –ø—Ä–∏–π–º–∞—î –≤–∞–Ω–Ω—É
üõå	–≥–æ—Ç–µ–ª—å, –ª—é–¥–∏–Ω–∞ –≤ –ª—ñ–∂–∫—É, —Å–æ–Ω
üë§	–±—é—Å—Ç, —Å–∏–ª—É–µ—Ç, —Å–∏–ª—É–µ—Ç –±—é—Å—Ç—É –ª—é–¥–∏–Ω–∏
üë•	–±—é—Å—Ç, —Å–∏–ª—É–µ—Ç, —Å–∏–ª—É–µ—Ç–∏ –¥–≤–æ—Ö –ª—é–¥—Å—å–∫–∏—Ö –±—é—Å—Ç—ñ–≤
ü§∫	—Ñ–µ—Ö—Ç—É–≤–∞–ª—å–Ω–∏–∫, —Ñ–µ—Ö—Ç—É–≤–∞–ª—å–Ω–∏—Ü—è, —Ñ–µ—Ö—Ç—É–≤–∞–Ω–Ω—è, —à–∞–±–ª—è, —à–ø–∞–≥–∞
üèá	–±—ñ–≥–æ–≤–∏–π –∫—ñ–Ω—å, –∂–æ–∫–µ–π, –∫—ñ–Ω–Ω—ñ –ø–µ—Ä–µ–≥–æ–Ω–∏, –∫—ñ–Ω—å, –ø–µ—Ä–µ–≥–æ–Ω–∏
üèå‚Äç‚ôÇ	–≥–æ–ª—å—Ñ, –≥–æ–ª—å—Ñ—ñ—Å—Ç, —á–æ–ª–æ–≤—ñ–∫
üèå‚Äç‚ôÄ	–≥–æ–ª—å—Ñ, –≥–æ–ª—å—Ñ—ñ—Å—Ç–∫–∞, –∂—ñ–Ω–∫–∞
üèÑ‚Äç‚ôÇ	—Å–µ—Ä—Ñ—ñ–Ω–≥, —Å–µ—Ä—Ñ—ñ–Ω–≥—ñ—Å—Ç, —á–æ–ª–æ–≤—ñ–∫
üèÑ‚Äç‚ôÄ	–∂—ñ–Ω–∫–∞, —Å–µ—Ä—Ñ—ñ–Ω–≥, —Å–µ—Ä—Ñ—ñ–Ω–≥—ñ—Å—Ç–∫–∞
üö£	–ª—é–¥–∏–Ω–∞, —â–æ –≤–µ—Å–ª—É—î –Ω–∞ —á–æ–≤–Ω—ñ, —Ç—Ä–∞–Ω—Å–ø–æ—Ä—Ç, —á–æ–≤–µ–Ω
üö£‚Äç‚ôÇ	–≤–µ—Å–ª–æ–≤–∏–π —á–æ–≤–µ–Ω, —á–æ–≤–µ–Ω, —á–æ–ª–æ–≤—ñ–∫, —á–æ–ª–æ–≤—ñ–∫, —â–æ –≤–µ—Å–ª—É—î –Ω–∞ —á–æ–≤–Ω—ñ
üö£‚Äç‚ôÄ	–≤–µ—Å–ª–æ–≤–∏–π —á–æ–≤–µ–Ω, –∂—ñ–Ω–∫–∞, –∂—ñ–Ω–∫–∞, —â–æ –≤–µ—Å–ª—É—î –Ω–∞ —á–æ–≤–Ω—ñ, —á–æ–≤–µ–Ω
üèä‚Äç‚ôÇ	–ø–ª–∞–≤–∞–Ω–Ω—è, –ø–ª–∞–≤–µ—Ü—å, —á–æ–ª–æ–≤—ñ–∫
üèä‚Äç‚ôÄ	–∂—ñ–Ω–∫–∞, –ø–ª–∞–≤–∞–Ω–Ω—è, –ø–ª–∞–≤—á–∏–Ω—è
‚õπ‚Äç‚ôÇ	–º‚Äô—è—á, —á–æ–ª–æ–≤—ñ–∫, —á–æ–ª–æ–≤—ñ–∫ —ñ–∑ –º‚Äô—è—á–µ–º, —á–æ–ª–æ–≤—ñ–∫, —â–æ –≤–µ–¥–µ –º º—è—á
‚õπ‚Äç‚ôÄ	–∂—ñ–Ω–∫–∞, –∂—ñ–Ω–∫–∞ –∑ –º‚Äô—è—á–µ–º, –∂—ñ–Ω–∫–∞, —â–æ –≤–µ–¥–µ –º º—è—á, –º‚Äô—è—á
üèã‚Äç‚ôÇ	–≤–∞–∂–∫–∞ –∞—Ç–ª–µ—Ç–∏–∫–∞, —á–æ–ª–æ–≤—ñ–∫, —à—Ç–∞–Ω–≥—ñ—Å—Ç
üèã‚Äç‚ôÄ	–≤–∞–∂–∫–∞ –∞—Ç–ª–µ—Ç–∏–∫–∞, –∂—ñ–Ω–∫–∞, —à—Ç–∞–Ω–≥—ñ—Å—Ç–∫–∞
üö¥	–≤–µ–ª–æ—Å–∏–ø–µ–¥, –ª—é–¥–∏–Ω–∞, —â–æ —ó–¥–µ –Ω–∞ –≤–µ–ª–æ—Å–∏–ø–µ–¥—ñ
üö¥‚Äç‚ôÇ	–≤–µ–ª–æ—Å–∏–ø–µ–¥, –≤–µ–ª–æ—Å–∏–ø–µ–¥–∏—Å—Ç, –≤–µ–ª–æ—Å–∏–ø–µ–¥–Ω–∏–π —Å–ø–æ—Ä—Ç, —á–æ–ª–æ–≤—ñ–∫
üö¥‚Äç‚ôÄ	–≤–µ–ª–æ—Å–∏–ø–µ–¥, –≤–µ–ª–æ—Å–∏–ø–µ–¥–∏—Å—Ç–∫–∞, –≤–µ–ª–æ—Å–∏–ø–µ–¥–Ω–∏–π —Å–ø–æ—Ä—Ç, –∂—ñ–Ω–∫–∞
üöµ	–≤–µ–ª–æ—Å–∏–ø–µ–¥, –≤–µ–ª–æ—Å–∏–ø–µ–¥–∏—Å—Ç, –≥–æ—Ä–∞, –ª—é–¥–∏–Ω–∞, —â–æ —ó–¥–µ –Ω–∞ –≥—ñ—Ä—Å—å–∫–æ–º—É –≤–µ–ª–æ—Å–∏–ø–µ–¥—ñ
üöµ‚Äç‚ôÇ	–≤–µ–ª–æ—Å–∏–ø–µ–¥, –≤–µ–ª–æ—Å–∏–ø–µ–¥–∏—Å—Ç, –≥–æ—Ä–∏, –≥—ñ—Ä—Å—å–∫–∏–π –≤–µ–ª–æ—Å–∏–ø–µ–¥–∏—Å—Ç, —á–æ–ª–æ–≤—ñ–∫
üöµ‚Äç‚ôÄ	–≤–µ–ª–æ—Å–∏–ø–µ–¥, –≤–µ–ª–æ—Å–∏–ø–µ–¥–∏—Å—Ç, –≥–æ—Ä–∏, –≥—ñ—Ä—Å—å–∫–∞ –≤–µ–ª–æ—Å–∏–ø–µ–¥–∏—Å—Ç–∫–∞, –∂—ñ–Ω–∫–∞
ü§∏	–≥—ñ–º–Ω–∞—Å—Ç–∏–∫–∞, –∫–æ–ª–µ—Å–æ, –ª—é–¥–∏–Ω–∞, –ª—é–¥–∏–Ω–∞, —â–æ –ø–µ—Ä–µ–≤–µ—Ä—Ç–∞—î—Ç—å—Å—è ¬´–∫–æ–ª–µ—Å–æ–º¬ª, —Å–ø–æ—Ä—Ç
ü§∏‚Äç‚ôÇ	–≥—ñ–º–Ω–∞—Å—Ç–∏–∫–∞, –∫–æ–ª–µ—Å–æ, –ª—é–¥–∏–Ω–∞, —Å–ø–æ—Ä—Ç, —á–æ–ª–æ–≤—ñ–∫, —á–æ–ª–æ–≤—ñ–∫, —â–æ –ø–µ—Ä–µ–≤–µ—Ä—Ç–∞—î—Ç—å—Å—è ¬´–∫–æ–ª–µ—Å–æ–º¬ª
ü§∏‚Äç‚ôÄ	–≥—ñ–º–Ω–∞—Å—Ç–∏–∫–∞, –∂—ñ–Ω–∫–∞, –∂—ñ–Ω–∫–∞, —â–æ –ø–µ—Ä–µ–≤–µ—Ä—Ç–∞—î—Ç—å—Å—è ¬´–∫–æ–ª–µ—Å–æ–º¬ª, –∫–æ–ª–µ—Å–æ, –ª—é–¥–∏–Ω–∞, —Å–ø–æ—Ä—Ç
ü§º	–±–æ—Ä–µ—Ü—å, –±–æ—Ä–æ—Ç—å–±–∞, –±–æ—Ä—Ü—ñ, –ª—é–¥–∏–Ω–∞, —Å–ø–æ—Ä—Ç
ü§º‚Äç‚ôÇ	–±–æ—Ä–µ—Ü—å, –±–æ—Ä–æ—Ç—å–±–∞, –ª—é–¥–∏–Ω–∞, —Å–ø–æ—Ä—Ç, —á–æ–ª–æ–≤—ñ–∫
ü§º‚Äç‚ôÄ	–±–æ—Ä–æ—Ç—å–±–∞, –±–æ—Ä—á–∏–Ω—è, –∂—ñ–Ω–∫–∞, –ª—é–¥–∏–Ω–∞, —Å–ø–æ—Ä—Ç
ü§Ω	–≤–æ–¥–∞, –ª—é–¥–∏–Ω–∞, –ª—é–¥–∏–Ω–∞, —â–æ –≥—Ä–∞—î —É –≤–∞—Ç–µ—Ä–ø–æ–ª–æ, –ø–æ–ª–æ, —Å–ø–æ—Ä—Ç
ü§Ω‚Äç‚ôÇ	–≤–∞—Ç–µ—Ä–ø–æ–ª—ñ—Å—Ç, –≤–æ–¥–Ω–µ –ø–æ–ª–æ, —Å–ø–æ—Ä—Ç, —á–æ–ª–æ–≤—ñ–∫
ü§Ω‚Äç‚ôÄ	–≤–∞—Ç–µ—Ä–ø–æ–ª—ñ—Å—Ç–∫–∞, –≤–æ–¥–Ω–µ –ø–æ–ª–æ, –∂—ñ–Ω–∫–∞, —Å–ø–æ—Ä—Ç
ü§æ	–≥–∞–Ω–¥–±–æ–ª, –ª—é–¥–∏–Ω–∞, –ª—é–¥–∏–Ω–∞, —â–æ –≥—Ä–∞—î —É –≥–∞–Ω–¥–±–æ–ª, –º‚Äô—è—á, —Å–ø–æ—Ä—Ç
ü§æ‚Äç‚ôÇ	–≥–∞–Ω–¥–±–æ–ª, –≥–∞–Ω–¥–±–æ–ª—ñ—Å—Ç, —Å–ø–æ—Ä—Ç, —á–æ–ª–æ–≤—ñ–∫
ü§æ‚Äç‚ôÄ	–≥–∞–Ω–¥–±–æ–ª, –≥–∞–Ω–¥–±–æ–ª—ñ—Å—Ç–∫–∞, –∂—ñ–Ω–∫–∞, —Å–ø–æ—Ä—Ç
ü§π	–±–∞–ª–∞–Ω—Å, –∂–æ–Ω–≥–ª—é–≤–∞–Ω–Ω—è, –ª—é–¥–∏–Ω–∞, —â–æ –∂–æ–Ω–≥–ª—é—î, —É–º—ñ–Ω–Ω—è
ü§π‚Äç‚ôÇ	–±–∞–≥–∞—Ç–æ–∑–∞–¥–∞—á–Ω—ñ—Å—Ç—å, –∂–æ–Ω–≥–ª–µ—Ä, –∂–æ–Ω–≥–ª—é–≤–∞–Ω–Ω—è, —á–æ–ª–æ–≤—ñ–∫
ü§π‚Äç‚ôÄ	–±–∞–≥–∞—Ç–æ–∑–∞–¥–∞—á–Ω—ñ—Å—Ç—å, –∂–æ–Ω–≥–ª–µ—Ä–∫–∞, –∂–æ–Ω–≥–ª—é–≤–∞–Ω–Ω—è, –∂—ñ–Ω–∫–∞
üë´	–∂—ñ–Ω–∫–∞, –ø–∞—Ä–∞, —Ä—É–∫–∞, —Ç—Ä–∏–º–∞—Ç–∏, —á–æ–ª–æ–≤—ñ–∫, —á–æ–ª–æ–≤—ñ–∫ —ñ –∂—ñ–Ω–∫–∞, —â–æ —Ç—Ä–∏–º–∞—é—Ç—å—Å—è –∑–∞ —Ä—É–∫–∏
üë¨	–±–ª–∏–∑–Ω—é–∫–∏, –¥–≤–∞ —á–æ–ª–æ–≤—ñ–∫–∏, —â–æ —Ç—Ä–∏–º–∞—é—Ç—å—Å—è –∑–∞ —Ä—É–∫–∏, –∑–Ω–∞–∫ –∑–æ–¥—ñ–∞–∫—É, –ø–∞—Ä–∞, —Ä—É–∫–∞, —Ç—Ä–∏–º–∞—Ç–∏—Å—è, —á–æ–ª–æ–≤—ñ–∫
üë≠	–¥–≤—ñ –∂—ñ–Ω–∫–∏, —â–æ —Ç—Ä–∏–º–∞—é—Ç—å—Å—è –∑–∞ —Ä—É–∫–∏, –∂—ñ–Ω–∫–∞, –ø–∞—Ä–∞, —Ä—É–∫–∞, —Ç—Ä–∏–º–∞—Ç–∏
üíè	–∑–∞–∫–æ—Ö–∞–Ω—ñ—Å—Ç—å, –ø–∞—Ä–∞, —á–æ–ª–æ–≤—ñ–∫ —ñ –∂—ñ–Ω–∫–∞, —â–æ —Ü—ñ–ª—É—é—Ç—å—Å—è
üíë	–∑–∞–∫–æ—Ö–∞–Ω—ñ—Å—Ç—å, –∫–æ—Ö–∞–Ω–Ω—è, –ø–∞—Ä–∞, —Å–µ—Ä—Ü–µ, —á–æ–ª–æ–≤—ñ–∫ —ñ –∂—ñ–Ω–∫–∞ —ñ–∑ —Å–µ—Ä—Ü–µ–º –º—ñ–∂ –Ω–∏–º–∏
ü§≥	–∞–≤—Ç–æ–ø–æ—Ä—Ç—Ä–µ—Ç, –∫–∞–º–µ—Ä–∞, —Å–µ–ª—Ñ—ñ, —Ç–µ–ª–µ—Ñ–æ–Ω
üí™	–±—ñ—Ü–µ–ø—Å–∏, –∑—ñ–≥–Ω—É—Ç–∏–π, –º‚Äô—è–∑, –Ω–∞–ø—Ä—É–∂–µ–Ω–∏–π –±—ñ—Ü–µ–ø—Å, —Ç—ñ–ª–æ
ü¶µ	–∫–æ–ø–Ω—è–∫, –Ω–æ–≥–∞, —Å—Ç–µ–≥–Ω–æ, —É–¥–∞—Ä –Ω–æ–≥–æ—é
ü¶∂	–Ω–æ–≥–∞, –Ω—ñ–∂–∫–∞, —Å—Ç–æ–ø–∞, —Å—Ç—É–ø–Ω—è, —É–¥–∞—Ä
üñï	–ø–∞–ª–µ—Ü—å, —Ä—É–∫–∞, —Å–µ—Ä–µ–¥–Ω—ñ–π –ø–∞–ª–µ—Ü—å, —Ç—ñ–ª–æ
ü§û	–ø–∞–ª—å—Ü—ñ, —Å—Ö—Ä–µ—â–µ–Ω—ñ, —Å—Ö—Ä–µ—â–µ–Ω—ñ –ø–∞–ª—å—Ü—ñ, —É–¥–∞—á–∞
üññ	–≤—É–ª–∫–∞–Ω, –≤—É–ª–∫–∞–Ω—Å—å–∫–µ –≤—ñ—Ç–∞–Ω–Ω—è, –∑–æ—Ä—è–Ω–∏–π —à–ª—è—Ö, –ø–∞–ª–µ—Ü—å, —Ä—É–∫–∞, —Å–ø–æ–∫, —Ç—ñ–ª–æ
ü§ò	–∂–µ—Å—Ç ¬´—Ä–æ–≥–∏¬ª, –∫–æ–∑–∞, –ø–∞–ª–µ—Ü—å, —Ä–æ–∫, —Ä—É–∫–∞, —Å–∏–º–≤–æ–ª —Ä–æ–≥—ñ–≤ —Ä—É–∫–æ—é, —Ç—ñ–ª–æ
ü§ô	–∂–µ—Å—Ç ¬´–ø–æ–¥–∑–≤–æ–Ω–∏ –º–µ–Ω—ñ¬ª, –∂–µ—Å—Ç —Ä—É–∫–æ—é ¬´–ø–æ–¥–∑–≤–æ–Ω–∏ –º–µ–Ω—ñ¬ª, —Ä—É–∫–∞, —Ç–µ–ª–µ—Ñ–æ–Ω
‚úã	–ø—ñ–¥–Ω—è—Ç–∞ —Ä—É–∫–∞, —Ä—É–∫–∞, —Ç—ñ–ª–æ
üëå	¬´–æ‚Äô–∫–µ–π¬ª, –∂–µ—Å—Ç ¬´–æ–∫–µ–π¬ª, —Ä—É–∫–∞, —Ç—ñ–ª–æ
‚úä	–∫—É–ª–∞–∫, –ø—ñ–¥–Ω—è—Ç–∏–π –∫—É–ª–∞–∫, —Ä—É–∫–∞, —Å—Ç–∏—Å–Ω—É—Ç–∏–π, —Ç—ñ–ª–æ
üëä	–∫—É–ª–∞–∫, –∫—É–ª–∞–∫, —â–æ –Ω–∞—Å—É–≤–∞—î—Ç—å—Å—è, —Ä—É–∫–∞, —Å—Ç–∏—Å–Ω—É—Ç–∏–π, —Ç—ñ–ª–æ
ü§õ	–∫—É–ª–∞–∫, –∫—É–ª–∞–∫ —É–ª—ñ–≤–æ, —É–ª—ñ–≤–æ
ü§ú	–∫—É–ª–∞–∫, –∫—É–ª–∞–∫ —É–ø—Ä–∞–≤–æ, —É–ø—Ä–∞–≤–æ
ü§ö	–¥–æ–ª–æ–Ω—è, –ø—ñ–¥–Ω—è—Ç–∞, –ø—ñ–¥–Ω—è—Ç–∞ —Ä—É–∫–∞ —Ç–∏–ª—å–Ω–æ—é —Å—Ç–æ—Ä–æ–Ω–æ—é, —Ç–∏–ª—å–Ω–∞
üëã	–º–∞—Ö–∞—Ç–∏, –ø–æ–º–∞—Ö, —Ä—É–∫–∞, —Ä—É–∫–∞, —â–æ –º–∞—Ö–∞—î, —Ç—ñ–ª–æ
ü§ü	–∂–µ—Å—Ç ¬´–∫–æ—Ö–∞—é —Ç–µ–±–µ¬ª, –ø—ñ–¥–Ω—è—Ç–∞ —Ä—É–∫–∞
üëè	–ø–ª–µ—Å–∫–∞—Ç–∏, —Ä—É–∫–∞, —Ä—É–∫–∏, —â–æ –∞–ø–ª–æ–¥—É—é—Ç—å, —Ç—ñ–ª–æ
üëê	–≤—ñ–¥–∫—Ä–∏—Ç–∏–π, –≤—ñ–¥–∫—Ä–∏—Ç—ñ –¥–æ–ª–æ–Ω—ñ, —Ä—É–∫–∞, —Ç—ñ–ª–æ
üôå	–∂–µ—Å—Ç, –ø—ñ–¥–Ω—è—Ç–∞, —Ä—É–∫–∞, —Ä—É–∫–∏, –ø—ñ–¥–Ω—è—Ç—ñ –¥–ª—è —Å–≤—è—Ç–∫—É–≤–∞–Ω–Ω—è, —Å–≤—è—Ç–∫—É–≤–∞–Ω–Ω—è, —Ç—ñ–ª–æ, —É—Ä–∞
ü§≤	–¥–æ–ª–æ–Ω—ñ, –ø—ñ–¥–Ω—è—Ç—ñ —Ä–∞–∑–æ–º, –º–æ–ª–∏—Ç–≤–∞
üôè	–±–ª–∞–≥–∞–Ω–Ω—è, –±—É–¥—å –ª–∞—Å–∫–∞, –¥—è–∫—É—é, –∂–µ—Å—Ç, –ø—Ä–æ—Å–∏—Ç–∏, —Ä—É–∫–∞, —Ä—É–∫–∏, —Å—Ç–∏—Å–Ω—É—Ç—ñ —Ä–∞–∑–æ–º, —Å–∫–ª–∞–¥–µ–Ω—ñ, —Ç—ñ–ª–æ, —É–∫–ª—ñ–Ω
ü§ù	–∑–≥–æ–¥–∞, –ø–æ—Ç–∏—Å–∫–∞–Ω–Ω—è, —Ä—É–∫–∏, —Ä—É–∫–æ—Å—Ç–∏—Å–∫–∞–Ω–Ω—è
üíÖ	–¥–æ–≥–ª—è–¥, –∫–æ—Å–º–µ—Ç–∏–∫–∞, –ª–∞–∫, –ª–∞–∫ –¥–ª—è –Ω—ñ–≥—Ç—ñ–≤, –º–∞–Ω—ñ–∫—é—Ä, –Ω—ñ–≥–æ—Ç—å, —Ç—ñ–ª–æ
üëÉ	–Ω—ñ—Å, —Ç—ñ–ª–æ
üë£	–≤—ñ–¥–±–∏—Ç–æ–∫, –Ω–æ–≥–∞, –æ–¥—è–≥, —Å–ª—ñ–¥, —Å–ª—ñ–¥–∏ –Ω—ñ–≥, —Ç—ñ–ª–æ
üëÄ	–æ–±–ª–∏—á—á—è, –æ–∫–æ, –æ—á—ñ, —Ç—ñ–ª–æ
üëÅ‚Äçüó®	–æ–∫–æ, –æ–∫–æ –≤ —Ç–µ–∫—Å—Ç–æ–≤—ñ–π –±—É–ª—å—Ü—ñ, –æ–∫–æ –≤ —Ç–µ–∫—Å—Ç–æ–≤—ñ–π –±—É–ª—å—Ü—ñ, —â–æ —Å–∏–º–≤–æ–ª—ñ–∑—É—î –∫–∞–º–ø–∞–Ω—ñ—é –ø—Ä–æ—Ç–∏ –∑–∞–ª—è–∫—É–≤–∞–Ω–Ω—è, –ø—Ä–æ—Ç–∏ –ø–µ—Ä–µ—Å–ª—ñ–¥—É–≤–∞–Ω–Ω—è, —Å–≤—ñ–¥–æ–∫
üß†	–º–æ–∑–æ–∫, —ñ–Ω—Ç–µ–ª—ñ–≥–µ–Ω—Ç
ü¶¥	–∫–∞–ª—å—Ü—ñ–π, –∫–æ—Å—Ç—ñ, –∫—ñ—Å—Ç–∫–∞, —Å–∫–µ–ª–µ—Ç
ü¶∑	–¥–∞–Ω—Ç–∏—Å—Ç, –∑—É–±, –∑—É–±–∏, —Å—Ç–æ–º–∞—Ç–æ–ª–æ–≥
üëÖ	—Ç—ñ–ª–æ, —è–∑–∏–∫
üëÑ	–≥—É–±–∏, —Ä–æ—Ç, —Ç—ñ–ª–æ
ü¶∞	—Ä–∏–∂–∏–π, —Ä—É–¥–µ –≤–æ–ª–æ—Å—Å—è, —Ä—É–¥–∏–π, —Ä—É–¥–æ–≤–æ–ª–æ—Å–∏–π
ü¶±	–∞—Ñ—Ä–æ, –≤–æ–ª–æ—Å—Å—è, –∫—É–¥—Ä—ñ, –∫—É—á–µ—Ä—è–≤–µ –≤–æ–ª–æ—Å—Å—è, –∫—É—á–µ—Ä—è–≤–∏–π, –∫—É—á–µ—Ä—ñ
ü¶≥	–±—ñ–ª–∏–π, –≤–æ–ª–æ—Å—Å—è, —Å–∏–≤–µ –≤–æ–ª–æ—Å—Å—è, —Å–∏–≤–∏–Ω–∞, —Å—Ç–∞—Ä–∏–π
ü¶≤	–±–µ–∑ –≤–æ–ª–æ—Å—Å—è, –≤–∏–≥–æ–ª–µ–Ω–∏–π, –ª–∏—Å–∞ –≥–æ–ª–æ–≤–∞, –Ω–µ–º–∞—î –≤–æ–ª–æ—Å—Å—è, —Ö—ñ–º—ñ–æ—Ç–µ—Ä–∞–ø—ñ—è
üíã	–≤—ñ–¥–±–∏—Ç–æ–∫, –≤—ñ–¥–±–∏—Ç–æ–∫ –≤—É—Å—Ç, –≥—É–±–∏, –∑–∞–∫–æ—Ö–∞–Ω—ñ—Å—Ç—å, –ø–æ—Ü—ñ–ª—É–Ω–æ–∫, —Å–µ—Ä—Ü–µ, —Å–ª—ñ–¥ —Ü—ñ–ª—É–Ω–∫—É
üíò	–∑–∞–∫–æ—Ö–∞–Ω—ñ—Å—Ç—å, –∫—É–ø—ñ–¥–æ–Ω, —Å–µ—Ä—Ü–µ, —Å–µ—Ä—Ü–µ, –ø—Ä–æ–±–∏—Ç–µ —Å—Ç—Ä—ñ–ª–æ—é, —Å—Ç—Ä—ñ–ª–∞
üíù	–≤–∞–ª–µ–Ω—Ç–∏–Ω, —Å–µ—Ä—Ü–µ, —Å–µ—Ä—Ü–µ –∑—ñ —Å—Ç—Ä—ñ—á–∫–æ—é, —Å—Ç—Ä—ñ—á–∫–∞
üíñ	–∑–∞—Ö–æ–ø–ª–µ–Ω–Ω—è, —Å–µ—Ä—Ü–µ, —Å–µ—Ä—Ü–µ, —â–æ –≤–∏–±–ª–∏—Å–∫—É—î, —Å—è–π–≤–æ
üíó	–∑–∞—Ö–æ–ø–ª–µ–Ω–Ω—è, –∑–±—ñ–ª—å—à—É—î—Ç—å—Å—è, –Ω–µ—Ä–≤—É–≤–∞—Ç–∏, —Å–µ—Ä—Ü–µ, —Å–µ—Ä—Ü–µ, —â–æ –∑—Ä–æ—Å—Ç–∞—î, —Å–µ—Ä—Ü–µ–±–∏—Ç—Ç—è
üíì	–±–∏—Ç—Ç—è, –ø—É–ª—å—Å—É–≤–∞—Ç–∏, —Å–µ—Ä—Ü–µ, —Å–µ—Ä—Ü–µ, —â–æ –± º—î—Ç—å—Å—è, —Å–µ—Ä—Ü–µ–±–∏—Ç—Ç—è
üíû	–æ–±–µ—Ä—Ç–∞—Ç–∏—Å—è, —Å–µ—Ä—Ü–µ, —Å–µ—Ä—Ü—è, —â–æ –æ–±–µ—Ä—Ç–∞—é—Ç—å—Å—è
üíï	–¥–≤–∞ —Å–µ—Ä—Ü—è, –∫–æ—Ö–∞–Ω–Ω—è, —Å–µ—Ä—Ü–µ
üíå	–∑–∞–∫–æ—Ö–∞–Ω—Å—ñ—Ç—å, –∫–æ—Ö–∞–Ω–Ω—è, –ª–∏—Å—Ç, –ª—é–±–æ–≤–Ω–∏–π –ª–∏—Å—Ç, –ø–æ—à—Ç–∞, —Å–µ—Ä—Ü–µ
üíî	—Ä–æ–∑–±–∏–≤–∞—Ç–∏, —Ä–æ–∑–±–∏—Ç–µ, —Ä–æ–∑–±–∏—Ç–µ —Å–µ—Ä—Ü–µ, —Å–µ—Ä—Ü–µ
üß°	–æ—Ä–∞–Ω–∂–µ–≤–µ —Å–µ—Ä—Ü–µ, –ø–æ–º–∞—Ä–∞–Ω—á–µ–≤–∏–π
üíõ	–∂–æ–≤—Ç–µ —Å–µ—Ä—Ü–µ, –∂–æ–≤—Ç–∏–π, —Å–µ—Ä—Ü–µ
üíö	–∑–µ–ª–µ–Ω–µ —Å–µ—Ä—Ü–µ, –∑–µ–ª–µ–Ω–∏–π, —Å–µ—Ä—Ü–µ
üíô	—Å–µ—Ä—Ü–µ, —Å–∏–Ω—î —Å–µ—Ä—Ü–µ, —Å–∏–Ω—ñ–π
üíú	–ø—É—Ä–ø—É—Ä–æ–≤–µ —Å–µ—Ä—Ü–µ, —Å–µ—Ä—Ü–µ, —Ñ—ñ–æ–ª–µ—Ç–æ–≤–∏–π
üñ§	–∑–ª–æ, —Å–µ—Ä—Ü–µ, —á–æ—Ä–Ω–µ, —á–æ—Ä–Ω–µ —Å–µ—Ä—Ü–µ
üíü	–ø—Ä–∏–∫—Ä–∞—Å–∞ —ñ–∑ —Å–µ—Ä—Ü–µ–º, —Å–µ—Ä—Ü–µ
üí§	–∫–æ–º—ñ–∫—Å–∏, —É–º–æ–≤–Ω–µ –ø–æ–∑–Ω–∞—á–µ–Ω–Ω—è —Å–Ω—É
üí¢	–∑–ª–∏–π, –∫–æ–º—ñ–∫—Å–∏, —Ä–æ–∑–ª—é—á–µ–Ω–∏–π, —Å–∏–º–≤–æ–ª –≥–Ω—ñ–≤—É
üí•	–±—É–º, –∑—ñ—Ç–∫–Ω–µ–Ω–Ω—è, –∫–æ–º—ñ–∫—Å–∏
üí¶	–±—Ä–∏–∑–∫–∏, –∫–æ–º—ñ–∫—Å–∏, –∫—Ä–∞–ø–ª—ñ –ø–æ—Ç—É, –ø—ñ—Ç
üí®	–±—ñ–≥, –∫–æ–º—ñ–∫—Å–∏, –º—á–∞—Ç–∏, –ø–æ—Ä–∏–≤ –≤—ñ—Ç—Ä—É
üí´	–∑—ñ—Ä–∫–∞, –∫–æ–º—ñ–∫—Å–∏, —Å–∏–º–≤–æ–ª –∑–∞–ø–∞–º–æ—Ä–æ—á–µ–Ω–Ω—è
üí¨	–¥—ñ–∞–ª–æ–≥, –∫–æ–º—ñ–∫—Å–∏, —Ä–æ–∑–º–æ–≤–∞, —Ç–µ–∫—Å—Ç–æ–≤–∞ –±—É–ª—å–∫–∞, —Ö–º–∞—Ä–∏–Ω–∫–∞
üí≠	–±—É–ª—å–∫–∞ —Ä–æ–∑–¥—É–º—ñ–≤, –¥—É–º–∫–∞, –∫–æ–º—ñ–∫—Å–∏, —Ö–º–∞—Ä–∏–Ω–∫–∞
ü•Ω	–∑–∞—Ö–∏—Å–Ω—ñ –æ–∫—É–ª—è—Ä–∏, –∑–∞—Ö–∏—Å—Ç, –∑–∞—Ö–∏—Å—Ç –æ—á–µ–π, –∑–≤–∞—Ä—é–≤–∞–Ω–Ω—è, –ø–ª–∞–≤–∞–Ω–Ω—è
ü•º	–¥–æ–∫—Ç–æ—Ä, –µ–∫—Å–ø–µ—Ä–∏–º–µ–Ω—Ç, –ª–∞–±–æ—Ä–∞—Ç–æ—Ä–Ω–∏–π —Ö–∞–ª–∞—Ç, –ª—ñ–∫–∞—Ä, –Ω–∞—É–∫–æ–≤–µ—Ü—å
üëî	–∫—Ä–∞–≤–∞—Ç–∫–∞, –æ–¥—è–≥
üëï	–æ–¥—è–≥, —Ç–µ–Ω—ñ—Å–∫–∞ –ø–æ–ª–æ, —Ç–æ–ø, —Ñ—É—Ç–±–æ–ª–∫–∞
üëñ	–¥–∂–∏–Ω—Å–∏, –æ–¥—è–≥, —à—Ç–∞–Ω–∏
üß£	—à–∞—Ä—Ñ, —à–∏—è
üß§	—Ä—É–∫–∞, —Ä—É–∫–∞–≤–∏—á–∫–∏
üß•	–∫—É—Ä—Ç–∫–∞, –ø–∞–ª—å—Ç–æ
üß¶	–ø–∞–Ω—á–æ—Ö–∏, —à–∫–∞—Ä–ø–µ—Ç–∫–∏
üëó	–æ–¥—è–≥, —Å—É–∫–Ω—è
üëò	–∫—ñ–º–æ–Ω–æ, –æ–¥—è–≥
üëô	–±—ñ–∫—ñ–Ω—ñ, –æ–¥—è–≥, –ø–ª–∞–≤–∞—Ç–∏
üëö	–∂—ñ–Ω–∫–∞, –∂—ñ–Ω–æ—á–∏–π –æ–¥—è–≥, –æ–¥—è–≥
üëõ	–∞–∫—Å–µ—Å—É–∞—Ä, –≥–∞–º–∞–Ω–µ—Ü—å, –≥—Ä–æ—à—ñ, –º–æ–Ω–µ—Ç–∞, –æ–¥—è–≥
üëú	–æ–¥—è–≥, —Å—É–º–∫–∞
üëù	–∫–ª–∞—Ç—á, –æ–¥—è–≥, —Å—É–º–∫–∞
üéí	–Ω–∞–≤—á–∞–Ω–Ω—è, —Ä–∞–Ω–µ—Ü—å, —Å—É–º–∫–∞, —à–∫–æ–ª–∞, —à–∫—ñ–ª—å–Ω–∏–π —Ä—é–∫–∑–∞–∫
üëû	–≤–∑—É—Ç—Ç—è, –æ–¥—è–≥, —á–æ–ª–æ–≤—ñ–∫, —á–æ–ª–æ–≤—ñ—á–∞ —Ç—É—Ñ–ª—è
üëü	–≤–∑—É—Ç—Ç—è, –∫—Ä–æ—Å—ñ–≤–∫–∞, –∫—Ä–æ—Å—ñ–≤–æ–∫, –æ–¥—è–≥, —Å–ø–æ—Ä—Ç–∏–≤–Ω–∏–π
ü•æ	–≤–∑—É—Ç—Ç—è, –ø–æ—Ö—ñ–¥, –ø–æ—Ö—ñ–¥–Ω—ñ —á–µ—Ä–µ–≤–∏–∫–∏, —Ç–∞–±—ñ—Ä, —Ç—É—Ä–∏—Å—Ç–∏—á–Ω—ñ —á–æ–±–æ—Ç–∏, —Ö–∞–π–∫—ñ–Ω–≥
ü•ø	–±–∞–ª–µ—Ç–∫–∏, –∫–µ–¥–∏, —Å–ª—ñ–ø–æ–Ω–∏, —Ç–∞–ø–æ—á–∫–∏, —Ç—É—Ñ–ª—ñ –±–µ–∑ –ø—ñ–¥–±–æ—Ä—ñ–≤
üë†	–≤–∑—É—Ç—Ç—è, –∂—ñ–Ω–∫–∞, –∫–∞–±–ª—É–∫, –æ–¥—è–≥, —Ç—É—Ñ–ª—è –Ω–∞ –≤–∏—Å–æ–∫–æ–º—É –ø—ñ–¥–±–æ—Ä—ñ
üë°	–≤–∑—É—Ç—Ç—è, –∂—ñ–Ω–∫–∞, –∂—ñ–Ω–æ—á–∞ —Å–∞–Ω–¥–∞–ª—ñ—è –∑ –ø—ñ–¥–±–æ—Ä–æ–º, –æ–¥—è–≥, —Å–∞–Ω–¥–∞–ª—ñ
üë¢	–≤–∑—É—Ç—Ç—è, –∂—ñ–Ω–∫–∞, –∂—ñ–Ω–æ—á–∏–π —á–æ–±—ñ—Ç, –æ–¥—è–≥, —á–æ–±—ñ—Ç
üëë	–∫–æ—Ä–æ–ª–µ–≤–∞, –∫–æ—Ä–æ–ª—å, –∫–æ—Ä–æ–Ω–∞, –æ–¥—è–≥
üëí	–∂—ñ–Ω–∫–∞, –∂—ñ–Ω–æ—á–∏–π –∫–∞–ø–µ–ª—é—à–æ–∫, –∫–∞–ø–µ–ª—é—Ö, –æ–¥—è–≥
üé©	–∫–∞–ø–µ–ª—é—Ö, –æ–¥—è–≥, —Ü–∏–ª—ñ–Ω–¥—Ä (–∫–∞–ø–µ–ª—é—Ö), —á–æ–ª–æ–≤—ñ–∫
üß¢	–±–µ–π—Å–±–æ–ª–∫–∞, –∫–∞—à–∫–µ—Ç
üìø	–≤–µ—Ä–≤–∏—Ü—è, –º–æ–ª–∏—Ç–∏—Å—è, –º–æ–ª–∏—Ç–æ–≤–Ω—ñ —á–æ—Ç–∫–∏, –æ–¥—è–≥, —Ä–µ–ª—ñ–≥—ñ—è, —á–æ—Ç–∫–∏
üíÑ	–≥—É–±–Ω–∞ –ø–æ–º–∞–¥–∞, –∫–æ—Å–º–µ—Ç–∏–∫–∞, –ø–æ–º–∞–¥–∞
üíç	–¥—ñ–∞–º–∞–Ω—Ç, –∫–∞–±–ª—É—á–∫–∞, –∫–æ—Ö–∞–Ω–Ω—è
üíé	–¥–æ—Ä–æ–≥–æ—Ü—ñ–Ω–Ω–∏–π, –¥—ñ–∞–º–∞–Ω—Ç, –∫–∞–º—ñ–Ω—å, –∫–æ—Ö–∞–Ω–Ω—è, –∫–æ—à—Ç–æ–≤–Ω–∏–π –∫–∞–º—ñ–Ω—å
üêµ	–º–∞–≤–ø–∞, –º–æ—Ä–¥–∞, –º–æ—Ä–¥–∞ –º–∞–≤–ø–∏
üêí	–º–∞–≤–ø–∞
ü¶ç	–≥–æ—Ä–∏–ª–∞, —Ç–≤–∞—Ä–∏–Ω–∞
üê∂	–º–æ—Ä–¥–∞, –º–æ—Ä–¥–∞ —Å–æ–±–∞–∫–∏, –ø–µ—Å, —Å–æ–±–∞–∫–∞
üê©	–ø–µ—Å, –ø—É–¥–µ–ª—å, —Å–æ–±–∞–∫–∞
üê∫	–≤–æ–≤–∫, –º–æ—Ä–¥–∞, –º–æ—Ä–¥–∞ –≤–æ–≤–∫–∞
ü¶ä	–ª–∏—Å, –ª–∏—Å–∏—Ü—è, –º–æ—Ä–¥–∞, –º–æ—Ä–¥–∞ –ª–∏—Å–∞, —Ç–≤–∞—Ä–∏–Ω–∞
ü¶ù	–ø–æ–ª–æ—Å–∫—É–Ω, —Ä–∞–∫—É–Ω, —Ö–∏—Ç—Ä–∏–π, —à–∏–±–µ–Ω–∏–∫, —î–Ω–æ—Ç
üê±	–∫—ñ—Ç, –º–æ—Ä–¥–∞, –º–æ—Ä–¥–∞ –∫–æ—Ç–∞
ü¶Å	–∑–Ω–∞–∫, –∑–æ–¥—ñ–∞–∫, –ª–µ–≤, –º–æ—Ä–¥–∞, –º–æ—Ä–¥–∞ –ª–µ–≤–∞
üêØ	–º–æ—Ä–¥–∞, –º–æ—Ä–¥–∞ —Ç–∏–≥—Ä–∞, —Ç–∏–≥—Ä
üêÖ	—Ç–∏–≥—Ä
üêÜ	–ª–µ–æ–ø–∞—Ä–¥
üê¥	–≥–æ–ª–æ–≤–∞ –∫–æ–Ω—è, –∫—ñ–Ω—å, –º–æ—Ä–¥–∞
üêé	–∫—ñ–Ω—å, —Å–∫–∞—á–∫–∏
ü¶Ñ	–≥–æ–ª–æ–≤–∞ —î–¥–∏–Ω–æ—Ä–æ–≥–∞, –º–æ—Ä–¥–∞, —î–¥–∏–Ω–æ—Ä—ñ–≥
ü¶ì	–∑–µ–±—Ä–∞, —Å–º—É–≥–∞
ü¶å	–æ–ª–µ–Ω—å, —Ç–≤–∞—Ä–∏–Ω–∞
üêÆ	–∫–æ—Ä–æ–≤–∞, –º–æ—Ä–¥–∞, –º–æ—Ä–¥–∞ –∫–æ—Ä–æ–≤–∏
üêÇ	–±–∏–∫, –∑–æ–¥—ñ–∞–∫, —Ç–µ–ª–µ—Ü—å
üêÉ	–±—É–π–≤—ñ–ª
üêÑ	–∫–æ—Ä–æ–≤–∞
üê∑	–º–æ—Ä–¥–∞, —Ä–∏–ª–æ —Å–≤–∏–Ω—ñ, —Å–≤–∏–Ω—è
üêñ	—Å–≤–∏–Ω—è
üêó	–≤–µ–ø—Ä
üêΩ	c–≤–∏–Ω—è—á–∏–π –ø º—è—Ç–∞–∫, –º–æ—Ä–¥–∞, —Ä–∏–ª–æ, —Å–≤–∏–Ω—è
üêè	–±–∞—Ä–∞–Ω, –≤—ñ–≤—Ü—è, –∑–æ–¥—ñ–∞–∫, –æ–≤–µ–Ω
üêë	–≤—ñ–≤—Ü—è
üêê	–∑–æ–¥—ñ–∞–∫, –∫–æ–∑–µ–ª, –∫–æ–∑–µ—Ä—ñ–≥
üê™	–≥–æ—Ä–±, –¥—Ä–æ–º–∞–¥–µ—Ä, –æ–¥–Ω–æ–≥–æ—Ä–±–∏–π, –æ–¥–Ω–æ–≥–æ—Ä–±–∏–π –≤–µ—Ä–±–ª—é–¥
üê´	–±–∞–∫—Ç—Ä—ñ–∞–Ω, –≤–µ—Ä–±–ª—é–¥, –≥–æ—Ä–±, –¥–≤–æ–≥–æ—Ä–±–∏–π, –¥–≤–æ–≥–æ—Ä–±–∏–π –≤–µ—Ä–±–ª—é–¥
ü¶ô	–∞–ª—å–ø–∞–∫–∞, –≥—É–∞–Ω–∞–∫–æ, –ª–∞–º–∞, —Ç–≤–∞—Ä–∏–Ω–∞, —Ö—É—Ç—Ä–æ, —à–µ—Ä—Å—Ç—å
ü¶í	–∂–∏—Ä–∞—Ñ–∞, –ø–ª—è–º–∏
üêò	—Å–ª–æ–Ω
ü¶è	–Ω–æ—Å–æ—Ä—ñ–≥, —Ç–≤–∞—Ä–∏–Ω–∞
ü¶õ	–±–µ–≥–µ–º–æ—Ç, –≥—ñ–ø–æ–ø–æ—Ç–∞–º
üê≠	–º–∏—à–∞, –º–∏—à–∞—á–∞ –º–æ—Ä–¥–∞, –º–æ—Ä–¥–∞, –º–æ—Ä–¥–∞ –º–∏—à—ñ
üêÅ	–º–∏—à–∞
üêÄ	–ø–∞—Ü—é–∫, —â—É—Ä
üêπ	–º–æ—Ä–¥–∞, –º–æ—Ä–¥–∞ —Ö–æ–º‚Äô—è–∫–∞, —Ö–æ–º‚Äô—è–∫
üê∞	–∫—Ä–æ–ª–∏–∫, –∫—Ä–æ–ª—è—á–∞ –º–æ—Ä–¥–∞, –º–æ—Ä–¥–∞, –º–æ—Ä–¥–∞ –∫—Ä–æ–ª—è
üêá	–∫—Ä–æ–ª–∏–∫
ü¶î	–≥–æ–ª—á–∞—Å—Ç–∏–π, —ó–∂–∞–∫
ü¶á	–≤–∞–º–ø—ñ—Ä, –∫–∞–∂–∞–Ω, —Ç–≤–∞—Ä–∏–Ω–∞
üêª	–≤–µ–¥–º–µ–∂–∞—á–∞ –º–æ—Ä–¥–∞, –≤–µ–¥–º—ñ–¥—å, –º–æ—Ä–¥–∞, –º–æ—Ä–¥–∞ –≤–µ–¥–º–µ–¥—è
üê®	–≤–µ–¥–º—ñ–¥—å, –∫–æ–∞–ª–∞
üêº	–º–æ—Ä–¥–∞, –º–æ—Ä–¥–∞ –ø–∞–Ω–¥–∏, –ø–∞–Ω–¥–∞
ü¶ò	–ê–≤—Å—Ç—Ä–∞–ª—ñ—è, –∫–µ–Ω–≥—É—Ä—É, –∫–µ–Ω–≥—É—Ä—è—Ç–∫–æ, —Å—Ç—Ä–∏–±–æ–∫, —Å—É–º—á–∞—Å—Ç–∏–π
ü¶°	–±–æ—Ä—Å—É–∫, –∫—É–Ω–∏—Ü–µ–≤—ñ, –º—É—Å—Ç–µ–ª–æ–≤—ñ, —Å—Å–∞–≤–µ—Ü—å, —Ö—É—Ç—Ä–æ
üêæ	–≤—ñ–¥–±–∏—Ç–∫–∏ –ª–∞–ø, –ª–∞–ø–∞, —Å–ª—ñ–¥, —Å–ª—ñ–¥–∏ –ª–∞–ø
ü¶É	—ñ–Ω–¥–∏–∫
üêî	–∫—É—Ä–∫–∞
üêì	–ø—ñ–≤–µ–Ω—å
üê£	–∫—É—Ä—á–∞, –∫—É—Ä—á–∞, —â–æ –≤–∏–ª—É–ø–ª—é—î—Ç—å—Å—è, –ø—Ä–æ–∫–ª—å–æ–≤—É–≤–∞—Ç–∏—Å—è
üê§	–∫—É—Ä–∫–∞, –∫—É—Ä—á–∞, –∫—É—Ä—á–∞—Ç–∫–æ, –º–∞–ª–µ –∫—É—Ä—á–∞
üê•	–∫—É—Ä—á–∞, –∫—É—Ä—á–∞, —â–æ —Å—Ç–æ—ó—Ç—å
üêß	–ø—ñ–Ω–≥–≤—ñ–Ω
ü¶Ö	–æ—Ä–µ–ª, –ø—Ç–∞—Ö
ü¶Ü	–∫–∞—á–∫–∞, –ø—Ç–∞—Ö
ü¶¢	–≥–∏–¥–∫–µ –∫–∞—á–µ–Ω—è, –ª–µ–±—ñ–¥—å, –æ–∑–µ—Ä–æ, –ø—Ç–∞—Ö
ü¶â	–º—É–¥—Ä—ñ—Å—Ç—å, –ø—Ç–∞—Ö, —Å–æ–≤–∞
ü¶ö	–ø–∞–≤–∏—á, –ø–∞–≤–ª—ñ–Ω, –ø—Ç–∞—Ö, —Ñ–∞–∑–∞–Ω, —Ö–≤—ñ—Å—Ç
ü¶ú	–∞—Ä–∞, –ø–∞–ø—É–≥–∞, –ø–∞–ø—É–≥–∞–π, –ø–æ–ø—É–≥–∞–π, –ø—Ç–∞—Ö, –ø—ñ—Ä–∞—Ç
üê∏	–∂–∞–± º—è—á–∞ –º–æ—Ä–¥–∞, –º–æ—Ä–¥–∞, –º–æ—Ä–¥–∞ –∂–∞–±–∏
üêä	–∫—Ä–æ–∫–æ–¥–∏–ª
üê¢	—á–µ—Ä–µ–ø–∞—Ö–∞
ü¶é	—Ä–µ–ø—Ç–∏–ª—ñ—è, —è—â—ñ—Ä–∫–∞
üêç	–∑–º—ñ—è, –∑–º—ñ—î–Ω–æ—Å–µ—Ü—å, –∑–æ–¥—ñ–∞–∫
üê≤	–≥–æ–ª–æ–≤–∞, –≥–æ–ª–æ–≤–∞ –¥—Ä–∞–∫–æ–Ω–∞, –¥—Ä–∞–∫–æ–Ω, –∫–∞–∑–∫–∞
üêâ	–¥—Ä–∞–∫–æ–Ω, –∫–∞–∑–∫–∞
ü¶ï	–±—Ä–∞—Ö—ñ–æ–∑–∞–≤—Ä, –±—Ä–æ–Ω—Ç–æ–∑–∞–≤—Ç, –¥–∏–ø–ª–æ–¥–æ–∫, –∑–∞–≤—Ä–æ–ø–æ–¥
ü¶ñ	–¢–∏—Ä–∞–Ω–æ–∑–∞–≤—Ä –†–µ–∫—Å, —Ç–∏—Ä–∞–Ω–æ–∑–∞–≤—Ä
üê≥	–∫–∏—Ç, –∫–∏—Ç, —â–æ –ø—É—Å–∫–∞—î —Ñ–æ–Ω—Ç–∞–Ω, —Ñ–æ–Ω—Ç–∞–Ω
üêã	–∫–∏—Ç
üê¨	–¥–µ–ª—å—Ñ—ñ–Ω, –ø–ª–∞–≤–µ—Ü—å
üê†	—Ä–∏–±–∞, —Ç—Ä–æ–ø—ñ—á–Ω–∞ —Ä–∏–±–∞, —Ç—Ä–æ–ø—ñ—á–Ω–∏–π
üê°	—Ä–∏–±–∞, —Ä–∏–±–∞-–∫—É–ª—è
ü¶à	–∞–∫—É–ª–∞, —Ä–∏–±–∞
üêô	–≤–æ—Å—å–º–∏–Ω—ñ–≥
üêö	–º–æ—Ä—Å—å–∫–∞ –º—É—à–ª—è, –º—É—à–ª—è, —Å–ø—ñ—Ä–∞–ª—å–Ω–∏–π
ü¶Ä	–∑–æ–¥—ñ–∞–∫, –∫—Ä–∞–±, —Ä–∞–∫
ü¶û	–¥–∞—Ä–∏ –º–æ—Ä—è, –∫–ª–µ—à–Ω—ñ, –ª–æ–±—Å—Ç–µ—Ä, –º–æ—Ä–µ–ø—Ä–æ–¥—É–∫—Ç–∏, –æ–º–∞—Ä, —Ä–∞–∫
ü¶ê	–∫—Ä–µ–≤–µ—Ç–∫–∞, –º–æ—Ä–µ–ø—Ä–æ–¥—É–∫—Ç, —ó–∂–∞
ü¶ë	–∫–∞–ª—å–º–∞—Ä, –º–æ–ª—é—Å–∫, —ó–∂–∞
üêå	—Ä–∞–≤–ª–∏–∫
ü¶ã	–∫–æ–º–∞—Ö–∞, –∫—Ä–∞—Å–∞, –º–µ—Ç–µ–ª–∏–∫
üêõ	–∫–æ–º–∞—Ö–∞
üêú	–∫–æ–º–∞—Ö–∞, –º—É—Ä–∞—Ö–∞
üêù	–±–¥–∂–æ–ª–∞, –∫–æ–º–∞—Ö–∞
üêû	–∫–æ–º–∞—Ö–∞, —Å–æ–Ω–µ—á–∫–æ
ü¶ó	–∫–æ–Ω–∏–∫, —Ü–≤—ñ—Ä–∫—É–Ω
ü¶Ç	–∑–æ–¥—ñ–∞–∫, —Å–∫–æ—Ä–ø—ñ–æ–Ω
ü¶ü	–≤—ñ—Ä—É—Å, –∂–∞—Ä, –∫–æ–º–∞—Ä, –∫–æ–º–∞—Ö–∞, –º–∞–ª—è—Ä—ñ—è, –º–æ—Å–∫—ñ—Ç, —Ö–≤–æ—Ä–æ–±–∞
ü¶†	–∞–º–µ–±–∞, –±–∞–∫—Ç–µ—Ä—ñ—è, –≤—ñ—Ä—É—Å, –º—ñ–∫—Ä–æ–±, –º—ñ–∫—Ä–æ–æ—Ä–≥–∞–Ω—ñ–∑–º, —Ö–≤–æ—Ä–æ–±–∞
üíê	–±—É–∫–µ—Ç, –∫–≤—ñ—Ç–∫–∞, –∫–æ—Ö–∞–Ω–Ω—è, —Ä–æ—Å–ª–∏–Ω–∞
üå∏	–≤–∏—à–Ω–µ–≤–∏–π —Ü–≤—ñ—Ç, –≤–∏—à–Ω—è, –∫–≤—ñ—Ç–∫–∞, —Ä–æ—Å–ª–∏–Ω–∞, —Ü–≤—ñ—Ç
üíÆ	–±—ñ–ª–∞ –∫–≤—ñ—Ç–∫–∞, –∫–≤—ñ—Ç–∫–∞
üåπ	–∫–≤—ñ—Ç–∫–∞, —Ä–æ—Å–ª–∏–Ω–∞, —Ç—Ä–æ—è–Ω–¥–∞
ü•Ä	–∑–∞–≤ º—è–ª–∞ —Ç—Ä–æ—è–Ω–¥–∞, –∑—ñ–≤‚Äô—è–ª–∞, –∫–≤—ñ—Ç–∫–∞, –ø—Ä–∏–≤ º—è–ª–∞ —Ç—Ä–æ—è–Ω–¥–∞
üå∫	–≥—ñ–±—ñ—Å–∫—É—Å, –∫–≤—ñ—Ç–∫–∞, —Ä–æ—Å–ª–∏–Ω–∞
üåª	c–æ–Ω—è—à–Ω–∏–∫, –∫–≤—ñ—Ç–∫–∞, —Ä–æ—Å–ª–∏–Ω–∞, —Å–æ–Ω—Ü–µ, —Å–æ–Ω—è—à–Ω–∏–∫
üåº	–∂–æ–≤—Ç–∞ –∫–≤—ñ—Ç–∫–∞, –∫–≤—ñ—Ç–∫–∞, —Ä–æ—Å–ª–∏–Ω–∞
üå∑	–∫–≤—ñ—Ç–∫–∞, —Ä–æ—Å–ª–∏–Ω–∞, —Ç—é–ª—å–ø–∞–Ω
üå±	–ø–∞—Ä–æ—Å—Ç–æ–∫, —Ä–æ—Å–ª–∏–Ω–∞, —Å—ñ—è–Ω–µ—Ü—å
üå≤	–≤—ñ—á–Ω–æ–∑–µ–ª–µ–Ω–µ –¥–µ—Ä–µ–≤–æ, –¥–µ—Ä–µ–≤–æ, —Ä–æ—Å–ª–∏–Ω–∞
üå≥	–¥–µ—Ä–µ–≤–æ, –ª–∏—Å—Ç—è–Ω–µ –¥–µ—Ä–µ–≤–æ, –ª–∏—Å—Ç—è–Ω–∏–π, –æ–ø–∞–¥–∞—î, —Ä–æ—Å–ª–∏–Ω–∞
üå¥	–¥–µ—Ä–µ–≤–æ, –ø–∞–ª—å–º–∞, —Ä–æ—Å–ª–∏–Ω–∞
üåµ	–∫–∞–∫—Ç—É—Å, —Ä–æ—Å–ª–∏–Ω–∞
üåæ	–∫–æ–ª–æ—Å, —Ä–∏—Å, —Ä–∏—Å–æ–≤–∏–π –∫–æ–ª–æ—Å–æ–∫, —Ä–æ—Å–ª–∏–Ω–∞, —Å–Ω—ñ–ø–æ–∫ —Ä–∏—Å—É
üåø	–ª–∏—Å—Ç–æ–∫, –ª—ñ–∫–∞—Ä—Å—å–∫–∞ —Ä–æ—Å–ª–∏–Ω–∞, —Ä–æ—Å–ª–∏–Ω–∞
üçÄ	4, –∫–æ–Ω—é—à–∏–Ω–∞, –ª–∏—Å—Ç–æ–∫, —Ä–æ—Å–ª–∏–Ω–∞, —á–æ—Ç–∏—Ä–∏, —á–æ—Ç–∏—Ä–∏–ª–∏—Å—Ç–∫–æ–≤–∞ –∫–æ–Ω—é—à–∏–Ω–∞
üçÅ	–∫–ª–µ–Ω, –∫–ª–µ–Ω–æ–≤–∏–π –ª–∏—Å—Ç–æ–∫, –ª–∏—Å—Ç–æ–∫, –æ–ø–∞–¥–∞—Ç–∏, —Ä–æ—Å–ª–∏–Ω–∞
üçÇ	–ª–∏—Å—Ç–æ–∫, –æ–ø–∞–¥–∞—Ç–∏, –æ–ø–∞–ª–µ –ª–∏—Å—Ç—è, —Ä–æ—Å–ª–∏–Ω–∞
üçÉ	–≤—ñ—Ç–µ—Ä, –¥—É—Ç–∏, –∫—Ä—É–∂–ª—è—Ç–∏, –ª–∏—Å—Ç–æ–∫, –ª–∏—Å—Ç—è, —â–æ –∫—Ä—É–∂–ª—è—î –∑–∞ –≤—ñ—Ç—Ä–æ–º, —Ä–æ—Å–ª–∏–Ω–∞
üçá	–≤–∏–Ω–æ–≥—Ä–∞–¥, –≤–∏–Ω–æ–≥—Ä–∞–¥–∏–Ω–∞, –≤–∏–Ω–æ–≥—Ä–∞–¥–∏–Ω–∏, –ø–ª—ñ–¥
üçà	–¥–∏–Ω—è, –ø–ª—ñ–¥
üçâ	–∫–∞–≤—É–Ω, –ø–ª—ñ–¥
üçä	–º–∞–Ω–¥–∞—Ä–∏–Ω, –æ—Ä–∞–Ω–∂–µ–≤–∏–π, –ø–ª—ñ–¥, —Ç–∞–Ω–∂–µ—Ä–∏–Ω
üçã	–ª–∏–º–æ–Ω, –ø–ª—ñ–¥, —Ü–∏—Ç—Ä—É—Å
üçå	–±–∞–Ω–∞–Ω, –ø–ª—ñ–¥
üçç	–∞–Ω–∞–Ω–∞—Å, –ø–ª—ñ–¥
ü•≠	–º–∞–Ω–≥–æ, –ø–ª—ñ–¥, —Ç—Ä–æ–ø—ñ—á–Ω–∏–π
üçé	–ø–ª—ñ–¥, —á–µ—Ä–≤–æ–Ω–µ —è–±–ª—É–∫–æ, —á–µ—Ä–≤–æ–Ω–∏–π, —è–±–ª—É–∫–æ
üçè	–∑–µ–ª–µ–Ω–µ —è–±–ª—É–∫–æ, –∑–µ–ª–µ–Ω–∏–π, –ø–ª—ñ–¥, —è–±–ª—É–∫–æ
üçê	–≥—Ä—É—à–∞, –ø–ª—ñ–¥
üçë	–ø–µ—Ä—Å–∏–∫, –ø–ª—ñ–¥
üçí	–≤–∏—à–Ω—è, –≤–∏—à–Ω—ñ, –ø–ª–æ–¥–∏, —á–µ—Ä–≤–æ–Ω—ñ
üçì	–ø–ª—ñ–¥, –ø–æ–ª—É–Ω–∏—Ü—è, —è–≥–æ–¥–∞
ü•ù	–∫—ñ–≤—ñ, –ø–ª—ñ–¥, —ó–∂–∞
üçÖ	–æ–≤–æ—á, –ø–ª—ñ–¥, –ø–æ–º—ñ–¥–æ—Ä, —Ç–æ–º–∞—Ç
ü••	–∫–æ–∫–æ—Å, –ø–∞–ª—å–º–∞, –ø—ñ–Ω—å—è –∫–æ–ª–∞–¥–∞
ü•ë	–∞–≤–æ–∫–∞–¥–æ, –ø–ª—ñ–¥, —ó–∂–∞
üçÜ	–±–∞–∫–ª–∞–∂–∞–Ω, –æ–≤–æ—á
ü•î	–∫–∞—Ä—Ç–æ–ø–ª—è, –æ–≤–æ—á, —ó–∂–∞
ü•ï	–º–æ—Ä–∫–≤–∞, –º–æ—Ä–∫–≤–∏–Ω–∞, –æ–≤–æ—á, —ó–∂–∞
üåΩ	–∫–∞—á–∞–Ω, –∫–∞—á–∞–Ω –∫—É–∫—É—Ä—É–¥–∑–∏, –∫—É–∫—É—Ä—É–¥–∑–∞, –º–∞—ó—Å, —Å—É—Ü–≤—ñ—Ç—Ç—è
ü•í	–∫–æ—Ä–Ω—ñ—à–æ–Ω, –æ–≤–æ—á, –æ–≥—ñ—Ä–æ–∫, –æ–∫—ñ—Ä–æ–∫, —ó–∂–∞
ü•¨	–±–æ–∫-—á–æ–π, –∑–µ–ª–µ–Ω—å, –∫–∞–ø—É—Å—Ç–∞, –ª–∏—Å—Ç–æ–∫, –ª–∏—Å—Ç—è, –ª–∏—Å—Ç—è —Å–∞–ª–∞—Ç—É, —Å–∞–ª–∞—Ç
ü•¶	–±—Ä–æ–∫–æ–ª—ñ, –∫—É—á–µ—Ä—è–≤–∞, —Ü–≤—ñ—Ç–Ω–∞ –∫–∞–ø—É—Å—Ç–∞
üçÑ	–≥—Ä–∏–±, –≥—Ä–∏–± —ñ–∑ —à–∞–ø–∏–Ω–∫–æ—é, –ø–ª–æ–¥–æ–≤–µ —Ç—ñ–ª–æ
ü•ú	–∞—Ä–∞—Ö—ñ—Å, –≥–æ—Ä—ñ—Ö, –∑–µ–º–ª—è–Ω–∏–π –≥–æ—Ä—ñ—Ö, —ó—Å—Ç—ñ–≤–Ω–∏–π
üå∞	–∫–∞—à—Ç–∞–Ω, —Ä–æ—Å–ª–∏–Ω–∞
üçû	–ø–∞–ª—è–Ω–∏—Ü—è, —Ö–ª—ñ–±, —Ö–ª—ñ–±–∏–Ω–∞
ü•ê	–±—É–ª–æ—á–Ω–∏–π –≤–∏—Ä—ñ–±, –∑–≤—ñ–π –ø—ñ–≤–º—ñ—Å—è—Ü–µ–º, –∫—Ä—É–∞—Å–∞–Ω, —Ñ—Ä–∞–Ω—Ü—É–∑—å–∫–∏–π, —ó–∂–∞
ü•ñ	–±–∞–≥–µ—Ç, –±—É–ª–∫–∞, —Ñ—Ä–∞–Ω—Ü—É–∑—å–∫–∏–π, —Ö–ª—ñ–±, —ó–∂–∞
ü•®	–∫—Ä–µ–Ω–¥–µ–ª–∏–∫, –∫—Ä–µ–Ω–¥–µ–ª—å, —Å–ø–ª–µ—Ç–µ–Ω–∏–π
ü•Ø	–±–∞–≥–µ–ª—å, –±–µ–π–≥–ª, –±—É–±–ª–∏–∫, –±—É–ª–æ—á–∫–∞, –≤–∏–ø—ñ—á–∫–∞, –ø–æ–Ω—á–∏–∫
ü•û	–∫—Ä–µ–ø, –º–ª–∏–Ω–µ—Ü—å, –º–ª–∏–Ω—Ü—ñ, –Ω–∞–ª–∏—Å–Ω–∏–∫, –Ω–∞–ª–∏—Å–Ω–∏–∫–∏, —ó–∂–∞
üßÄ	–∫—É—Å–µ–Ω—å —Å–∏—Ä—É, —Å–∏—Ä, —à–º–∞—Ç–æ–∫ —Å–∏—Ä—É
üçñ	–∫—ñ—Å—Ç–∫–∞, –º‚Äô—è—Å–æ, –º‚Äô—è—Å–æ –Ω–∞ –∫—ñ—Å—Ç—Ü—ñ
üçó	–∫—É—Ä–∫–∞, –∫—ñ—Å—Ç–∫–∞, –Ω—ñ–∂–∫–∞, –Ω—ñ–∂–∫–∞ —Å–≤—ñ–π—Å—å–∫–æ—ó –ø—Ç–∏—Ü—ñ, –ø—Ç–∏—Ü—è
ü•©	–±–∞—Ä–∞–Ω—è—á–∞ –≤—ñ–¥–±–∏–≤–Ω–∞, –∫–æ—Ç–ª–µ—Ç–∞, –º º—è—Å–Ω–∏–π —Ñ—ñ–ª–µ–π, —Å–≤–∏–Ω—è—á–∞ –∫–æ—Ç–ª–µ—Ç–∞, —Å—Ç–µ–π–∫
ü•ì	–±–µ–∫–æ–Ω, –º‚Äô—è—Å–æ, —ó–∂–∞
üçî	–±—É—Ä–≥–µ—Ä, –≥–∞–º–±—É—Ä–≥–µ—Ä
üçü	–∫–∞—Ä—Ç–æ–ø–ª—è, –∫–∞—Ä—Ç–æ–ø–ª—è —Ñ—Ä—ñ, —Ñ—Ä—ñ
üçï	–ø—ñ—Ü–∞, —Å–∏—Ä, —à–º–∞—Ç–æ–∫
üå≠	—Å–æ—Å–∏—Å–∫–∞, —Ö–æ—Ç-–¥–æ–≥
ü•™	—Å–∞–Ω–¥–≤—ñ—á, —Ö–ª—ñ–±
üåÆ	–º–µ–∫—Å–∏–∫–∞, —Ç–∞–∫–æ, —ó–∂–∞
üåØ	–±—É—Ä—ñ—Ç–æ, –º–µ–∫—Å–∏–∫–∞, —ó–∂–∞
ü•ô	–∫–µ–±–∞–±, –ª–∞–≤–∞—à, –Ω–∞—á–∏–Ω–µ–Ω–∏–π –∫–æ—Ä–∂–∏–∫, –Ω–∞—á–∏–Ω–∫–∞, –ø—ñ—Ç–∞, —Ñ–∞–ª–∞—Ñ–µ–ª—å, —ó–∂–∞
ü•ö	—è–π—Ü–µ, —ó–∂–∞
üç≥	–≥–æ—Ç—É–≤–∞–Ω–Ω—è —ó–∂—ñ, –ø–∞—Ç–µ–ª—å–Ω—è, —è–π—Ü–µ
ü•ò	–∫–∞—Å—Ç—Ä—É–ª—è, –∫–∞—Å—Ç—Ä—É–ª—è –∑ —ó–∂–µ—é, –ø–ª–æ–≤, —Ä–∞–≥—É, —ó–∂–∞
üç≤	–≥–æ—Ä—â–∏–∫, –≥–æ—Ä—â–∏–∫ –∑ —ó–∂–µ—é, —Ä–∞–≥—É
ü•£	–∑–∞–≤—Ç—Ä–∞–∫, –∑–ª–∞–∫–∏, –º–∏—Å–∫–∞ –∑ –ª–æ–∂–∫–æ—é, —Ä–∏—Å–æ–≤–∞ –∫–∞—à–∞
ü•ó	–∑–µ–ª–µ–Ω–∏–π, –∑–µ–ª–µ–Ω–∏–π —Å–∞–ª–∞—Ç, —Å–∞–ª–∞—Ç, —ó–∂–∞
üçø	–ø–æ–ø–∫–æ—Ä–Ω
üßÇ	–ø—Ä–∏–ø—Ä–∞–≤–∞, —Å–æ–ª—å–Ω–∏—á–∫–∞, —Å—ñ–ª—å, —Å—ñ–ª—å–Ω–∏—Ü—è, —Å—ñ–ª—å–Ω–∏—á–∫–∞
ü•´	–±–∞–Ω–∫–∞, –∫–æ–Ω—Å–µ—Ä–≤–∏
üç±	–±–µ–Ω—Ç–æ, –æ–±—ñ–¥ —É –∫–æ—Ä–æ–±—Ü—ñ, —É–ø–∞–∫–æ–≤–∫–∞
üçò	–∫—Ä–µ–∫–µ—Ä, —Ä–∏—Å, —Ä–∏—Å–æ–≤–∏–π –∫—Ä–µ–∫–µ—Ä
üçô	–∫—É–ª—å–∫–∞, —Ä–∏—Å, —Ä–∏—Å–æ–≤–∞ –∫—É–ª—å–∫–∞, —è–ø–æ–Ω—Å—å–∫–∏–π
üçö	–≤–∞—Ä–µ–Ω–∏–π, –ø—Ä–∏–≥–æ—Ç–æ–≤–∞–Ω–∏–π —Ä–∏—Å, —Ä–∏—Å
üçõ	–∫–∞—Ä—ñ, —Ä–∏—Å, —Ä–∏—Å —ñ–∑ –∫–∞—Ä—ñ
üçú	–ª–æ–∫—à–∏–Ω–∞, –º–∏—Å–∫–∞, –º–∏—Å–∫–∞, –∑ —è–∫–æ—ó –ø—ñ–¥–Ω—ñ–º–∞—î—Ç—å—Å—è –ø–∞—Ä–∞, –ø–∞—Ä—É–≤–∞—Ç–∏, —Ä–∞–º–µ–Ω
üçù	–ø–∞—Å—Ç–∞, —Å–ø–∞–≥–µ—Ç—ñ
üç†	–±–∞—Ç–∞—Ç, –ø–µ—á–µ–Ω–∏–π –±–∞—Ç–∞—Ç, –ø–µ—á–µ–Ω–∏–π —Ç–æ–ø—ñ–Ω–∞–º–±—É—Ä, —Å–º–∞–∂–∏—Ç–∏
üç¢	–∫–µ–±–∞–±, –º–æ—Ä—Å—å–∫–∏–π, –æ–¥–µ–Ω, —à–∞–º–ø—É—Ä, —ó–∂–∞
üç£	—Å—É—à—ñ
üç§	c–º–∞–∂–µ–Ω–∞ –∫—Ä–µ–≤–µ—Ç–∫–∞, –∫—Ä–µ–≤–µ—Ç–∫–∞, —Å–º–∞–∂–µ–Ω–∞ –∫—Ä–µ–≤–µ—Ç–∫–∞, —Å–º–∞–∂–µ–Ω–∏–π, —Ç–µ–º–ø—É—Ä–∞
üç•	–≤–∏–ø—ñ—á–∫–∞, —Ä–∏–±–Ω–∏–π, —Ä–∏–±–Ω–∏–π —Ä—É–ª–µ—Ç –∑—ñ —Å–ø—ñ—Ä–∞–ª—å–Ω–∏–º –≤—ñ–∑–µ—Ä—É–Ω–∫–æ–º, —Ä—É–ª–µ—Ç
ü•Æ	–ê–∑—ñ—è, –º—É–Ω–∫–µ–π–∫, –º—ñ—Å—è—á–Ω–∏–π –ø–∏—Ä—ñ–≥, –æ—Å—ñ–Ω—å, –ø–∏—Ä—ñ–∂–æ–∫, —Ñ–µ—Å—Ç–∏–≤–∞–ª—å
üç°	–¥–µ—Å–µ—Ä—Ç, —Ä–∏—Å–æ–≤—ñ –∫—É–ª—å–∫–∏ –Ω–∞ —à–ø–∞–∂—Ü—ñ, —Å–æ–ª–æ–¥–∫–∏–π, —à–∞–º–ø—É—Ä, —è–ø–æ–Ω—Å—å–∫–∏–π
ü•ü	–≤–∞—Ä–µ–Ω–∏–∫, –≤–∞—Ä–µ–Ω–∏–∫–∏, –¥–∞–º–ø–ª—ñ–Ω–≥, –µ–º–ø–∞–Ω–∞–¥–∞, –ø–æ—Ç—Å—Ç—ñ–∫–µ—Ä, —Ü–∑—è–æ—Ü–∑–∏
ü•†	–ø–µ—á–∏–≤–æ –∑ –ø–µ—Ä–µ–¥–±–∞—á–µ–Ω–Ω—è–º, –ø—Ä–æ—Ä–æ—Ü—Ç–≤–æ
ü•°	–∫–æ—Ä–æ–±–∫–∞ –∑ –∫–∏—Ç–∞–π—Å—å–∫–æ—é —ó–∂–µ—é, –∫–æ—Ä–æ–±–∫–∞ –∑ —ó–∂–µ—é –Ω–∞ –≤–∏–Ω–æ—Å
üç¶	–¥–µ—Å–µ—Ä—Ç, –º–æ—Ä–æ–∑–∏–≤–æ, –º–æ—Ä–æ–∑–∏–≤–æ –≤ —Ä—ñ–∂–∫—É, –º‚Äô—è–∫–∏–π, —Å–æ–ª–æ–¥–∫–∏–π
üçß	–¥–µ—Å–µ—Ä—Ç, –ª—å–æ–¥–æ–≤–∞ —Å—Ç—Ä—É–∂–∫–∞, –ª—ñ–¥, —Å–æ–ª–æ–¥–∫–∏–π, —Å—Ç—Ä—É–∂–∫–∞
üç®	–¥–µ—Å–µ—Ä—Ç, –º–æ—Ä–æ–∑–∏–≤–æ, —Å–æ–ª–æ–¥–∫–∏–π
üç©	–¥–µ—Å–µ—Ä—Ç, –ø–æ–Ω—á–∏–∫, —Å–æ–ª–æ–¥–∫–∏–π
üç™	–¥–µ—Å–µ—Ä—Ç, –ø–µ—á–∏–≤–æ, —Å–æ–ª–æ–¥–∫–∏–π
üéÇ	–≤–∏–ø—ñ—á–∫–∞, –¥–µ–Ω—å, –¥–µ—Å–µ—Ä—Ç, –Ω–∞—Ä–æ–¥–∂–µ–Ω–Ω—è, —Å–≤—è—Ç–∫—É–≤–∞–Ω–Ω—è, —Å–æ–ª–æ–¥–∫–∏–π, —Ç–æ—Ä—Ç, —Ç–æ—Ä—Ç –Ω–∞ –¥–µ–Ω—å –Ω–∞—Ä–æ–¥–∂–µ–Ω–Ω—è
üç∞	–≤–∏–ø—ñ—á–∫–∞, –¥–µ—Å–µ—Ä—Ç, —Å–æ–ª–æ–¥–∫–∏–π, —Ç—ñ—Å—Ç–µ—á–∫–æ, —à–º–∞—Ç–æ–∫
üßÅ	–≤–∏–ø—ñ—á–∫–∞, –∫–∞–ø–∫–µ–π–∫, –∫–µ–∫—Å, —Å–º–∞–∫–æ–ª–∏–∫, —Ç–æ—Ä—Ç, —Ç—ñ—Å—Ç–µ—á–∫–æ
ü•ß	–≤–∏–ø—ñ—á–∫–∞, –Ω–∞—á–∏–Ω–∫–∞, –ø–∏—Ä—ñ–≥
üç´	–¥–µ—Å–µ—Ä—Ç, –ø–ª–∏—Ç–∫–∞, –ø–ª–∏—Ç–∫–∞ —à–æ–∫–æ–ª–∞–¥—É, —Å–æ–ª–æ–¥–∫–∏–π, —à–æ–∫–æ–ª–∞–¥
üç¨	–¥–µ—Å–µ—Ä—Ç, —Å–æ–ª–æ–¥–∫–∏–π, —Ü—É–∫–µ—Ä–∫–∞
üç≠	–¥–µ—Å–µ—Ä—Ç, –ª—å–æ–¥—è–Ω–∏–∫, —Å–æ–ª–æ–¥–∫–∏–π, —Ü—É–∫–µ—Ä–∫–∞
üçÆ	–¥–µ—Å–µ—Ä—Ç, –∑–∞–≤–∞—Ä–Ω–∏–π –∫—Ä–µ–º, –ø—É–¥–∏–Ω–≥, —Å–æ–ª–æ–¥–∫–∏–π
üçØ	–≥–æ—Ä—â–∏–∫, –≥–æ—Ä—â–∏–∫ —ñ–∑ –º–µ–¥–æ–º, –º–µ–¥, —Å–æ–ª–æ–¥–∫–∏–π
üçº	–º–æ–ª–æ–∫–æ, –Ω–µ–º–æ–≤–ª—è, –ø–∏—Ç–∏, –ø–ª—è—à–µ—á–∫–∞, –ø–ª—è—à–µ—á–∫–∞ –¥–ª—è –Ω–µ–º–æ–≤–ª—è—Ç–∏
ü•õ	–º–æ–ª–æ–∫–æ, –Ω–∞–ø—ñ–π, —Å–∫–ª—è–Ω–∫–∞, —Å–∫–ª—è–Ω–∫–∞ –º–æ–ª–æ–∫–∞
üçµ	–Ω–∞–ø—ñ–π, —á–∞–π, —á–∞–π–Ω–∞ —á–∞—à–∫–∞ –±–µ–∑ –≤—É—à–∫–∞, —á–∞—à–∫–∞
üç∂	–±–∞—Ä, –Ω–∞–ø—ñ–π, –ø–∏—Ç–∏, –ø–ª—è—à–∫–∞, —Å–∞–∫–µ, —á–∞—à–∫–∞
üçæ	–±–∞—Ä, –∫–æ—Ä–æ–∫, –ø–∏—Ç–∏, –ø–ª—è—à–∫–∞, –ø–ª—è—à–∫–∞ –∑ –∫–æ—Ä–∫–æ–º –ø—ñ–¥ —Ç–∏—Å–∫–æ–º, –ø–ª—è—à–∫–∞ –∑ –∫–æ—Ä–∫–æ–º, —â–æ –≤–∏–ª—ñ—Ç–∞—î, —Å—Ç—Ä—ñ–ª—è—Ç–∏
üç∑	–±–∞—Ä, –≤–∏–Ω–æ, –∫–µ–ª–∏—Ö, –∫–µ–ª–∏—Ö –¥–ª—è –≤–∏–Ω–∞, –Ω–∞–ø—ñ–π, –ø–∏—Ç–∏
üçπ	–±–∞—Ä, –ø–∏—Ç–∏, —Ç—Ä–æ–ø—ñ—á–Ω–∏–π, —Ç—Ä–æ–ø—ñ—á–Ω–∏–π –Ω–∞–ø—ñ–π
üç∫	–±–∞—Ä, –∫—É—Ö–æ–ª—å, –∫—É—Ö–æ–ª—å —ñ–∑ –ø–∏–≤–æ–º, –ø–∏–≤–æ, –ø–∏—Ç–∏
üçª	–±–∞—Ä, –∫—É—Ö–ª—ñ –∑ –ø–∏–≤–æ–º, —â–æ —Ü–æ–∫–∞—é—Ç—å—Å—è, –∫—É—Ö–æ–ª—å, –ø–∏–≤–æ, –ø–∏—Ç–∏, —Ü–æ–∫–∞—Ç–∏
ü•Ç	–±–æ–∫–∞–ª—ñ–≤, –±—É–¥—å–º–æ, –¥–∑–≤—ñ–Ω, –¥–∑–≤—ñ–Ω –±–æ–∫–∞–ª—ñ–≤, –Ω–∞–ø—ñ–π, —Å–≤—è—Ç–∫—É–≤–∞–Ω–Ω—è
ü•É	–∞–ª–∫–æ–≥–æ–ª—å, –±–æ–∫–∞–ª, –±–æ–∫–∞–ª –≤—ñ—Å–∫—ñ, –≤—ñ—Å–∫—ñ, –Ω–∞–ø—ñ–π, —Å–ø–∏—Ä—Ç–Ω–µ
ü•§	—Å–æ–¥–æ–≤–∞, —Å—Ç–∞–∫–∞–Ω —ñ–∑ —Ç—Ä—É–±–æ—á–∫–æ—é, —Å—ñ–∫
ü•¢	–ø–∞–ª–∏—á–∫–∏ –¥–ª—è —ó–∂—ñ, —Ö–∞—à—ñ
üç¥	–≤–∏–¥–µ–ª–∫–∞, –≤–∏–¥–µ–ª–∫–∞ —Ç–∞ –Ω—ñ–∂, –∫—É–ª—ñ–Ω–∞—Ä—ñ—è, –Ω—ñ–∂
ü•Ñ	–ª–æ–∂–∫–∞, –ø—Ä–∏–±–æ—Ä–∏
üî™	–∑–±—Ä–æ—è, –∑–Ω–∞—Ä—è–¥–¥—è, –∫—É—Ö–Ω—è, –∫—É—Ö–æ–Ω–Ω–∏–π –Ω—ñ–∂, –Ω—ñ–∂
üè∫	–∞–º—Ñ–æ—Ä–∞, –≤–æ–¥–æ–ª—ñ–π, –≥–ª–µ–∫, –∑–±—Ä–æ—è, –∑–æ–¥—ñ–∞–∫, –∫—É–ª—ñ–Ω–∞—Ä—ñ—è, –ø–∏—Ç–∏
üåç	–∞—Ñ—Ä–∏–∫–∞, –≥–ª–æ–±—É—Å, –≥–ª–æ–±—É—Å, —â–æ –ø–æ–∫–∞–∑—É—î –Ñ–≤—Ä–æ–ø—É –π –ê—Ñ—Ä–∏–∫—É, –∑–µ–º–ª—è, —Å–≤—ñ—Ç, —î–≤—Ä–æ–ø–∞
üåè	–∞–≤—Å—Ç—Ä–∞–ª—ñ—è, –∞–∑—ñ—è, –≥–ª–æ–±—É—Å, –≥–ª–æ–±—É—Å, —â–æ –ø–æ–∫–∞–∑—É—î –ê–∑—ñ—é —ñ –ê–≤—Å—Ç—Ä–∞–ª—ñ—é, –∑–µ–º–ª—è, —Å–≤—ñ—Ç
üåê	–≥–ª–æ–±—É—Å, –∑–µ–º–ª—è, –∑–µ–º–Ω–∞ –∫—É–ª—è –∑ –º–µ—Ä–∏–¥—ñ–∞–Ω–∞–º–∏, –º–µ—Ä–∏–¥—ñ–∞–Ω–∏, —Å–≤—ñ—Ç
üóæ	–∫–∞—Ä—Ç–∞, –∫–∞—Ä—Ç–∞ –Ø–ø–æ–Ω—ñ—ó, —è–ø–æ–Ω—ñ—è
üß≠	–∫–æ–º–ø–∞—Å, –º–∞–≥–Ω–µ—Ç–∏–∑–º, –º–∞–≥–Ω—ñ—Ç, –Ω–∞–≤—ñ–≥–∞—Ü—ñ—è, –æ—Ä—ñ—î–Ω—Ç—É–≤–∞–Ω–Ω—è, —Å—Ç–æ—Ä–æ–Ω–∏ —Å–≤—ñ—Ç—É
üåã	–≤–∏–≤–µ—Ä–∂–µ–Ω–Ω—è, –≤—É–ª–∫–∞–Ω, –≥–æ—Ä–∞, –ø–æ–≥–æ–¥–∞
üóª	–≥–æ—Ä–∞, –≥–æ—Ä–∞ –§—É–¥–∑—ñ, —Ñ—É–¥–∑—ñ
üß±	–≥–ª–∏–Ω–∞, —Ä–æ–∑—á–∏–Ω, —Å—Ç—ñ–Ω–∞, —Ü–µ–≥–ª–∞, —Ü–µ–≥–ª–∏–Ω–∞
üè°	–±—É–¥–∏–Ω–æ–∫, –±—É–¥–∏–Ω–æ–∫ —ñ–∑ —Å–∞–¥–æ–º, –±—É–¥—ñ–≤–ª—è, –¥—ñ–º, —Å–∞–¥
üè¢	–±—É–¥—ñ–≤–ª—è, –æ—Ñ—ñ—Å–Ω–∞ –±—É–¥—ñ–≤–ª—è
üè£	–±—É–¥—ñ–≤–ª—è, –ø–æ—à—Ç–∞, —è–ø–æ–Ω—Å—å–∫–µ –ø–æ—à—Ç–æ–≤–µ –≤—ñ–¥–¥—ñ–ª–µ–Ω–Ω—è, —è–ø–æ–Ω—Å—å–∫–∏–π
üè§	–±—É–¥—ñ–≤–ª—è, –ø–æ—à—Ç–æ–≤–µ –≤—ñ–¥–¥—ñ–ª–µ–Ω–Ω—è, —î–≤—Ä–æ–ø–µ–π—Å—å–∫–∏–π
üè•	–±—É–¥—ñ–≤–ª—è, –ª—ñ–∫–∞—Ä, –ª—ñ–∫–∞—Ä–Ω—è, –º–µ–¥–∏—Ü–∏–Ω–∞
üè¶	–±–∞–Ω–∫, –±—É–¥—ñ–≤–ª—è
üè®	–±—É–¥—ñ–≤–ª—è, –≥–æ—Ç–µ–ª—å
üè©	–±—É–¥—ñ–≤–ª—è, –≥–æ—Ç–µ–ª—å, –≥–æ—Ç–µ–ª—å –∫–æ—Ö–∞–Ω–Ω—è, –∫–æ—Ö–∞–Ω–Ω—è
üè™	–±—É–¥—ñ–≤–ª—è, –º–∞–≥–∞–∑–∏–Ω, —Ü—ñ–ª–æ–¥–æ–±–æ–≤–∏–π, —Ü—ñ–ª–æ–¥–æ–±–æ–≤–∏–π –º–∞–≥–∞–∑–∏–Ω
üè´	–±—É–¥—ñ–≤–ª—è, —à–∫–æ–ª–∞
üè¨	–±—É–¥—ñ–≤–ª—è, —É–Ω—ñ–≤–µ—Ä–º–∞–≥
üèØ	–±—É–¥—ñ–≤–ª—è, —è–ø–æ–Ω—Å—å–∫–∏–π –∑–∞–º–æ–∫
üè∞	–±—É–¥—ñ–≤–ª—è, –∑–∞–º–æ–∫, —î–≤—Ä–æ–ø–µ–π—Å—å–∫–∞
üíí	–≤–µ—Å—ñ–ª–ª—è, –∫–∞–ø–ª–∏—Ü—è, –∫–æ—Ö–∞–Ω–Ω—è
üóº	–¢–æ–∫—ñ–π—Å—å–∫–∞ –≤–µ–∂–∞, –≤–µ–∂–∞, —Ç–æ–∫—ñ–π—Å—å–∫–∞ –≤–µ–∂–∞, —Ç–æ–∫—ñ–æ
üóΩ	—Å–≤–æ–±–æ–¥–∞, —Å—Ç–∞—Ç—É—è, —Å—Ç–∞—Ç—É—è —Å–≤–æ–±–æ–¥–∏
üïå	–º–µ—á–µ—Ç—å, –º—É—Å—É–ª—å–º–∞–Ω—Å—å–∫–∏–π, —Ä–µ–ª—ñ–≥—ñ—è, —ñ—Å–ª–∞–º
üïç	—Ä–µ–ª—ñ–≥—ñ—è, —Å–∏–Ω–∞–≥–æ–≥–∞, —Ö—Ä–∞–º, —î–≤—Ä–µ–π, —î–≤—Ä–µ–π—Å—å–∫–∏–π
üïã	–ö–∞–∞–±–∞, –º—É—Å—É–ª—å–º–∞–Ω—Å—å–∫–∏–π, —Ä–µ–ª—ñ–≥—ñ—è, —ñ—Å–ª–∞–º
üåÅ	–ø–æ–≥–æ–¥–∞, —Ç—É–º–∞–Ω, —Ç—É–º–∞–Ω–Ω–æ
üåÉ	–∑–æ—Ä—è–Ω–∞ –Ω—ñ—á, –∑—ñ—Ä–∫–∞, –Ω—ñ—á, –ø–æ–≥–æ–¥–∞
üåÑ	–≥–æ—Ä–∞, –ø–æ–≥–æ–¥–∞, —Ä–∞–Ω–æ–∫, —Å–æ–Ω—Ü–µ, —Å—Ö—ñ–¥, —Å—Ö—ñ–¥ —Å–æ–Ω—Ü—è –Ω–∞–¥ –≥–æ—Ä–∞–º–∏
üåÖ	–ø–æ–≥–æ–¥–∞, —Ä–∞–Ω–æ–∫, —Å–æ–Ω—Ü–µ, —Å—Ö—ñ–¥ —Å–æ–Ω—Ü—è
üåÜ	–±—É–¥—ñ–≤–ª—è, –≤–µ—á—ñ—Ä, –∑–∞—Ö—ñ–¥, –ª–∞–Ω–¥—à–∞—Ñ—Ç, –º—ñ—Å—Ç–æ, –º—ñ—Å—Ç–æ –≤ —Å—É—Ç—ñ–Ω–∫–∞—Ö, –ø–æ–≥–æ–¥–∞, —Å–æ–Ω—Ü–µ, —Å—É—Ç—ñ–Ω–∫–∏
üåá	–±—É–¥—ñ–≤–ª—è, –∑–∞—Ö—ñ–¥ —Å–æ–Ω—Ü—è, –ø–æ–≥–æ–¥–∞, —Å–æ–Ω—Ü–µ, —Å—É—Ç—ñ–Ω–∫–∏
üåâ	–º—ñ—Å—Ç, –º—ñ—Å—Ç —É–Ω–æ—á—ñ, –Ω—ñ—á, –ø–æ–≥–æ–¥–∞
üåå	–ß—É–º–∞—Ü—å–∫–∏–π —à–ª—è—Ö, –∫–æ—Å–º–æ—Å, –ø–æ–≥–æ–¥–∞
üé†	–∫–∞—Ä—É—Å–µ–ª—å, –∫–æ–Ω–∏–∫ –Ω–∞ –∫–∞—Ä—É—Å–µ–ª—ñ, –∫—ñ–Ω—å
üé°	–∫–æ–ª–µ—Å–æ, –æ–≥–ª—è–¥, –ø–∞—Ä–∫ —Ä–æ–∑–≤–∞–≥, —á–æ—Ä—Ç–æ–≤–µ –∫–æ–ª–µ—Å–æ
üé¢	–∞–º–µ—Ä–∏–∫–∞–Ω—Å—å–∫–∏–π, –∞–º–µ—Ä–∏–∫–∞–Ω—Å—å–∫—ñ –≥—ñ—Ä–∫–∏, –≥—ñ—Ä–∫–∏, –ø–∞—Ä–∫ —Ä–æ–∑–≤–∞–≥
üíà	–≤–∏–≤—ñ—Å–∫–∞, –≤–∏–≤—ñ—Å–∫–∞ –ø–µ—Ä—É–∫–∞—Ä—è (—Å–º—É–≥–∞—Å—Ç–∏–π —Å—Ç–æ–≤–ø), –∑–∞—á—ñ—Å–∫–∞, –ø–µ—Ä—É–∫–∞—Ä
üé™	–Ω–∞–º–µ—Ç, —Ü–∏—Ä–∫, —Ü–∏—Ä–∫–æ–≤–µ —à–∞—Ç—Ä–æ
üöÇ	–¥–≤–∏–≥—É–Ω, –∑–∞–ª—ñ–∑–Ω–∏—Ü—è, –ø–∞—Ä–æ–≤–∏–π, –ø–∞—Ä–æ–≤–∏–π –ª–æ–∫–æ–º–æ—Ç–∏–≤, –ø–æ—Ç—è–≥, —Ç—Ä–∞–Ω—Å–ø–æ—Ä—Ç
üöÉ	–≤–∞–≥–æ–Ω, –µ–ª–µ–∫—Ç—Ä–∏—á–Ω–∏–π, –∑–∞–ª—ñ–∑–Ω–∏—Ü—è, –ø–æ—Ç—è–≥, —Ç—Ä–∞–º–≤–∞–π, —Ç—Ä–∞–Ω—Å–ø–æ—Ä—Ç, —Ç—Ä–æ–ª–µ–π–±—É—Å
üöÑ	–∑–∞–ª—ñ–∑–Ω–∏—Ü—è, –ø–æ—Ç—è–≥, —Ç—Ä–∞–Ω—Å–ø–æ—Ä—Ç, —à–≤–∏–¥–∫—ñ—Å–Ω–∏–π, —à–≤–∏–¥–∫—ñ—Å–Ω–∏–π –ø–æ—Ç—è–≥, —ñ–Ω—Ç–µ—Ä—Å—ñ—Ç—ñ
üöÖ	–∑–∞–ª—ñ–∑–Ω–∏—Ü—è, –∫—É–ª–µ–ø–æ–¥—ñ–±–Ω–∏–π, –ø–æ—Ç—è–≥, —Ç—Ä–∞–Ω—Å–ø–æ—Ä—Ç, —à–≤–∏–¥–∫—ñ—Å–Ω–∏–π, —à–≤–∏–¥–∫—ñ—Å–Ω–∏–π –ø–æ—Ç—è–≥ –∑ –æ–∫—Ä—É–≥–ª–∏–º –Ω–æ—Å–æ–º, —ñ–Ω—Ç–µ—Ä—Å—ñ—Ç—ñ
üöÜ	–∑–∞–ª—ñ–∑–Ω–∏—Ü—è, –ø–æ—Ç—è–≥, —Ç—Ä–∞–Ω—Å–ø–æ—Ä—Ç
üöà	–∑–∞–ª—ñ–∑–Ω–∏—Ü—è, —Ç—Ä–∞–Ω—Å–ø–æ—Ä—Ç, —à–≤–∏–¥–∫—ñ—Å–Ω–∏–π —Ç—Ä–∞–º–≤–∞–π
üöâ	c—Ç–∞–Ω—Ü—ñ—è, –∑–∞–ª—ñ–∑–Ω–∏—Ü—è, –ø–æ—Ç—è–≥, —Å—Ç–∞–Ω—Ü—ñ—è, —Ç—Ä–∞–Ω—Å–ø–æ—Ä—Ç
üöä	—Ç—Ä–∞–º–≤–∞–π, —Ç—Ä–∞–Ω—Å–ø–æ—Ä—Ç, —Ç—Ä–æ–ª–µ–π–±—É—Å
üöù	–º–æ–Ω–æ—Ä–µ–π–∫–∞, —Ç—Ä–∞–Ω—Å–ø–æ—Ä—Ç
üöû	–≤–∞–≥–æ–Ω, –≥–æ—Ä–∞, –∑–∞–ª—ñ–∑–Ω–∏—Ü—è, –∑–∞–ª—ñ–∑–Ω–∏—Ü—è –≤ –≥–æ—Ä–∞—Ö, —Ç—Ä–∞–Ω—Å–ø–æ—Ä—Ç
üöã	–≤–∞–≥–æ–Ω, –≤–∞–≥–æ–Ω —Ç—Ä–∞–º–≤–∞—è, —Ç—Ä–∞–º–≤–∞–π, —Ç—Ä–∞–Ω—Å–ø–æ—Ä—Ç, —Ç—Ä–æ–ª–µ–π–±—É—Å
üöå	–∞–≤—Ç–æ–±—É—Å, —Ç—Ä–∞–Ω—Å–ø–æ—Ä—Ç
üöé	–∞–≤—Ç–æ–±—É—Å, —Ç—Ä–∞–º–≤–∞–π, —Ç—Ä–∞–Ω—Å–ø–æ—Ä—Ç, —Ç—Ä–æ–ª–µ–π–±—É—Å
üöê	–∞–≤—Ç–æ–±—É—Å, –º—ñ–∫—Ä–æ–∞–≤—Ç–æ–±—É—Å, —Ç—Ä–∞–Ω—Å–ø–æ—Ä—Ç
üöí	–≤–∞–Ω—Ç–∞–∂—ñ–≤–∫–∞, –¥–≤–∏–≥—É–Ω, –ø–æ–∂–µ–∂–Ω–∞ –º–∞—à–∏–Ω–∞, –ø–æ–∂–µ–∂–Ω–∏–π
üöì	–∞–≤—Ç–æ–º–æ–±—ñ–ª—å, –ø–∞—Ç—Ä—É–ª—å, –ø–æ–ª—ñ—Ü–µ–π—Å—å–∫–∞ –º–∞—à–∏–Ω–∞, –ø–æ–ª—ñ—Ü–µ–π—Å—å–∫–∏–π –∞–≤—Ç–æ–º–æ–±—ñ–ª—å, –ø–æ–ª—ñ—Ü—ñ—è
üöï	—Ç–∞–∫—Å—ñ, —Ç—Ä–∞–Ω—Å–ø–æ—Ä—Ç
üöñ	–Ω–∞–±–ª–∏–∂–∞—Ç–∏—Å—è, —Ç–∞–∫—Å—ñ, —Ç–∞–∫—Å—ñ, —â–æ –Ω–∞–±–ª–∏–∂–∞—î—Ç—å—Å—è, —Ç—Ä–∞–Ω—Å–ø–æ—Ä—Ç
üöó	–∞–≤—Ç–æ–º–æ–±—ñ–ª—å, —Ç—Ä–∞–Ω—Å–ø–æ—Ä—Ç
üöô	–∂–∏—Ç–ª–æ–≤–∏–π, –ø–æ–∑–∞—à–ª—è—Ö–æ–≤–∏–∫, —Ç—Ä–∞–Ω—Å–ø–æ—Ä—Ç, —Ç—Ä–µ–π–ª–µ—Ä, —Ñ—É—Ä–≥–æ–Ω
üöö	–≤–∞–Ω—Ç–∞–∂—ñ–≤–∫–∞ –¥–ª—è –¥–æ—Å—Ç–∞–≤–∫–∏, –¥–æ—Å—Ç–∞–≤–∫–∞, —Ç—Ä–∞–Ω—Å–ø–æ—Ä—Ç, —Ñ—É—Ä–≥–æ–Ω
üöõ	–≤–∞–Ω—Ç–∞–∂—ñ–≤–∫–∞, –≤–∞–Ω—Ç–∞–∂—ñ–≤–∫–∞ –∑ –ø—Ä–∏—á–µ–ø–æ–º, —Ç—Ä–∞–Ω—Å–ø–æ—Ä—Ç, —Ñ—É—Ä–≥–æ–Ω
üöú	—Ç—Ä–∞–∫—Ç–æ—Ä, —Ç—Ä–∞–Ω—Å–ø–æ—Ä—Ç
üõ¥	—Å–∞–º–æ–∫–∞—Ç
üõπ	–±–æ—Ä–¥, –¥–æ—à–∫–∞, —Å–∫–µ–π—Ç, —Å–∫–µ–π—Ç–±–æ—Ä–¥
üõµ	–º–æ–ø–µ–¥, —Å–∫—É—Ç–µ—Ä
üöè	–∞–≤—Ç–æ–±—É—Å, –∞–≤—Ç–æ–±—É—Å–Ω–∞ –∑—É–ø–∏–Ω–∫–∞, –∑—É–ø–∏–Ω–∫–∞
üö®	–∞–≤—Ç–æ–º–æ–±—ñ–ª—å, –≤–æ–≥–Ω—ñ –ø–æ–ª—ñ—Ü–µ–π—Å—å–∫–æ–≥–æ –∞–≤—Ç–æ–º–æ–±—ñ–ª—è, –º–∞—è–∫, –º–∏–≥–∞—Ç–∏, –æ–±–µ—Ä—Ç–∞—Ç–∏—Å—è, –ø–æ–ª—ñ—Ü—ñ—è, –ø—Ä–æ–±–ª–∏—Å–∫–æ–≤–∏–π –º–∞—è—á–æ–∫
üö•	–≥–æ—Ä–∏–∑–æ–Ω—Ç–∞–ª—å–Ω–∏–π —Å–≤—ñ—Ç–ª–æ—Ñ–æ—Ä, —Å–≤—ñ—Ç–ª–æ—Ñ–æ—Ä, —Ç—Ä–∞–Ω—Å–ø–æ—Ä—Ç
üö¶	–≤–µ—Ä—Ç–∏–∫–∞–ª—å–Ω–∏–π —Å–≤—ñ—Ç–ª–æ—Ñ–æ—Ä, —Å–≤—ñ—Ç–ª–æ—Ñ–æ—Ä, —Ç—Ä–∞–Ω—Å–ø–æ—Ä—Ç
üõë	–≤–æ—Å—å–º–∏–∫—É—Ç–Ω–∏–π —á–µ—Ä–≤–æ–Ω–∏–π –∑–Ω–∞–∫, –≤–æ—Å—å–º–∏–∫—É—Ç–Ω–∏–∫, –∑–Ω–∞–∫, —Å—Ç–æ–ø
üöß	–∑–Ω–∞–∫ —Ä–µ–º–æ–Ω—Ç–Ω–∏—Ö —Ä–æ–±—ñ—Ç, –ø–∞—Ä–∫–∞–Ω
üõ∂	–∫–∞–Ω–æ–µ, —á–æ–≤–µ–Ω
üö§	—Ç—Ä–∞–Ω—Å–ø–æ—Ä—Ç, —á–æ–≤–µ–Ω, —à–≤–∏–¥–∫–æ—Ö—ñ–¥–Ω–∏–π –∫–∞—Ç–µ—Ä
üö¢	–∫–æ—Ä–∞–±–µ–ª—å, —Ç—Ä–∞–Ω—Å–ø–æ—Ä—Ç
üõ´	–≤—ñ–¥–ø—Ä–∞–≤–ª–µ–Ω–Ω—è, –ª—ñ—Ç–∞–∫, –ª—ñ—Ç–∞–∫ –∑–ª—ñ—Ç–∞—î, —Ä–µ—î—Å—Ç—Ä–∞—Ü—ñ—è, —Ç—Ä–∞–Ω—Å–ø–æ—Ä—Ç
üõ¨	–ª—ñ—Ç–∞–∫, –ª—ñ—Ç–∞–∫ —Å—ñ–¥–∞—î, –ø—Ä–∏–±—É—Ç—Ç—è, –ø—Ä–∏–∑–µ–º–ª–µ–Ω–Ω—è, —Ç—Ä–∞–Ω—Å–ø–æ—Ä—Ç
üí∫	c–∏–¥—ñ–Ω–Ω—è, –∫—Ä—ñ—Å–ª–æ, —Å–∏–¥—ñ–Ω–Ω—è
üöÅ	–≥–µ–ª—ñ–∫–æ–ø—Ç–µ—Ä, —Ç—Ä–∞–Ω—Å–ø–æ—Ä—Ç
üöü	–∑–∞–ª—ñ–∑–Ω–∏—Ü—è, –ø—ñ–¥–≤—ñ—Å–Ω–∞ –º–æ–Ω–æ—Ä–µ–π–∫–∞, –ø—ñ–¥–≤—ñ—Å–Ω–∏–π, —Ç—Ä–∞–Ω—Å–ø–æ—Ä—Ç
üö†	–≥–æ–Ω–¥–æ–ª–∞, –≥–æ—Ä–∞, –∫–∞–±–µ–ª—å, –∫–∞–Ω–∞—Ç–Ω–∞ –¥–æ—Ä–æ–≥–∞ –≤ –≥–æ—Ä–∞—Ö, —Ç—Ä–∞–Ω—Å–ø–æ—Ä—Ç
üö°	–∞–≤—Ç–æ–º–æ–±—ñ–ª—å, –≥–æ–Ω–¥–æ–ª–∞, –∫–∞–±–µ–ª—å, –∫–∞–Ω–∞—Ç–Ω–∞ –¥–æ—Ä–æ–≥–∞, –ø–æ–≤—ñ—Ç—Ä—è–Ω–∏–π, –ø—ñ–¥–≤—ñ—Å–Ω–∞ –¥–æ—Ä–æ–≥–∞, —Ç—Ä–∞–Ω—Å–ø–æ—Ä—Ç
üöÄ	–∫–æ—Å–º–æ—Å, —Ä–∞–∫–µ—Ç–∞, —Ç—Ä–∞–Ω—Å–ø–æ—Ä—Ç
üõ∏	–ù–õ–û, –ª–µ—Ç—é—á–∞ —Ç–∞—Ä—ñ–ª–∫–∞
üß≥	–±–∞–≥–∞–∂, –≤–∞–ª—ñ–∑–∞, –ø–æ–¥–æ—Ä–æ–∂, —á–µ–º–æ–¥–∞–Ω
‚è∞	–±—É–¥–∏–ª—å–Ω–∏–∫, –≥–æ–¥–∏–Ω–Ω–∏–∫
üïß	12, 12:30, 30, –≥–æ–¥–∏–Ω–Ω–∏–∫, –¥–≤–∞–Ω–∞–¥—Ü—è—Ç—å, –ø—ñ–≤ –Ω–∞ –ø–µ—Ä—à—É, —Ç—Ä–∏–¥—Ü—è—Ç—å
üïú	1, 1:30, 30, –≥–æ–¥–∏–Ω–Ω–∏–∫, –æ–¥–∏–Ω, –ø—ñ–≤ –Ω–∞ –¥—Ä—É–≥—É, —Ç—Ä–∏–¥—Ü—è—Ç—å
üïù	2, 2:30, 30, –≥–æ–¥–∏–Ω–Ω–∏–∫, –¥–≤–∞, –ø—ñ–≤ –Ω–∞ —Ç—Ä–µ—Ç—é, —Ç—Ä–∏–¥—Ü—è—Ç—å
üïû	3, 30, 3:30, –≥–æ–¥–∏–Ω–Ω–∏–∫, –ø—ñ–≤ –Ω–∞ —á–µ—Ç–≤–µ—Ä—Ç—É, —Ç—Ä–∏, —Ç—Ä–∏–¥—Ü—è—Ç—å
üïü	30, 4, 4:30, –≥–æ–¥–∏–Ω–Ω–∏–∫, –ø—ñ–≤ –Ω–∞ –ø‚Äô—è—Ç—É, —Ç—Ä–∏–¥—Ü—è—Ç—å, —á–æ—Ç–∏—Ä–∏
üï†	30, 5, 5:30, –≥–æ–¥–∏–Ω–Ω–∏–∫, –ø—ñ–≤ –Ω–∞ —à–æ—Å—Ç—É, –ø‚Äô—è—Ç—å, —Ç—Ä–∏–¥—Ü—è—Ç—å
üï°	30, 6, 6:30, –≥–æ–¥–∏–Ω–Ω–∏–∫, –ø—ñ–≤ –Ω–∞ —Å—å–æ–º—É, —Ç—Ä–∏–¥—Ü—è—Ç—å, —à—ñ—Å—Ç—å
üï¢	30, 7, 7:30, –≥–æ–¥–∏–Ω–Ω–∏–∫, –ø—ñ–≤ –Ω–∞ –≤–æ—Å—å–º—É, —Å—ñ–º, —Ç—Ä–∏–¥—Ü—è—Ç—å
üï£	30, 8, 8:30, –≤—ñ—Å—ñ–º, –≥–æ–¥–∏–Ω–Ω–∏–∫, –ø—ñ–≤ –Ω–∞ –¥–µ–≤‚Äô—è—Ç—É, —Ç—Ä–∏–¥—Ü—è—Ç—å
üï§	30, 9, 9:30, –≥–æ–¥–∏–Ω–Ω–∏–∫, –¥–µ–≤‚Äô—è—Ç—å, –ø—ñ–≤ –Ω–∞ –¥–µ—Å—è—Ç—É, —Ç—Ä–∏–¥—Ü—è—Ç—å
üï•	10, 10:30, 30, –≥–æ–¥–∏–Ω–Ω–∏–∫, –¥–µ—Å—è—Ç—å, –ø—ñ–≤ –Ω–∞ –æ–¥–∏–Ω–∞–¥—Ü—è—Ç—É, —Ç—Ä–∏–¥—Ü—è—Ç—å
üï¶	11, 11:30, 30, –≥–æ–¥–∏–Ω–Ω–∏–∫, –æ–¥–∏–Ω–∞–¥—Ü—è—Ç—å, –ø—ñ–≤ –Ω–∞ –¥–≤–∞–Ω–∞–¥—Ü—è—Ç—É, —Ç—Ä–∏–¥—Ü—è—Ç—å
üåë	–∫–æ—Å–º–æ—Å, –º–æ–ª–æ–¥–∏–π –º—ñ—Å—è—Ü—å, –º—ñ—Å—è—Ü—å, –ø–æ–≥–æ–¥–∞, —Ç–µ–º–Ω–∏–π
üåí	–∑—Ä–æ—Å—Ç–∞—é—á–∏–π, –∫–æ—Å–º–æ—Å, –º—ñ—Å—è—Ü—å, –º—ñ—Å—è—Ü—å —É –ø–µ—Ä—à—ñ–π —á–≤–µ—Ä—Ç—ñ, –ø–æ–≥–æ–¥–∞, –ø—ñ–≤–º—ñ—Å—è—Ü—å
üåì	–∫–æ—Å–º–æ—Å, –º—ñ—Å—è—Ü—å, –ø–µ—Ä—à–∞ —á–≤–µ—Ä—Ç—å –º—ñ—Å—è—Ü—è, –ø–æ–≥–æ–¥–∞, —á–≤–µ—Ä—Ç—å
üåî	–∑—Ä–æ—Å—Ç–∞—é—á–∏–π, –∫–æ—Å–º–æ—Å, –º—ñ—Å—è—Ü—å, –º—ñ—Å—è—Ü—å —É –¥—Ä—É–≥—ñ–π —á–≤–µ—Ä—Ç—ñ, –ø–æ–≥–æ–¥–∞, —Å–µ—Ä–ø–æ–ø–æ–¥—ñ–±–Ω–∏–π
üåñ	–∫–æ—Å–º–æ—Å, –º—ñ—Å—è—Ü—å, –º—ñ—Å—è—Ü—å —É —Ç—Ä–µ—Ç—ñ–π —á–≤–µ—Ä—Ç—ñ, –ø–æ–≥–æ–¥–∞, —Å–µ—Ä–ø–æ–ø–æ–¥—ñ–±–Ω–∏–π, —Å–ø–∞–¥–∞—é—á–∏–π
üåó	–∫–æ—Å–º–æ—Å, –º—ñ—Å—è—Ü—å, –æ—Å—Ç–∞–Ω–Ω—è —á–≤–µ—Ä—Ç—å –º—ñ—Å—è—Ü—è, –ø–æ–≥–æ–¥–∞, —á–≤–µ—Ä—Ç—å
üåò	–∫–æ—Å–º–æ—Å, –º—ñ—Å—è—Ü—å, –º—ñ—Å—è—Ü—å —É —á–µ—Ç–≤–µ—Ä—Ç—ñ–π —á–≤–µ—Ä—Ç—ñ, –ø–æ–≥–æ–¥–∞, –ø—ñ–≤–º—ñ—Å—è—Ü—å, —Å–ø–∞–¥–∞—é—á–∏–π
üåô	–∫–æ—Å–º–æ—Å, –º—ñ—Å—è—Ü—å, –ø–æ–≥–æ–¥–∞, —Å–µ—Ä–ø –º—ñ—Å—è—Ü—è
üåö	–∫–æ—Å–º–æ—Å, –º–æ–ª–æ–¥–∏–π –º—ñ—Å—è—Ü—å –∑ –æ–±–ª–∏—á—á—è–º, –º—ñ—Å—è—Ü—å, –æ–±–ª–∏—á—á—è, –ø–æ–≥–æ–¥–∞
üåõ	–∫–æ—Å–º–æ—Å, –º—ñ—Å—è—Ü—å, –æ–±–ª–∏—á—á—è, –ø–µ—Ä—à–∞ —á–≤–µ—Ä—Ç—å –º—ñ—Å—è—Ü—è –∑ –æ–±–ª–∏—á—á—è–º, –ø–æ–≥–æ–¥–∞, —á–≤–µ—Ä—Ç—å
üåù	–∫–æ—Å–º–æ—Å, –º—ñ—Å—è—Ü—å, –æ–±–ª–∏—á—á—è, –ø–æ–≤–Ω–∏–π, –ø–æ–≤–Ω–∏–π –º—ñ—Å—è—Ü—å –∑ –æ–±–ª–∏—á—á—è–º, –ø–æ–≥–æ–¥–∞, —è—Å–∫—Ä–∞–≤–∏–π
üåû	–∫–æ—Å–º–æ—Å, –æ–±–ª–∏—á—á—è, –ø–æ–≥–æ–¥–∞, —Å–æ–Ω—Ü–µ, —Å–æ–Ω—Ü–µ –∑ –æ–±–ª–∏—á—á—è–º, —è—Å–∫—Ä–∞–≤–∏–π
üåü	–±–ª–∏—Å–∫—É—á–∏–π, –∑—ñ—Ä–∫–∞, —Å–≤—ñ—Ç–∏—Ç—å—Å—è, —Å–≤—ñ—Ç–ª–æ, —Å—è–π–Ω–∞ –∑—ñ—Ä–∫–∞, —Å—è—î, —ñ—Å–∫—Ä–∞
üå†	–∑—ñ—Ä–∫–∞, –∫–æ—Å–º–æ—Å, –º–µ—Ç–µ–æ—Ä, –Ω–µ–±–æ, –ø–∞–¥–∞—î
üåÄ	–∑–∞–ø–∞–º–æ—Ä–æ—á–µ–Ω–Ω—è, –ø–æ–≥–æ–¥–∞, —Å–º–µ—Ä—á, —Ç–∞–π—Ñ—É–Ω, —Ü–∏–∫–ª–æ–Ω
üåà	–≤–µ—Å–µ–ª–∫–∞, –¥–æ—â, –ø–æ–≥–æ–¥–∞
üåÇ	–¥–æ—â, –æ–¥—è–≥, –ø–∞—Ä–∞—Å–æ–ª—å–∫–∞, –ø–æ–≥–æ–¥–∞, —Å–∫–ª–∞–¥–µ–Ω–∞ –ø–∞—Ä–∞—Å–æ–ª—å–∫–∞
üî•	–≤–æ–≥–æ–Ω—å, –ø–æ–ª—É–º‚Äô—è, —ñ–Ω—Å—Ç—Ä—É–º–µ–Ω—Ç
üíß	–∫–æ–º—ñ—á–Ω–∏–π, –∫—Ä–∞–ø–ª—è, –ø–æ–≥–æ–¥–∞, –ø—ñ—Ç, —Ö–æ–ª–æ–¥–Ω–∏–π
üåä	–≤–æ–¥–∞, –æ–∫–µ–∞–Ω, –ø–æ–≥–æ–¥–∞, —Ö–≤–∏–ª—è
üéÉ	–≥–∞—Ä–±—É–∑, –ª—ñ—Ö—Ç–∞—Ä, –ª—ñ—Ö—Ç–∞—Ä-–≥–∞—Ä–±—É–∑, —Å–≤—è—Ç–∫—É–≤–∞–Ω–Ω—è, —Ö–µ–ª–ª–æ–≤—ñ–Ω
üéÑ	–¥–µ—Ä–µ–≤–æ, —Ä—ñ–∑–¥–≤–æ, —Ä—ñ–∑–¥–≤—è–Ω–∞ —è–ª–∏–Ω–∫–∞, —Å–≤—è—Ç–∫—É–≤–∞–Ω–Ω—è, —è–ª–∏–Ω–∫–∞
üéÜ	—Å–≤—è—Ç–∫—É–≤–∞–Ω–Ω—è, —Ñ–µ—î—Ä–≤–µ—Ä–∫–∏
üéá	–±–µ–Ω–≥–∞–ª—å—Å—å–∫–∏–π –≤–æ–≥–æ–Ω—å, —Å–≤—è—Ç–∫—É–≤–∞–Ω–Ω—è, —Ñ–µ—î—Ä–≤–µ—Ä–∫–∏, —ñ—Å–∫—Ä–∞
üß®	–±–æ–º–±–∞, –≤–∏–±—É—Ö—ñ–≤–∫–∞, –¥–∏–Ω–∞–º—ñ—Ç, –ø–µ—Ç–∞—Ä–¥–∞, —Ñ–µ—î—Ä–≤–µ—Ä–∫
‚ú®	–±–ª–∏—Å–∫—ñ—Ç–∫–∏, –∑—ñ—Ä–∫–∞, —ñ—Å–∫—Ä–∞, —ñ—Å–∫—Ä–∏
üéà	–ø–æ–≤—ñ—Ç—Ä—è–Ω–∞ –∫—É–ª—å–∫–∞, —Å–≤—è—Ç–∫—É–≤–∞–Ω–Ω—è
üéâ	–≤–µ—á—ñ—Ä–∫–∞, –≥–æ—Ç–æ–≤–æ, —Å–≤—è—Ç–∫—É–≤–∞–Ω–Ω—è, —Ö–ª–æ–ø–∞–≤–∫–∞
üéä	–±–∞–ª, –∫–æ–Ω—Ñ–µ—Ç—ñ, –∫—É–ª—å–∫–∞ –∑ –∫–æ–Ω—Ñ–µ—Ç—ñ, —Å–≤—è—Ç–∫—É–≤–∞–Ω–Ω—è
üéã	–±–∞–Ω–µ—Ä, –¥–µ—Ä–µ–≤–æ, —Å–≤—è—Ç–∫—É–≤–∞–Ω–Ω—è, —Ç–∞–Ω–∞–±–∞—Ç–∞, –≥—ñ–ª–∫–∞ —Ç–∞–Ω–¥–∑–∞–∫—É, —è–ø–æ–Ω—Å—å–∫–∏–π
üéç	–±–∞–º–±—É–∫, –ø—Ä–∏–∫—Ä–∞—Å–∏ –Ω–∞ —è–ª–∏–Ω–∫—É, —Ä–æ—Å–ª–∏–Ω–∞, —Å–≤—è—Ç–∫—É–≤–∞–Ω–Ω—è, —Å–æ—Å–Ω–∞, —è–ø–æ–Ω—Å—å–∫–∏–π
üéé	–ª—è–ª—å–∫–∞, —Å–≤—è—Ç–∫—É–≤–∞–Ω–Ω—è, —Ñ–µ—Å—Ç–∏–≤–∞–ª—å, —è–ø–æ–Ω—Å—å–∫–∏–π, —è–ø–æ–Ω—Å—å–∫—ñ –ª—è–ª—å–∫–∏
üéè	–≤—ñ—Ç—Ä–æ–≤–∫–∞–∑ —É —Ñ–æ—Ä–º—ñ –∫–æ—Ä–æ–ø—ñ–≤, –∫–∞—Ä–ø, —Å–≤—è—Ç–∫—É–≤–∞–Ω–Ω—è, —Ç—Ä–∞–Ω—Å–ø–∞—Ä–∞–Ω—Ç, —Ç—Ä–∞–Ω—Å–ø–∞—Ä–∞–Ω—Ç —ñ–∑ –∫–∞—Ä–ø–∞–º–∏
üéê	–≤—ñ—Ç–µ—Ä, –¥–∑–≤–æ–Ω–∏–∫, –¥–∑–≤—ñ–Ω–æ—á–∫–∏, –∫–∏—Ç–∞–π—Å—å–∫—ñ –¥–∑–≤—ñ–Ω–æ—á–∫–∏, —Å–≤—è—Ç–∫—É–≤–∞–Ω–Ω—è
üéë	–º—ñ—Å—è—Ü—å, —Å–≤—è—Ç–∫—É–≤–∞–Ω–Ω—è, —Ü–µ—Ä–µ–º–æ–Ω—ñ—è, —Ü–µ—Ä–µ–º–æ–Ω—ñ—è –≤—à–∞–Ω—É–≤–∞–Ω–Ω—è –º—ñ—Å—è—Ü—è
üßß	–≥—Ä–æ—à—ñ, –∫–æ–Ω–≤–µ—Ä—Ç, –ª–∏—Å—Ç, –Ω–∞ —â–∞—Å—Ç—è, –ø–æ–¥–∞—Ä—É–Ω–æ–∫, —á–µ—Ä–≤–æ–Ω–∏–π –∫–æ–Ω–≤–µ—Ä—Ç
üéÄ	–±–∞–Ω—Ç –∑—ñ —Å—Ç—Ä—ñ—á–∫–∏, —Å–≤—è—Ç–∫—É–≤–∞–Ω–Ω—è
üéÅ	–¥–∞—Ä—É–Ω–æ–∫, –∑–∞–ø–∞–∫–æ–≤–∞–Ω–∏–π, –∫–æ—Ä–æ–±–∫–∞, –ø–æ–¥–∞—Ä—É–Ω–æ–∫, —Å–≤—è—Ç–∫—É–≤–∞–Ω–Ω—è
üé´	–≤—Ö—ñ–¥–Ω–∏–π, –∫–≤–∏—Ç–æ–∫
üèÖ	–º–µ–¥–∞–ª—å, —Å–ø–æ—Ä—Ç–∏–≤–Ω–∞ –º–µ–¥–∞–ª—å
ü•á	–∑–æ–ª–æ—Ç–∞ –º–µ–¥–∞–ª—å, –∑–æ–ª–æ—Ç–æ, –º–µ–¥–∞–ª—å, –º—ñ—Å—Ü–µ, –ø–µ—Ä—à–µ
ü•à	–¥—Ä—É–≥–µ, –º–µ–¥–∞–ª—å, –º—ñ—Å—Ü–µ, —Å—Ä—ñ–±–ª–æ, —Å—Ä—ñ–±–Ω–∞ –º–µ–¥–∞–ª—å
ü•â	–±—Ä–æ–Ω–∑–∞, –±—Ä–æ–Ω–∑–æ–≤–∞ –º–µ–¥–∞–ª—å, –º–µ–¥–∞–ª—å, –º—ñ—Å—Ü–µ, —Ç—Ä–µ—Ç—î
ü•é	–±–µ–π—Å–±–æ–ª, –º‚Äô—è—á, —Ä—É–∫–∞–≤–∏—á–∫–∞, —Å–æ—Ñ—Ç, —Å–æ—Ñ—Ç–±–æ–ª—å–Ω–∏–π –º º—è—á, —Å–ø–æ—Ä—Ç
üèÄ	–±–∞—Å–∫–µ—Ç–±–æ–ª—å–Ω–∏–π –º‚Äô—è—á, –∫—ñ–ª—å—Ü–µ, –º‚Äô—è—á
üèê	–≤–æ–ª–µ–π–±–æ–ª—å–Ω–∏–π –º‚Äô—è—á, –≥—Ä–∞, –º‚Äô—è—á
üèà	–∞–º–µ—Ä–∏–∫–∞–Ω—Å—å–∫–∏–π, –º º—è—á –¥–ª—è –∞–º–µ—Ä–∏–∫–∞–Ω—Å—å–∫–æ–≥–æ —Ñ—É—Ç–±–æ–ª—É, –º‚Äô—è—á, —Ñ—É—Ç–±–æ–ª
üèâ	–º º—è—á –¥–ª—è —Ä–µ–≥–±—ñ, –º‚Äô—è—á, —Ä–µ–≥–±—ñ, —Ñ—É—Ç–±–æ–ª
üéæ	–º‚Äô—è—á, —Ä–∞–∫–µ—Ç–∫–∞, —Ç–µ–Ω—ñ—Å–Ω–∏–π –º‚Äô—è—á
ü•è	–∞–ª—Ç–∏–º–∞—Ç, –¥–∏—Å–∫, –∫–∏–¥–æ–∫, –ª—ñ—Ç–∞—é—á–∏–π –¥–∏—Å–∫, —Ç–∞—Ä—ñ–ª–∫–∞, —Ñ—Ä–∏–∑–±—ñ, —Ñ—Ä—ñ–∑–±—ñ
üé≥	–≥—Ä–∞, –∫—É–ª—è —ñ –∫–µ–≥–ª—ñ –¥–ª—è –±–æ—É–ª—ñ–Ω–≥—É, –º‚Äô—è—á
üèè	–±–∏—Ç–∞, –±–∏—Ç–∞ —ñ –º º—è—á –¥–ª—è –∫—Ä–∏–∫–µ—Ç—É, –≥—Ä–∞, –º‚Äô—è—á
üèë	–≥—Ä–∞, –∫–ª—é—á–∫–∞, –∫–ª—é—á–∫–∞ —ñ –º º—è—á –¥–ª—è —Ö–æ–∫–µ—é –Ω–∞ —Ç—Ä–∞–≤—ñ, –º‚Äô—è—á, –ø–æ–ª–µ, —Ö–æ–∫–µ–π
üèí	–≥—Ä–∞, –∫–ª—é—á–∫–∞, –∫–ª—é—á–∫–∞ —ñ —à–∞–π–±–∞ –¥–ª—è —Ö–æ–∫–µ—é, –ª—ñ–¥, —Ö–æ–∫–µ–π, —à–∞–π–±–∞
ü•ç	–≥–æ–ª, –ª–∞–∫—Ä–æ—Å, –º‚Äô—è—á, –ø–∞–ª–∏—Ü—è, —Å—Ç—ñ–∫, —Å—Ç—ñ–∫ –¥–ª—è –ª–∞–∫—Ä–æ—Å—É
üèì	–±–∏—Ç–∞, –≥—Ä–∞, –º‚Äô—è—á, —Ä–∞–∫–µ—Ç–∫–∞, —Ä–∞–∫–µ—Ç–∫–∞ —ñ –∫—É–ª—å–∫–∞ –¥–ª—è –ø—ñ–Ω–≥-–ø–æ–Ω–≥—É, —Å—Ç—ñ–ª, —Ç–µ–Ω—ñ—Å
üè∏	–≤–æ–ª–∞–Ω, –≤–æ–ª–∞–Ω—á–∏–∫, –≥—Ä–∞, —Ä–∞–∫–µ—Ç–∫–∞, —Ä–∞–∫–µ—Ç–∫–∞ —ñ –≤–æ–ª–∞–Ω –¥–ª—è –±–∞–¥–º—ñ–Ω—Ç–æ–Ω—É
ü•ä	–±–æ–∫—Å, –±–æ–∫—Å–µ—Ä—Å—å–∫–∞ —Ä—É–∫–∞–≤–∏—á–∫–∞, —Ä—É–∫–∞–≤–∏—á–∫–∞, —Å–ø–æ—Ä—Ç
ü•ã	–±–æ–π–æ–≤—ñ –º–∏—Å—Ç–µ—Ü—Ç–≤–∞, –¥–∑—é–¥–æ, –∫–∞—Ä–∞—Ç–µ, –∫—ñ–º–æ–Ω–æ, –æ–¥—è–≥ –¥–ª—è —î–¥–∏–Ω–æ–±–æ—Ä—Å—Ç–≤, —Å–ø–æ—Ä—Ç, —Ç—Ö–µ–∫–≤–æ–Ω–¥–æ, —Ñ–æ—Ä–º–∞
ü•Ö	–≤–æ—Ä–æ—Ç–∞, —Å–ø–æ—Ä—Ç, —Å—ñ—Ç–∫–∞, —Å—ñ—Ç–∫–∞ –≤–æ—Ä—ñ—Ç
üé£	–≤—É–¥–∫–∞ —ñ —Ä–∏–±–∞, —Ä–∏–±–∞, —Ä–∏–±–∞—Ü—å–∫–∞ –≤—É–¥–∫–∞
üéΩ	–±—ñ–≥, –±—ñ–≥–æ–≤–∞ —Ç–µ–Ω—ñ—Å–∫–∞, —Å–æ—Ä–æ—á–∫–∞, —Å—Ç—Ä—ñ—á–∫–∞
üéø	–ª–∏–∂—ñ, —Å–Ω—ñ–≥
üõ∑	—Å–∞–Ω–∏
ü•å	–≥—Ä–∞, –∫–∞–º º—è–Ω–∞ —à–∞–π–±–∞ –¥–ª—è –∫–µ—Ä–ª—ñ–Ω–≥—É, –∫–∞–º—ñ–Ω—å
üéØ	¬´—è–±–ª—É—á–∫–æ¬ª, –≤–ª—É—á–∏—Ç–∏, –≥—Ä–∞, –¥—Ä–æ—Ç–∏–∫, –º—ñ—à–µ–Ω—å —ñ–∑ –ø—Ä—è–º–∏–º –≤–ª—É—á–µ–Ω–Ω—è–º, —Ü–µ–Ω—Ç—Ä, —Ü–µ–Ω—Ç—Ä–∞–ª—å–Ω–µ –∫–æ–ª–æ, —Ü—ñ–ª—å
üé±	8, –±—ñ–ª—å—è—Ä–¥, –±—ñ–ª—å—è—Ä–¥–Ω–∞ –∫—É–ª—è 8, –≤—ñ—Å—ñ–º, –∫—É–ª—è
üîÆ	–∫–∞–∑–∫–∞, –∫—Ä–∏—à—Ç–∞–ª–µ–≤–∞ –∫—É–ª—è, –∫—Ä–∏—à—Ç–∞–ª–µ–≤–∏–π, –∫—É–ª—è, –ø–µ—Ä–µ–¥–±–∞—á–µ–Ω–Ω—è, —Ñ–∞–Ω—Ç–∞–∑—ñ—è, —ñ–Ω—Å—Ç—Ä—É–º–µ–Ω—Ç
üßø	–û–∫–æ –§–∞—Ç—ñ–º–∏, –∞–º—É–ª–µ—Ç, –Ω–∞–≤—Ä–æ—á–∏—Ç–∏, –Ω–∞–∑–∞—Ä, –ø—Ä–∏—Å—Ç—Ä—ñ—Ç, —Ç–∞–ª—ñ—Å–º–∞–Ω
üé∞	–∞–≤—Ç–æ–º–∞—Ç, –≥—Ä–∞–ª—å–Ω–∏–π –∞–≤—Ç–æ–º–∞—Ç, —ñ–≥—Ä–æ–≤–∏–π
üé≤	–≥—Ä–∞, –≥—Ä–∞–ª—å–Ω–∞ –∫—ñ—Å—Ç—å, –∫—É–±–∏–∫
üß©	–≥–æ–ª–æ–≤–æ–ª–æ–º–∫–∞, –ø–∞–∑–ª, –ø—ñ–¥–∫–∞–∑–∫–∞, —á–∞—Å—Ç–∏–Ω–∞, —à–º–∞—Ç–æ–∫
üß∏	–≤–µ–¥–º–µ–¥–∏–∫, –º‚Äô—è–∫–∞ —ñ–≥—Ä–∞—à–∫–∞, –ø–ª—é—à–µ–≤–∞ —ñ–≥—Ä–∞—à–∫–∞, —ñ–≥—Ä–∞—à–∫–∞
üÉè	–≥—Ä–∞, –≥—Ä–∞—Ç–∏, –¥–∂–æ–∫–µ—Ä, –∫–∞—Ä—Ç–∞
üé¥	–≥—Ä–∞, –≥—Ä–∞–ª—å–Ω—ñ –∫–∞—Ä—Ç–∏ –∑ –∫–≤—ñ—Ç–∞–º–∏ (—Ö–∞–Ω–∞—Ñ—É–¥–∞), –≥—Ä–∞—Ç–∏, –∫–∞—Ä—Ç–∞, —Ö–∞–Ω–∞—Ñ—É–¥–∞, —è–ø–æ–Ω—Å—å–∫–∏–π
üé®	–∫–∞—Ä—Ç–∏–Ω–∞, –º–∏—Å—Ç–µ—Ü—Ç–≤–æ, –º—É–∑–µ–π, –ø–∞–ª—ñ—Ç—Ä–∞, –ø–∞–ª—ñ—Ç—Ä–∞ —Ö—É–¥–æ–∂–Ω–∏–∫–∞
üßµ	–≥–æ–ª–∫–∞, –Ω–∏—Ç–∫–∞, –ø—Ä—è–∂–∞, —à–∏—Ç—Ç—è
üß∂	–∫–ª—É–±–æ–∫, –º–æ—Ç–æ–∫, –º–æ—Ç—É–∑–∫–∞, –Ω–∏—Ç–∫–∞, –ø—Ä—è–∂–∞
üîá	–±–µ–∑–∑–≤—É—á–Ω–æ, –¥–∏–Ω–∞–º—ñ–∫, –∑–∞–≥–ª—É—à–µ–Ω–∏–π –¥–∏–Ω–∞–º—ñ–∫, –∑–≤—É–∫ –¥–∏–Ω–∞–º—ñ–∫–∞ –≤–∏–º–∫–Ω–µ–Ω–æ, –Ω–µ—á—É—Ç–Ω–æ, —Ç–∏—Ö–æ
üîâ	—Å–µ—Ä–µ–¥–Ω—å–æ, —Å–µ—Ä–µ–¥–Ω—è –≥—É—á–Ω—ñ—Å—Ç—å –¥–∏–Ω–∞–º—ñ–∫–∞
üîä	–≤–∏—Å–æ–∫–∞ –≥—É—á–Ω—ñ—Å—Ç—å –¥–∏–Ω–∞–º—ñ–∫–∞, –≤–∏—Å–æ–∫–∏–π —Ä—ñ–≤–µ–Ω—å –≥—É—á–Ω–æ—Å—Ç—ñ –¥–∏–Ω–∞–º—ñ–∫–∞, –≥—É—á–Ω–æ
üì¢	–≥—É—á–Ω–∏–π, –≥—É—á–Ω–æ–º–æ–≤–µ—Ü—å, –∑–≤—É–∫–æ–≤–µ –æ–ø–æ–≤—ñ—â–µ–Ω–Ω—è
üì£	–º–µ–≥–∞—Ñ–æ–Ω, –ø—ñ–¥–±–∞–¥—å–æ—Ä–µ–Ω–Ω—è
üìØ	–ø–æ—à—Ç–∞, –ø–æ—à—Ç–æ–≤–∏–π, –ø–æ—à—Ç–æ–≤–∏–π —Ä—ñ–∂–æ–∫, —Ä—ñ–∂–æ–∫
üîî	–¥–∑–≤–æ–Ω–∏–∫, –¥–∑–≤—ñ–Ω, –¥–∑–≤—ñ–Ω–æ–∫
üîï	–±–µ–∑–∑–≤—É—á–Ω–æ, –≥–ª—É—à–∏—Ç–∏, –¥–∑–≤—ñ–Ω–æ–∫, –¥–∑–≤—ñ–Ω–æ–∫ –∑—ñ —Å–∫—ñ—Å–Ω–æ—é —Ä–∏—Å–∫–æ—é, –∑–∞–±–æ—Ä–æ–Ω–µ–Ω–æ, –∑–∞–≥–ª—É—à–µ–Ω–∏–π –¥–∑–≤—ñ–Ω–æ–∫, —Ç–∏—à–∞
üéº	–º—É–∑–∏—á–Ω–∏–π, –ø–∞—Ä—Ç–∏—Ç—É—Ä–∞
üéµ	–º—É–∑–∏—á–Ω–∞ –Ω–æ—Ç–∞, –º—É–∑–∏—á–Ω–∏–π, –Ω–æ—Ç–∞
üé∂	–º—É–∑–∏—á–Ω–∏–π, –º—É–∑–∏—á–Ω—ñ –Ω–æ—Ç–∏, –Ω–æ—Ç–∞, –Ω–æ—Ç–∏
üé§	–∫–∞—Ä–∞–æ–∫–µ, –º—ñ–∫—Ä–æ—Ñ–æ–Ω
üé∑	–º—É–∑–∏—á–Ω–∏–π, —Å–∞–∫—Å–æ—Ñ–æ–Ω, —ñ–Ω—Å—Ç—Ä—É–º–µ–Ω—Ç
üé∏	–≥—ñ—Ç–∞—Ä–∞, –º—É–∑–∏—á–Ω–∏–π, —ñ–Ω—Å—Ç—Ä—É–º–µ–Ω—Ç
üéπ	–∫–ª–∞–≤—ñ–∞—Ç—É—Ä–∞, –º—É–∑–∏—á–Ω–∞ –∫–ª–∞–≤—ñ–∞—Ç—É—Ä–∞, –º—É–∑–∏—á–Ω–∏–π, –ø—ñ–∞–Ω—ñ–Ω–æ, —ñ–Ω—Å—Ç—Ä—É–º–µ–Ω—Ç
üé∫	–º—É–∑–∏—á–Ω–∏–π, —Ç—Ä—É–±–∞, —ñ–Ω—Å—Ç—Ä—É–º–µ–Ω—Ç
üéª	–º—É–∑–∏—á–Ω–∏–π, —Å–∫—Ä–∏–ø–∫–∞, —ñ–Ω—Å—Ç—Ä—É–º–µ–Ω—Ç
ü•Å	–±–∞—Ä–∞–±–∞–Ω, –º—É–∑–∏–∫–∞, –ø–∞–ª–∏—á–∫–∏
üì±	–º–æ–±—ñ–ª—å–Ω–∏–π, –º–æ–±—ñ–ª—å–Ω–∏–π —Ç–µ–ª–µ—Ñ–æ–Ω, —Å—Ç—ñ–ª—å–Ω–∏–∫–æ–≤–∏–π, —Ç–µ–ª–µ—Ñ–æ–Ω
üì≤	–º–æ–±—ñ–ª—å–Ω–∏–π, –º–æ–±—ñ–ª—å–Ω–∏–π —Ç–µ–ª–µ—Ñ–æ–Ω –∑—ñ —Å—Ç—Ä—ñ–ª–∫–æ—é, –æ—Ç—Ä–∏–º—É–≤–∞—Ç–∏, —Å—Ç—Ä—ñ–ª–∫–∞, —Å—Ç—ñ–ª—å–Ω–∏–∫–æ–≤–∏–π, —Ç–µ–ª–µ—Ñ–æ–Ω, —Ç–µ–ª–µ—Ñ–æ–Ω—É–≤–∞—Ç–∏
üìû	—Å–ª—É—Ö–∞–≤–∫–∞, —Ç–µ–ª–µ—Ñ–æ–Ω, —Ç–µ–ª–µ—Ñ–æ–Ω–Ω–∞ —Å–ª—É—Ö–∞–≤–∫–∞
üì†	—Ñ–∞–∫—Å
üîã	–∞–∫—É–º—É–ª—è—Ç–æ—Ä, –±–∞—Ç–∞—Ä–µ–π–∫–∞, –±–∞—Ç–∞—Ä–µ—è
üîå	–≤–∏–ª–∫–∞, –µ–ª–µ–∫—Ç—Ä–∏–∫–∞, –µ–ª–µ–∫—Ç—Ä–∏—á–Ω–∏–π, —à—Ç–µ–ø—Å–µ–ª—å
üíΩ	–¥–∏—Å–∫, –∫–æ–º–ø‚Äô—é—Ç–µ—Ä, –º—ñ–Ω—ñ-–¥–∏—Å–∫, –æ–ø—Ç–∏—á–Ω–∏–π
üíæ	–¥–∏—Å–∫, –¥–∏—Å–∫–µ—Ç–∞, –∫–æ–º–ø‚Äô—é—Ç–µ—Ä
üìÄ	DVD-–¥–∏—Å–∫, [DVD]-–¥–∏—Å–∫, blu-ray, cd, –¥–∏—Å–∫, –∫–æ–º–ø‚Äô—é—Ç–µ—Ä, –æ–ø—Ç–∏—á–Ω–∏–π
üßÆ	–∞–±–∞–∫, –æ–±—á–∏—Å–ª–µ–Ω–Ω—è, —Ä–∞—Ö—ñ–≤–Ω–∏—Ü—è
üé•	–∫–∞–º–µ—Ä–∞, –∫—ñ–Ω–æ, –∫—ñ–Ω–æ–∫–∞–º–µ—Ä–∞, —Ñ—ñ–ª—å–º
üì∏	–≤—ñ–¥–µ–æ, –∫–∞–º–µ—Ä–∞, —Å–ø–∞–ª–∞—Ö, —Ñ–æ—Ç–æ–∞–ø–∞—Ä–∞—Ç –∑—ñ —Å–ø–∞–ª–∞—Ö–æ–º
üìº	–≤—ñ–¥–µ–æ, –≤—ñ–¥–µ–æ–∫–∞—Å–µ—Ç–∞, –∫–∞—Å–µ—Ç–∞, —Å—Ç—Ä—ñ—á–∫–∞
üîç	–∑–±—ñ–ª—å—à—É–≤–∞–ª—å–Ω–µ —Å–∫–ª–æ –∑ –Ω–∞—Ö–∏–ª–æ–º —É–ª—ñ–≤–æ, –∑–±—ñ–ª—å—à—É–≤–∞–ª—å–Ω–µ —Å–∫–ª–æ, —Å–ø—Ä—è–º–æ–≤–∞–Ω–µ –ª—ñ–≤–æ—Ä—É—á, –ª—É–ø–∞, –ø–æ—à—É–∫, —ñ–Ω—Å—Ç—Ä—É–º–µ–Ω—Ç
üîé	–∑–±—ñ–ª—å—à—É–≤–∞–ª—å–Ω–µ —Å–∫–ª–æ –∑ –Ω–∞—Ö–∏–ª–æ–º —É–ø—Ä–∞–≤–æ, –∑–±—ñ–ª—å—à—É–≤–∞–ª—å–Ω–µ —Å–∫–ª–æ, —Å–ø—Ä—è–º–æ–≤–∞–Ω–µ –ø—Ä–∞–≤–æ—Ä—É—á, –ª—É–ø–∞, –ø–æ—à—É–∫, —ñ–Ω—Å—Ç—Ä—É–º–µ–Ω—Ç
üí°	–µ–ª–µ–∫—Ç—Ä–∏—á–Ω–∏–π, –ª–∞–º–ø–æ—á–∫–∞, –º–∞–ª—é–Ω–æ–∫, —Å–≤—ñ—Ç–ª–æ, —ñ–¥–µ—è
üî¶	–µ–ª–µ–∫—Ç—Ä–∏—á–Ω–∏–π, –ª—ñ—Ö—Ç–∞—Ä–∏–∫, —Å–≤—ñ—Ç–ª–æ, —ñ–Ω—Å—Ç—Ä—É–º–µ–Ω—Ç
üèÆ	–±–∞—Ä, –ª—ñ—Ö—Ç–∞—Ä, –ª—ñ—Ö—Ç–∞—Ä —ñ–∑–∞–∫–∞–π–∞, —Å–≤—ñ—Ç–ª–æ, —á–µ—Ä–≤–æ–Ω–∏–π, —á–µ—Ä–≤–æ–Ω–∏–π –ø–∞–ø–µ—Ä–æ–≤–∏–π –ª—ñ—Ö—Ç–∞—Ä, —è–ø–æ–Ω—Å—å–∫–∏–π
üìî	–¥–µ–∫–æ—Ä–∞—Ç–∏–≤–Ω–∞, –∑–∞–ø–∏—Å–Ω–∏–∫, –∑–∞–ø–∏—Å–Ω–∏–∫ —É –¥–µ–∫–æ—Ä–∞—Ç–∏–≤–Ω—ñ–π –æ–±–∫–ª–∞–¥–∏–Ω—Ü—ñ, –∫–Ω–∏–∂–∫–∞, –æ–±–∫–ª–∞–¥–∏–Ω–∫–∞
üìï	–∑–∞–∫—Ä–∏—Ç–∞, –∑–∞–∫—Ä–∏—Ç–∞ –∫–Ω–∏–≥–∞, –∫–Ω–∏–∂–∫–∞, —á–µ—Ä–≤–æ–Ω–∏–π –ø—ñ–¥—Ä—É—á–Ω–∏–∫
üìñ	–≤—ñ–¥–∫—Ä–∏—Ç–∞, –≤—ñ–¥–∫—Ä–∏—Ç–∞ –∫–Ω–∏–≥–∞, –∫–Ω–∏–∂–∫–∞
üìó	–∑–µ–ª–µ–Ω–∏–π, –∑–µ–ª–µ–Ω–∏–π –ø—ñ–¥—Ä—É—á–Ω–∏–∫, –∫–Ω–∏–∂–∫–∞
üìò	–∫–Ω–∏–∂–∫–∞, —Å–∏–Ω—ñ–π, —Å–∏–Ω—ñ–π –ø—ñ–¥—Ä—É—á–Ω–∏–∫
üìô	–∫–Ω–∏–∂–∫–∞, –æ—Ä–∞–Ω–∂–µ–≤–∏–π, –æ—Ä–∞–Ω–∂–µ–≤–∏–π –ø—ñ–¥—Ä—É—á–Ω–∏–∫
üìì	–±–ª–æ–∫–Ω–æ—Ç, –∑–∞–ø–∏—Å–Ω–∏–∫, –∑–æ—à–∏—Ç –¥–ª—è —Ç–≤–æ—Ä—ñ–≤
üìí	–≥—Ä–æ—Å–±—É—Ö, –∑–∞–ø–∏—Å–Ω–∏–∫
üìÉ	–¥–æ–∫—É–º–µ–Ω—Ç, –∑–∞–≤–∏—Ç–æ–∫, —Å—Ç–æ—Ä—ñ–Ω–∫–∞, —Å—Ç–æ—Ä—ñ–Ω–∫–∞ —ñ–∑ –∑–∞–≤–∏—Ç–∫–æ–º
üìú	–ø–∞–ø—ñ—Ä, —Å—É–≤—ñ–π
üìÑ	–¥–æ–∫—É–º–µ–Ω—Ç, —Å—Ç–æ—Ä—ñ–Ω–∫–∞, —Å—Ç–æ—Ä—ñ–Ω–∫–∞ –ª–∏—Ü–µ–≤–æ—é —Å—Ç–æ—Ä–æ–Ω–æ—é
üì∞	–≥–∞–∑–µ—Ç–∞, –Ω–æ–≤–∏–Ω–∏, –ø–∞–ø—ñ—Ä
üóû	–≥–∞–∑–µ—Ç–∞, –∑–≤–∏–≤–µ–Ω–∞ –≥–∞–∑–µ—Ç–∞, –∑–≥–æ—Ä–Ω—É—Ç–∞, –Ω–æ–≤–∏–Ω–∏, –ø–∞–ø—ñ—Ä, —Å–∫—Ä—É—á–µ–Ω–∞ –≥–∞–∑–µ—Ç–∞
üìë	–≤–∫–ª–∞–¥–∫–∞, –∑–∞–∫–ª–∞–¥–∫–∞, –∑–Ω–∞—á–æ–∫, –º—ñ—Ç–∫–∞, –º—ñ—Ç–∫–∏ –∑–∞–∫–ª–∞–¥–æ–∫
üîñ	–∑–∞–∫–ª–∞–¥–∫–∞, –∑–Ω–∞—á–æ–∫
üí¥	–±–∞–Ω–∫, –±–∞–Ω–∫–Ω–æ—Ç–∞, –≤–∞–ª—é—Ç–∞, –≥—Ä–æ—à—ñ, –∫—É–ø—é—Ä–∞, —î–Ω–∞, —î–Ω–æ–≤—ñ –±–∞–Ω–∫–Ω–æ—Ç–∏
üíµ	–±–∞–Ω–∫, –±–∞–Ω–∫–Ω–æ—Ç–∞, –≤–∞–ª—é—Ç–∞, –≥—Ä–æ—à—ñ, –¥–æ–ª–∞—Ä, –¥–æ–ª–∞—Ä–æ–≤—ñ –±–∞–Ω–∫–Ω–æ—Ç–∏, –∫—É–ø—é—Ä–∞
üí∂	–±–∞–Ω–∫, –±–∞–Ω–∫–Ω–æ—Ç–∞, –≤–∞–ª—é—Ç–∞, –≥—Ä–æ—à—ñ, –∫—É–ø—é—Ä–∞, —î–≤—Ä–æ, —î–≤—Ä–æ–≤—ñ –±–∞–Ω–∫–Ω–æ—Ç–∏
üí∑	–±–∞–Ω–∫, –±–∞–Ω–∫–Ω–æ—Ç–∞, –≤–∞–ª—é—Ç–∞, –≥—Ä–æ—à—ñ, –∫—É–ø—é—Ä–∞, —Ñ—É–Ω—Ç, —Ñ—É–Ω—Ç–æ–≤—ñ –±–∞–Ω–∫–Ω–æ—Ç–∏
üí∏	–±–∞–Ω–∫, –±–∞–Ω–∫–Ω–æ—Ç–∞, –≥—Ä–æ—à—ñ, –≥—Ä–æ—à—ñ –∑ –∫—Ä–∏–ª–∞–º–∏, –¥–æ–ª–∞—Ä, –∫—Ä–∏–ª–∞, –∫—É–ø—é—Ä–∞, –ª—ñ—Ç–∞—Ç–∏
üßæ	–¥–æ–∫—É–º–µ–Ω—Ç, –∫–≤–∏—Ç–∞–Ω—Ü—ñ—è, —Ä–∞—Ö—É–Ω–æ–∫, —Ä–∞—Ö—É–Ω–æ–∫-—Ñ–∞–∫—Ç—É—Ä–∞, —á–µ–∫, —ñ–Ω–≤–æ–π—Å
üíπ	–±–∞–Ω–∫, –≤–∞–ª—é—Ç–∞, –≤–≥–æ—Ä—É, –≥—Ä–∞—Ñ—ñ–∫ –∑—Ä–æ—Å—Ç–∞–Ω–Ω—è —ñ –∑–Ω–∞–∫ —î–Ω–∏, –≥—Ä–∞—Ñ—ñ–∫–∞, –≥—Ä–æ—à—ñ, –¥—ñ–∞–≥—Ä–∞–º–∞, –∑–±—ñ–ª—å—à–µ–Ω–Ω—è, —Ä–∏–Ω–æ–∫, —Ä—ñ—Å—Ç, —Ç–µ–Ω–¥–µ–Ω—Ü—ñ—è, —î–Ω–∞
üí±	–±–∞–Ω–∫, –≤–∞–ª—é—Ç–∞, –≥—Ä–æ—à—ñ, –æ–±–º—ñ–Ω, –æ–±–º—ñ–Ω –≤–∞–ª—é—Ç
üí≤	–≤–∞–ª—é—Ç–∞, –≥—Ä–æ—à—ñ, –¥–æ–ª–∞—Ä, –∑–Ω–∞–∫ –¥–æ–ª–∞—Ä–∞
üìß	–µ–ª–µ–∫—Ç—Ä–æ–Ω–Ω–∏–π –ª–∏—Å—Ç, –µ–º–µ–π–ª, –ª–∏—Å—Ç, –ø–æ—à—Ç–∞
üì®	–≤—Ö—ñ–¥–Ω–∏–π, –µ–º–µ–π–ª, –∫–æ–Ω–≤–µ—Ä—Ç, –∫–æ–Ω–≤–µ—Ä—Ç –≤—Ö—ñ–¥–Ω–æ–≥–æ –ª–∏—Å—Ç–∞, –ª–∏—Å—Ç, –æ—Ç—Ä–∏–º–∞—Ç–∏, –ø–æ—à—Ç–∞
üì©	–≤–∏—Ö—ñ–¥–Ω–∏–π, –≤–Ω–∏–∑, –µ–º–µ–π–ª, –∫–æ–Ω–≤–µ—Ä—Ç, –∫–æ–Ω–≤–µ—Ä—Ç –∑—ñ —Å—Ç—Ä—ñ–ª–∫–æ—é, –ª–∏—Å—Ç, –Ω–∞–¥—ñ—Å–ª–∞–Ω–∏–π, –ø–æ—à—Ç–∞, —Å—Ç—Ä—ñ–ª–∫–∞
üìÆ	–ø–æ—à—Ç–∞, –ø–æ—à—Ç–æ–≤–∞ —Å–∫—Ä–∏–Ω—å–∫–∞, —Å–∫—Ä–∏–Ω—å–∫–∞
üìù	–æ–ª—ñ–≤–µ—Ü—å, –ø–∞–º º—è—Ç–∫–∞
üíº	–∫–µ–π—Å, –ø–æ—Ä—Ç—Ñ–µ–ª—å
üìÅ	–∑–∞–∫—Ä–∏—Ç–∞ –ø–∞–ø–∫–∞ –¥–ª—è —Ñ–∞–π–ª—ñ–≤, –ø–∞–ø–∫–∞, —Ç–µ–∫–∞ –¥–ª—è —Ñ–∞–π–ª—ñ–≤
üìÇ	–≤—ñ–¥–∫—Ä–∏—Ç–∞ –ø–∞–ø–∫–∞ –¥–ª—è —Ñ–∞–π–ª—ñ–≤, –≤—ñ–¥–∫—Ä–∏—Ç–∏–π, –ø–∞–ø–∫–∞
üìÖ	–¥–∞—Ç–∞, –∫–∞–ª–µ–Ω–¥–∞—Ä
üìÜ	–≤—ñ–¥—Ä–∏–≤–Ω–∏–π –∫–∞–ª–µ–Ω–¥–∞—Ä, –∫–∞–ª–µ–Ω–¥–∞—Ä
üìá	–∫–∞—Ä—Ç–æ—Ç–µ–∫–∞, —É–∫–∞–∑—ñ–≤–Ω–∏–∫, —ñ–Ω–¥–µ–∫—Å
üìà	–≤–≥–æ—Ä—É, –≤–∏—Å—Ö—ñ–¥–Ω–∏–π –≥—Ä–∞—Ñ—ñ–∫, –≥—Ä–∞—Ñ—ñ–∫, –≥—Ä–∞—Ñ—ñ–∫ –ø—ñ–¥–≤–∏—â–µ–Ω–Ω—è, –¥—ñ–∞–≥—Ä–∞–º–∞, —Ä—ñ—Å—Ç, —Ç–µ–Ω–¥–µ–Ω—Ü—ñ—è
üìâ	–≤–Ω–∏–∑, –≥—Ä–∞—Ñ—ñ–∫, –≥—Ä–∞—Ñ—ñ–∫ –ø–∞–¥—ñ–Ω–Ω—è, –¥—ñ–∞–≥—Ä–∞–º–∞, –Ω–∏–∑—Ö—ñ–¥–Ω–∏–π –≥—Ä–∞—Ñ—ñ–∫, —Ç–µ–Ω–¥–µ–Ω—Ü—ñ—è
üìä	–≥—Ä–∞—Ñ—ñ–∫, –≥—ñ—Å—Ç–æ–≥—Ä–∞–º–∞
üìå	–∫–∞–Ω—Ü–µ–ª—è—Ä—Å—å–∫–∞ –∫–Ω–æ–ø–∫–∞, –∫–Ω–æ–ø–∫–∞
üìç	–∫–∞–Ω—Ü–µ–ª—è—Ä—Å—å–∫–∏–π, –∫–Ω–æ–ø–∫–∞, —à–ø–∏–ª—å–∫–∞ –∑ –∫—Ä—É–≥–ª–æ—é –≥–æ–ª—ñ–≤–∫–æ—é
üìé	—Å–∫—Ä—ñ–ø–∫–∞
üìè	–ª—ñ–Ω—ñ–π–∫–∞, –ø—Ä—è–º–∞ –ª—ñ–Ω—ñ–π–∫–∞, –ø—Ä—è–º–∏–π –∫—É—Ç
üìê	–ª—ñ–Ω—ñ–π–∫–∞, —Ç—Ä–∏–∫—É—Ç–Ω–∞ –ª—ñ–Ω—ñ–π–∫–∞, —Ç—Ä–∏–∫—É—Ç–Ω–∏–∫
üîè	–∑–∞–º–æ–∫, –∑–∞–º–æ–∫ —ñ —á–æ—Ä–Ω–∏–ª—å–Ω–∞ —Ä—É—á–∫–∞, –ø–µ—Ä–æ, –ø—Ä–∏–≤–∞—Ç–Ω—ñ—Å—Ç—å, —Ä—É—á–∫–∞, —á–æ—Ä–Ω–∏–ª–æ
üîê	–±–µ–∑–ø–µ—á–Ω–æ, –∑–∞–º–∫–Ω–µ–Ω–∏–π –∑–∞–º–æ–∫ —ñ–∑ –∫–ª—é—á–µ–º, –∑–∞–º–∫–Ω–µ–Ω–æ, –∑–∞–º–æ–∫, –∫–ª—é—á
üîë	–∫–ª—é—á, –ø–∞—Ä–æ–ª—å
üî®	–º–æ–ª–æ—Ç–æ–∫, —ñ–Ω—Å—Ç—Ä—É–º–µ–Ω—Ç
üî´	–≤–æ–¥—è–Ω–∏–π –ø—ñ—Å—Ç–æ–ª–µ—Ç, –∑–±—Ä–æ—è, –∑–Ω–∞—Ä—è–¥–¥—è, –ø—ñ—Å—Ç–æ–ª–µ—Ç, —Ä–µ–≤–æ–ª—å–≤–µ—Ä
üèπ	–∑–±—Ä–æ—è, –∑–Ω–∞—Ä—è–¥–¥—è, –∑–æ–¥—ñ–∞–∫, –ª—É–∫, –ª—É–∫ —ñ —Å—Ç—Ä—ñ–ª–∞, –ª—É—á–Ω–∏–∫, —Å—Ç—Ä—ñ–ª–∞, —Å—Ç—Ä—ñ–ª–µ—Ü—å
üîß	–≥–∞–π–∫–æ–≤–∏–π –∫–ª—é—á, —ñ–Ω—Å—Ç—Ä—É–º–µ–Ω—Ç
üî©	–±–æ–ª—Ç, –≥–∞–π–∫–∞, –≥–∞–π–∫–∞ —Ç–∞ –±–æ–ª—Ç, —ñ–Ω—Å—Ç—Ä—É–º–µ–Ω—Ç
üîó	–ª–∞–Ω–∫–∞, –ø–æ—Å–∏–ª–∞–Ω–Ω—è, —Å–∏–º–≤–æ–ª –∑ º—î–¥–Ω–∞–Ω–Ω—è –ª–∞–Ω–æ–∫
üß∞	–∫–æ—Ä–æ–±–∫–∞, –º–µ—Ö–∞–Ω—ñ–∫, —Å–∫—Ä–∏–Ω—è, —Å–∫—Ä–∏–Ω—è –¥–ª—è —ñ–Ω—Å—Ç—Ä—É–º–µ–Ω—Ç—ñ–≤, —ñ–Ω—Å—Ç—Ä—É–º–µ–Ω—Ç
üß≤	–º–∞–≥–Ω–µ—Ç–∏–∑–º, –º–∞–≥–Ω—ñ—Ç, –ø—Ä–∏—Ç—è–≥—É–≤–∞—Ç–∏, –ø—ñ–¥–∫–æ–≤–∞, —Ç—è–∂—ñ–Ω–Ω—è
üß™	–¥–æ—Å–ª—ñ–¥, –µ–∫—Å–ø–µ—Ä–∏–º–µ–Ω—Ç, –ª–∞–±–æ—Ä–∞—Ç–æ—Ä—ñ—è, –Ω–∞—É–∫–∞, –ø—Ä–æ–±—ñ—Ä–∫–∞, —Ö—ñ–º—ñ–∫, —Ö—ñ–º—ñ—è
üß´	–±–∞–∫—Ç–µ—Ä—ñ—è, –±—ñ–æ–ª–æ–≥, –±—ñ–æ–ª–æ–≥—ñ—è, –∫—É–ª—å—Ç—É—Ä–∞, –ª–∞–±–æ—Ä–∞—Ç–æ—Ä—ñ—è, —á–∞—à–∫–∞ –ü–µ—Ç—Ä—ñ
üß¨	–î–ù–ö, –±—ñ–æ–ª–æ–≥, –≥–µ–Ω, –≥–µ–Ω–µ—Ç–∏–∫–∞, –µ–≤–æ–ª—é—Ü—ñ—è, –∂–∏—Ç—Ç—è
üî¨	–º—ñ–∫—Ä–æ—Å–∫–æ–ø, —ñ–Ω—Å—Ç—Ä—É–º–µ–Ω—Ç
üî≠	—Ç–µ–ª–µ—Å–∫–æ–ø, —ñ–Ω—Å—Ç—Ä—É–º–µ–Ω—Ç
üì°	–∞–Ω—Ç–µ–Ω–∞, —Å—É–ø—É—Ç–Ω–∏–∫–æ–≤–∞, —Å—É–ø—É—Ç–Ω–∏–∫–æ–≤–∞ –∞–Ω—Ç–µ–Ω–∞, —Ç–∞—Ä—ñ–ª–∫–∞
üíâ	–≥–æ–ª–∫–∞, –ª—ñ–∫–∞—Ä, –ª—ñ–∫–∏, —É–∫–æ–ª, —Ö–≤–æ—Ä–∏–π, —à–ø—Ä–∏—Ü, —ñ–Ω—Å—Ç—Ä—É–º–µ–Ω—Ç
üíä	–ª—ñ–∫–∞—Ä, –ª—ñ–∫–∏, –ø—ñ–≥—É–ª–∫–∞, —Ö–≤–æ—Ä–∏–π
üö™	–¥–≤–µ—Ä—ñ
üöΩ	—Ç—É–∞–ª–µ—Ç, —É–Ω—ñ—Ç–∞–∑
üöø	–≤–æ–¥–∞, –¥—É—à
üõÅ	–≤–∞–Ω–Ω–∞, –∫—É–ø–∞—Ç–∏—Å—è
üß¥	–∑–≤–æ–ª–æ–∂—É–≤–∞—á, –ª–æ—Å—å–π–æ–Ω, —Å–æ–Ω—Ü–µ–∑–∞—Ö–∏—Å–Ω–∏–π –∫—Ä–µ–º, —à–∞–º–ø—É–Ω—å
üß∑	–∞–Ω–≥–ª—ñ–π—Å—å–∫–∞ —à–ø–∏–ª—å–∫–∞, –±—É–ª–∞–≤–∫–∞, –∑–≥–ª–∞–∑, –ø–∞–Ω–∫-—Ä–æ–∫, —à–ø–∏–ª—å–∫–∞
üßπ	–≤—ñ–¥—å–º–∞, –≤—ñ–Ω–∏–∫, –º—ñ—Ç–ª–∞, –ø—Ä–∏–±–∏—Ä–∞—Ç–∏, –ø—ñ–¥–º—ñ—Ç–∞—Ç–∏
üß∫	–±—ñ–ª–∏–∑–Ω–∞, –∫–æ—Ä–∑–∏–Ω–∞, –∫–æ—à–∏–∫, –ø—ñ–∫–Ω—ñ–∫, —Ñ–µ—Ä–º–∞
üßª	–ø–∞–ø–µ—Ä–æ–≤—ñ —Ä—É—à–Ω–∏–∫–∏, –ø–∞–ø—ñ—Ä, —Ä—É–ª–æ–Ω –ø–∞–ø–µ—Ä—É, —Ç—É–∞–ª–µ—Ç, —Ç—É–∞–ª–µ—Ç–Ω–∏–π –ø–∞–ø—ñ—Ä
üßº	–∫—É–ø–∞—Ç–∏—Å—è, –º–∏–ª–æ, –º–∏—Ç–∏—Å—è, —á–∏—Å—Ç–∏—Ç–∏, —à–∫—ñ—Ä–∞
üßΩ	–≥—É–±–∫–∞, –º–æ—á–∞–ª–∫–∞, –ø–æ–≥–ª–∏–Ω–∞—Ç–∏, –ø–æ—Ä–∏, —á–∏—Å—Ç–∏—Ç–∏
üßØ	–≤–æ–≥–Ω–µ–≥–∞—Å–Ω–∏–∫, –≤–æ–≥–æ–Ω—å, –≥–∞—Å–∏—Ç–∏, –ø–æ–∂–µ–∂–∞, —Ç—É—à–∏—Ç–∏, —Ç—É—à—ñ–Ω–Ω—è
üõí	–≤–æ–∑–∏–∫, –º–∞–≥–∞–∑–∏–Ω, –º–∞–≥–∞–∑–∏–Ω–Ω–∏–π –≤—ñ–∑–æ–∫, —Å—É–ø–µ—Ä–º–∞—Ä–∫–µ—Ç, —à–æ–ø—ñ–Ω–≥
üö¨	c–∏–≥–∞—Ä–µ—Ç–∞, –∫—É—Ä—ñ–Ω–Ω—è, —Å–∏–≥–∞—Ä–µ—Ç–∞
üóø	–ª–∏—Ü–µ, —Å—Ç–∞—Ç—É—è, —Å—Ç–∞—Ç—É—è –∑ –û—Å—Ç—Ä–æ–≤–∞ –ü–∞—Å—Ö–∏
üèß	–±–∞–Ω–∫–æ–º–∞—Ç, –±–∞–Ω–∫—ñ–≤—Å—å–∫–∏–π –∞–≤—Ç–æ–º–∞—Ç, –∑–Ω–∞–∫ –±–∞–Ω–∫–æ–º–∞—Ç–∞, —Å–∏–º–≤–æ–ª –±–∞–Ω–∫–æ–º–∞—Ç–∞, —Ç–µ—Ä–º—ñ–Ω–∞–ª —Å–∞–º–æ–æ–±—Å–ª—É–≥–æ–≤—É–≤–∞–Ω–Ω—è
üöÆ	–∑–Ω–∞–∫ –∫–∏–¥–∞—Ç–∏ —Å–º—ñ—Ç—Ç—è –≤ —É—Ä–Ω—É, –ø–∞–º º—è—Ç–∫–∞ –Ω–µ —Å–º—ñ—Ç–∏—Ç–∏, —Å–º—ñ—Ç—Ç—è, —É—Ä–Ω–∞
üö∞	–≤–æ–¥–∞, –ø–∏—Ç–Ω–∞, –ø–∏—Ç–Ω–∞ –≤–æ–¥–∞, –ø—Ä–∏–¥–∞—Ç–Ω–∞ –¥–ª—è –ø–∏—Ç—Ç—è
üöª	–≤–±–∏—Ä–∞–ª—å–Ω—è, –≥—Ä–æ–º–∞–¥—Å—å–∫–∏–π —Ç—É–∞–ª–µ—Ç, –∫–ª–æ–∑–µ—Ç, —Ç—É–∞–ª–µ—Ç
üöæ	–≤–∞–Ω–Ω–∞, –≤–±–∏—Ä–∞–ª—å–Ω—è, –∑–Ω–∞–∫ —É–±–∏—Ä–∞–ª—å–Ω—ñ WC, –∫—ñ–º–Ω–∞—Ç–∞, —Å–∏–º–≤–æ–ª —É–±–∏—Ä–∞–ª—å–Ω—ñ WC, —Å–∏–º–≤–æ–ª —É–±–∏—Ä–∞–ª—å–Ω—ñ [WC]
üõÇ	–∫–æ–Ω—Ç—Ä–æ–ª—å, –ø–∞—Å–ø–æ—Ä—Ç–Ω–∏–π, –ø–∞—Å–ø–æ—Ä—Ç–Ω–∏–π –∫–æ–Ω—Ç—Ä–æ–ª—å
üõÉ	–º–∏—Ç–Ω–∏–π –∫–æ–Ω—Ç—Ä–æ–ª—å, –º–∏—Ç–Ω–∏—Ü—è
üõÑ	–±–∞–≥–∞–∂, –≤–∏–¥–∞—á–∞, –≤–∏–¥–∞—á–∞ –±–∞–≥–∞–∂—É, –æ—Ç—Ä–∏–º–∞–Ω–Ω—è
üõÖ	–±–∞–≥–∞–∂, –∑–∞–ª–∏—à–µ–Ω—ñ —Ä–µ—á—ñ, –∫–∞–º–µ—Ä–∞ —Å—Ö–æ–≤—É, –∫–æ–º—ñ—Ä–∫–∞ –¥–ª—è –∑–±–µ—Ä—ñ–≥–∞–Ω–Ω—è, –ø–æ–∫–ª–∞–∂–∞
üö∏	–¥—ñ—Ç–∏, –Ω–∞ –¥–æ—Ä–æ–∑—ñ, –ø–µ—Ä–µ—Ö—ñ–¥ –¥–æ—Ä–æ–≥–∏ –¥–ª—è –¥—ñ—Ç–µ–π, –ø–æ–ø–µ—Ä–µ–¥–∂—É–≤–∞–ª—å–Ω–∏–π –∑–Ω–∞–∫ ¬´–î—ñ—Ç–∏¬ª, –ø—ñ—à–æ—Ö–æ–¥–∏, —Ä—É—Ö
üö´	–∑–∞–±–æ—Ä–æ–Ω–µ–Ω–æ, –∑–∞–±–æ—Ä–æ–Ω—è—î—Ç—å—Å—è, –Ω–µ –¥–æ–∑–≤–æ–ª–µ–Ω–æ, –Ω–µ –¥–æ–ø—É—Å–∫–∞—î—Ç—å—Å—è, –Ω–µ–º–∞—î
üö≥	–≤–µ–ª–æ—Å–∏–ø–µ–¥, –≤–µ–ª–æ—Å–∏–ø–µ–¥–∏ –∑–∞–±–æ—Ä–æ–Ω–µ–Ω–æ, –∑–∞–±–æ—Ä–æ–Ω–µ–Ω–æ, —Ä—É—Ö –Ω–∞ –≤–µ–ª–æ—Å–∏–ø–µ–¥—ñ –∑–∞–±–æ—Ä–æ–Ω–µ–Ω–æ, —Ç—Ä–∞–Ω—Å–ø–æ—Ä—Ç–Ω–∏–π –∑–∞—Å—ñ–±
üöØ	–∑–∞–±–æ—Ä–æ–Ω–µ–Ω–æ, –∑–Ω–∞–∫ ¬´–Ω–µ —Å–º—ñ—Ç–∏—Ç–∏¬ª, –Ω–µ, —Å–º—ñ—Ç–∏—Ç–∏, —Å–º—ñ—Ç–∏—Ç–∏ –∑–∞–±–æ—Ä–æ–Ω–µ–Ω–æ
üö±	–≤–æ–¥–∞, –∑–∞–±–æ—Ä–æ–Ω–µ–Ω–æ, –∑–Ω–∞–∫ ¬´–Ω–µ–ø–∏—Ç–Ω–∞ –≤–æ–¥–∞¬ª, –Ω–µ, –Ω–µ–ø—Ä–∏–¥–∞—Ç–Ω–∞ –¥–ª—è –ø–∏—Ç—Ç—è –≤–æ–¥–∞, –Ω–µ–ø—Ä–∏–¥–∞—Ç–Ω–æ, –ø–∏—Ç–∏, –ø–∏—Ç—Ç—è
üö∑	–∑–∞–±–æ—Ä–æ–Ω–µ–Ω–æ, –Ω–µ, –ø—ñ—à–æ—Ö—ñ–¥, –ø—ñ—à–æ—Ö—ñ–¥–Ω–∏–π —Ä—É—Ö –∑–∞–±–æ—Ä–æ–Ω–µ–Ω–æ, —Ä—É—Ö –ø—ñ—à–æ—Ö–æ–¥—ñ–≤ –∑–∞–±–æ—Ä–æ–Ω–µ–Ω–æ
üìµ	–∑–∞–±–æ—Ä–æ–Ω–µ–Ω–æ, –∫–æ—Ä–∏—Å—Ç—É–≤–∞—Ç–∏—Å—è, –º–æ–±—ñ–ª—å–Ω–∏–π, –º–æ–±—ñ–ª—å–Ω—ñ —Ç–µ–ª–µ—Ñ–æ–Ω–∏ –∑–∞–±–æ—Ä–æ–Ω–µ–Ω–æ, –º–æ–±—ñ–ª—å–Ω—ñ —Ç–µ–ª–µ—Ñ–æ–Ω–∏ –∑–∞–±–æ—Ä–æ–Ω–µ–Ω—ñ, –Ω–µ, —Å—Ç—ñ–ª—å–Ω–∏–∫–æ–≤–∏–π, —Ç–µ–ª–µ—Ñ–æ–Ω
üîû	18, –≤—Ö—ñ–¥ –æ—Å–æ–±–∞–º –¥–æ 18 —Ä–æ–∫—ñ–≤ –∑–∞–±–æ—Ä–æ–Ω–µ–Ω–∏–π, –≤—ñ–∫–æ–≤–µ –æ–±–º–µ–∂–µ–Ω–Ω—è, –≤—ñ—Å—ñ–º–Ω–∞–¥—Ü—è—Ç—å, –¥–ª—è, –∑–∞–±–æ—Ä–æ–Ω–µ–Ω–æ, –ª–∏—à–µ, –ø–æ–≤–Ω–æ–ª—ñ—Ç–Ω—ñ–π
üîÉ	–≤–µ—Ä—Ç–∏–∫–∞–ª—å–Ω—ñ —Å—Ç—Ä—ñ–ª–∫–∏ –∑–∞ —Ö–æ–¥–æ–º –≥–æ–¥–∏–Ω–Ω–∏–∫–∞, –∑–∞ –≥–æ–¥–∏–Ω–Ω–∏–∫–æ–≤–æ—é —Å—Ç—Ä—ñ–ª–∫–æ—é, –ø–µ—Ä–µ–∑–∞–≤–∞–Ω—Ç–∞–∂–∏—Ç–∏, —Å—Ç—Ä—ñ–ª–∫–∞, —Å—Ç—Ä—ñ–ª–∫–∏ –ø–æ –∫–æ–ª—É –∑–∞ –≥–æ–¥–∏–Ω–Ω–∏–∫–æ–≤–æ—é —Å—Ç—Ä—ñ–ª–∫–æ—é
üîÑ	–∫–Ω–æ–ø–∫–∞ –∑—ñ —Å—Ç—Ä—ñ–ª–∫–∞–º–∏, –Ω–∞–ø—Ä—è–º–ª–µ–Ω–∏–º–∏ –ø—Ä–æ—Ç–∏ –≥–æ–¥–∏–Ω–Ω–∏–∫–æ–≤–æ—ó —Å—Ç—Ä—ñ–ª–∫–∏, –∫–Ω–æ–ø–∫–∞ —Å—Ç—Ä—ñ–ª–æ–∫ –ø—Ä–æ—Ç–∏ —Ö–æ–¥—É –≥–æ–¥–∏–Ω–Ω–∏–∫–∞, –ø—Ä–æ—Ç–∏ –≥–æ–¥–∏–Ω–Ω–∏–∫–æ–≤–æ—ó —Å—Ç—Ä—ñ–ª–∫–∏, —Å—Ç—Ä—ñ–ª–∫–∞
üîô	–Ω–∞–∑–∞–¥, —Å—Ç—Ä—ñ–ª–∫–∞, —Å—Ç—Ä—ñ–ª–∫–∞ BACK, —Å—Ç—Ä—ñ–ª–∫–∞ –Ω–∞–∑–∞–¥ BACK, —Å—Ç—Ä—ñ–ª–∫–∞ –Ω–∞–∑–∞–¥ [BACK]
üîö	–∫—ñ–Ω–µ—Ü—å, —Å—Ç—Ä—ñ–ª–∫–∞, —Å—Ç—Ä—ñ–ª–∫–∞ "END", —Å—Ç—Ä—ñ–ª–∫–∞ [END]
üîõ	–≤–≤—ñ–º–∫–Ω–µ–Ω–æ, –∑–Ω–∞—á–æ–∫, —Å—Ç—Ä—ñ–ª–∫–∞, —Å—Ç—Ä—ñ–ª–∫–∞ "ON!", —Å—Ç—Ä—ñ–ª–∫–∞ [ON!]
üîú	–Ω–µ–∑–∞–±–∞—Ä–æ–º, —Å—Ç—Ä—ñ–ª–∫–∞, —Å—Ç—Ä—ñ–ª–∫–∞ "SOON", —Å—Ç—Ä—ñ–ª–∫–∞ [SOON]
üîù	–≤–≤–µ—Ä—Ö, –≤–≥–æ—Ä—É, —Å—Ç—Ä—ñ–ª–∫–∞, —Å—Ç—Ä—ñ–ª–∫–∞ "TOP", —Å—Ç—Ä—ñ–ª–∫–∞ [TOP]
üõê	–∫—É–ª—å—Ç–æ–≤–∞ —Å–ø–æ—Ä—É–¥–∞, –º–æ–ª–∏—Ç–æ–≤–Ω–∏–π –¥—ñ–º, –ø–æ–∫–ª–æ–Ω—ñ–Ω–Ω—è, —Ä–µ–ª—ñ–≥—ñ—è
üïé	–∫–∞–Ω–¥–µ–ª—è–±—Ä, –º–µ–Ω–æ—Ä–∞, –ø—ñ–¥—Å–≤—ñ—á–Ω–∏–∫, —Ä–µ–ª—ñ–≥—ñ—è
üîØ	–∑—ñ—Ä–∫–∞, —É–¥–∞—á–∞, —à–µ—Å—Ç–∏–∫—É—Ç–Ω–∞ –∑—ñ—Ä–∫–∞ –∑ –∫—Ä–∞–ø–∫–æ—é
‚õé	–ó–º—ñ—î–Ω–æ—Å–µ—Ü—å, –∑–º—ñ—è, –∑–æ–¥—ñ–∞–∫, –Ω–æ—Å—ñ–π
üîÄ	–∫–Ω–æ–ø–∫–∞ ¬´–ó–º—ñ—à–∞—Ç–∏ –∫–æ–º–ø–æ–∑–∏—Ü—ñ—ó¬ª, –∫–Ω–æ–ø–∫–∞ —Ç–∞—Å—É–≤–∞–Ω–Ω—è –∫–æ–º–ø–æ–∑–∏—Ü—ñ–π, –ø–µ—Ä–µ—Ö—Ä–µ—â–µ–Ω—ñ, —Å—Ç—Ä—ñ–ª–∫–∞
üîÅ	–∑–∞ –≥–æ–¥–∏–Ω–Ω–∏–∫–æ–≤–æ—é —Å—Ç—Ä—ñ–ª–∫–æ—é, –∫–Ω–æ–ø–∫–∞ ¬´–ü–æ–≤—Ç–æ—Ä–∏—Ç–∏¬ª, –∫–Ω–æ–ø–∫–∞ –ø–æ–≤—Ç–æ—Ä—É, –ø–æ–≤—Ç–æ—Ä–∏—Ç–∏, —Å—Ç—Ä—ñ–ª–∫–∞
üîÇ	–∑–∞ –≥–æ–¥–∏–Ω–Ω–∏–∫–æ–≤–æ—é —Å—Ç—Ä—ñ–ª–∫–æ—é, –∫–Ω–æ–ø–∫–∞ ¬´–ü–æ–≤—Ç–æ—Ä–∏—Ç–∏ –æ–¥–Ω—É –∫–æ–º–ø–æ–∑–∏—Ü—ñ—é¬ª, –∫–Ω–æ–ø–∫–∞ –æ–¥–Ω–æ—Ä–∞–∑–æ–≤–æ–≥–æ –ø–æ–≤—Ç–æ—Ä—É, –æ–¥–∏–Ω —Ä–∞–∑, —Å—Ç—Ä—ñ–ª–∫–∞
‚ñ∂	–≤–ø—Ä–∞–≤–æ, –≤—ñ–¥—Ç–≤–æ—Ä–∏—Ç–∏, –∫–Ω–æ–ø–∫–∞ ¬´–í—ñ–¥—Ç–≤–æ—Ä–∏—Ç–∏¬ª, –∫–Ω–æ–ø–∫–∞ –≤—ñ–¥—Ç–≤–æ—Ä–µ–Ω–Ω—è, —Å—Ç—Ä—ñ–ª–∫–∞, —Ç—Ä–∏–∫—É—Ç–Ω–∏–∫
‚è©	–≤–ø–µ—Ä–µ–¥, –¥–≤—ñ, –∫–Ω–æ–ø–∫–∞ ¬´–ü–µ—Ä–µ–º–æ—Ç–∞—Ç–∏ –≤–ø–µ—Ä–µ–¥¬ª, –∫–Ω–æ–ø–∫–∞ –º–æ—Ç–∞–Ω–Ω—è –≤–ø–µ—Ä–µ–¥, –∫–Ω–æ–ø–∫–∞ –ø–µ—Ä–µ–º–æ—Ç—É–≤–∞–Ω–Ω—è –≤–ø–µ—Ä–µ–¥, –ø–µ—Ä–µ–º–æ—Ç–∞—Ç–∏, —Å—Ç—Ä—ñ–ª–∫–∞
‚è≠	–∫–Ω–æ–ø–∫–∞ ¬´–ù–∞—Å—Ç—É–ø–Ω–∞ –∫–æ–º–ø–æ–∑–∏—Ü—ñ—è¬ª, –∫–Ω–æ–ø–∫–∞ –Ω–∞—Å—Ç—É–ø–Ω–æ—ó –∫–æ–º–ø–æ–∑–∏—Ü—ñ—ó, –Ω–∞—Å—Ç—É–ø–Ω–∞ –∫–æ–º–ø–æ–∑–∏—Ü—ñ—è, –Ω–∞—Å—Ç—É–ø–Ω–∞ —Å—Ü–µ–Ω–∞, —Å—Ç—Ä—ñ–ª–∫–∞, —Ç—Ä–∏–∫—É—Ç–Ω–∏–∫
‚èØ	–≤—ñ–¥—Ç–≤–æ—Ä–∏—Ç–∏, –∫–Ω–æ–ø–∫–∞ ¬´–í—ñ–¥—Ç–≤–æ—Ä–∏—Ç–∏ –∞–±–æ –ø—Ä–∏–∑—É–ø–∏–Ω–∏—Ç–∏¬ª, –ø–∞—É–∑–∞, –ø—Ä–∞–≤–∏–π, –ø—Ä–∏–∑—É–ø–∏–Ω–∏—Ç–∏, —Å—Ç—Ä—ñ–ª–∫–∞, —Ç—Ä–∏–∫—É—Ç–Ω–∏–∫
‚óÄ	–≤–ª—ñ–≤–æ, –∫–Ω–æ–ø–∫–∞ ¬´–ù–∞–∑–∞–¥¬ª, –∫–Ω–æ–ø–∫–∞ —Ä–µ–≤–µ—Ä—Å—É, –Ω–∞–∑–∞–¥, —Å—Ç—Ä—ñ–ª–∫–∞, —Ç—Ä–∏–∫—É—Ç–Ω–∏–∫
‚è™	–¥–≤—ñ, –∫–Ω–æ–ø–∫–∞ ¬´–®–≤–∏–¥–∫–æ –Ω–∞–∑–∞–¥¬ª, –∫–Ω–æ–ø–∫–∞ –º–æ—Ç–∞–Ω–Ω—è –Ω–∞–∑–∞–¥, –∫–Ω–æ–ø–∫–∞ –ø–µ—Ä–µ–º–æ—Ç—É–≤–∞–Ω–Ω—è –Ω–∞–∑–∞–¥, –ø–µ—Ä–µ–º–æ—Ç–∞—Ç–∏, —Å—Ç—Ä—ñ–ª–∫–∞
‚èÆ	–∫–Ω–æ–ø–∫–∞ ¬´–û—Å—Ç–∞–Ω–Ω—è –∫–æ–º–ø–æ–∑–∏—Ü—ñ—è¬ª, –∫–Ω–æ–ø–∫–∞ –ø–æ–≤–µ—Ä–Ω–µ–Ω–Ω—è –¥–æ –ø–æ–ø–µ—Ä–µ–¥–Ω—å–æ—ó –∫–æ–º–ø–æ–∑–∏—Ü—ñ—ó, –ø–æ–ø–µ—Ä–µ–¥–Ω—è –∫–æ–º–ø–æ–∑–∏—Ü—ñ—è, –ø–æ–ø–µ—Ä–µ–¥–Ω—è —Å—Ü–µ–Ω–∞, —Å—Ç—Ä—ñ–ª–∫–∞, —Ç—Ä–∏–∫—É—Ç–Ω–∏–∫
üîº	–∫–Ω–æ–ø–∫–∞, –∫–Ω–æ–ø–∫–∞ ¬´–£–≥–æ—Ä—É¬ª, –∫–Ω–æ–ø–∫–∞ –¥–æ–≥–æ—Ä–∏, —Å—Ç—Ä—ñ–ª–∫–∞, —á–µ—Ä–≤–æ–Ω–∏–π
‚è´	–¥–≤—ñ, –∫–Ω–æ–ø–∫–∞ ¬´–®–≤–∏–¥–∫–æ –≤–≥–æ—Ä—É¬ª, –∫–Ω–æ–ø–∫–∞ –º–æ—Ç–∞–Ω–Ω—è –≤–≥–æ—Ä—É, —Å—Ç—Ä—ñ–ª–∫–∞
üîΩ	–≤–Ω–∏–∑, –∫–Ω–æ–ø–∫–∞, –∫–Ω–æ–ø–∫–∞ ¬´–£–Ω–∏–∑¬ª, –∫–Ω–æ–ø–∫–∞ –¥–æ–Ω–∏–∑—É, —Å—Ç—Ä—ñ–ª–∫–∞, —á–µ—Ä–≤–æ–Ω–∏–π
‚è¨	–≤–Ω–∏–∑, –¥–≤—ñ, –∫–Ω–æ–ø–∫–∞ ¬´–®–≤–∏–¥–∫–æ –≤–Ω–∏–∑¬ª, –∫–Ω–æ–ø–∫–∞ –º–æ—Ç–∞–Ω–Ω—è –≤–Ω–∏–∑, —Å—Ç—Ä—ñ–ª–∫–∞
üé¶	–∫–∞–º–µ—Ä–∞, –∫—ñ–Ω–µ–º–∞—Ç–æ–≥—Ä–∞—Ñ, –∫—ñ–Ω–æ, —Ñ—ñ–ª—å–º
üîÖ	–∑–º–µ–Ω—à–∏—Ç–∏, –∫–Ω–æ–ø–∫–∞ –∑–º–µ–Ω—à–µ–Ω–Ω—è —è—Å–∫—Ä–∞–≤–æ—Å—Ç—ñ, —è—Å–∫—Ä–∞–≤—ñ—Å—Ç—å
üîÜ	–∫–Ω–æ–ø–∫–∞ –∑–±—ñ–ª—å—à–µ–Ω–Ω—è —è—Å–∫—Ä–∞–≤–æ—Å—Ç—ñ, —è—Å–∫—Ä–∞–≤–∏–π, —è—Å–∫—Ä–∞–≤—ñ—Å—Ç—å
üì∂	–º–æ–±—ñ–ª—å–Ω–∏–π, —Ä—ñ–≤–µ–Ω—å, —Ä—ñ–≤–µ–Ω—å —Å–∏–≥–Ω–∞–ª—É, —Å–∏–≥–Ω–∞–ª, —Å—Ç—ñ–ª—å–Ω–∏–∫–æ–≤–∏–π, —Ç–µ–ª–µ—Ñ–æ–Ω
üì≥	–≤—ñ–±—Ä–∞—Ü—ñ—è, –≤—ñ–±—Ä–æ—Ä–µ–∂–∏–º, –º–æ–±—ñ–ª—å–Ω–∏–π, —Ä–µ–∂–∏–º, —Ä–µ–∂–∏–º –≤—ñ–±—Ä–∞—Ü—ñ—ó, —Å—Ç—ñ–ª—å–Ω–∏–∫–æ–≤–∏–π, —Ç–µ–ª–µ—Ñ–æ–Ω
üì¥	–≤–∏–º–∫–Ω–µ–Ω–æ, –º–æ–±—ñ–ª—å–Ω–∏–π, –º–æ–±—ñ–ª—å–Ω–∏–π —Ç–µ–ª–µ—Ñ–æ–Ω –≤–∏–º–∫–Ω–µ–Ω–æ, —Å—Ç—ñ–ª—å–Ω–∏–∫–æ–≤–∏–π, —Ç–µ–ª–µ—Ñ–æ–Ω
‚öú	–≥–µ—Ä–∞–ª—å–¥–∏—á–Ω–∞ –ª—ñ–ª—ñ—è
üî±	–µ–º–±–ª–µ–º–∞, –∫–æ—Ä–∞–±–µ–ª—å, —Ç—Ä–∏–∑—É–±, —è–∫—ñ—Ä, —ñ–Ω—Å—Ç—Ä—É–º–µ–Ω—Ç
üìõ	–±–µ–π–¥–∂, –±–µ–π–¥–∂ –∑ —ñ–º–µ–Ω–µ–º, —ñ–º‚Äô—è
üî∞	–∂–æ–≤—Ç–∏–π, –∑–µ–ª–µ–Ω–∏–π, –ª–∏—Å—Ç–æ–∫, –ø–æ—á–∞—Ç–∫—ñ–≤–µ—Ü—å, —à–µ–≤—Ä–æ–Ω, —è–ø–æ–Ω—Å—å–∫–∏–π, —è–ø–æ–Ω—Å—å–∫–∏–π —Å–∏–º–≤–æ–ª ¬´–ø–æ—á–∞—Ç–∫—ñ–≤–µ—Ü—å¬ª, —ñ–Ω—Å—Ç—Ä—É–º–µ–Ω—Ç
‚úÖ	–±—ñ–ª–∞ –∂–∏—Ä–Ω–∞ –≥–∞–ª–æ—á–∫–∞, –∂–∏—Ä–Ω–∏–π –±—ñ–ª–∏–π –ø—Ä–∞–ø–æ—Ä–µ—Ü—å, –∑–Ω–∞—á–æ–∫, –ø—Ä–∞–ø–æ—Ä–µ—Ü—å
‚ùå	x, –∑–Ω–∞—á–æ–∫, –º–Ω–æ–∂–µ–Ω–Ω—è, –ø–æ–º–Ω–æ–∂–∏—Ç–∏, —Å–∫–∞—Å—É–≤–∞—Ç–∏, —Ö—Ä–µ—Å—Ç–∏–∫
‚ùé	–∑–Ω–∞—á–æ–∫, –∫–≤–∞–¥—Ä–∞—Ç, –∫–Ω–æ–ø–∫–∞ –∑ —Ö—Ä–µ—Å—Ç–∏–∫–æ–º
‚ûï	–∂–∏—Ä–Ω–∏–π –∑–Ω–∞–∫ –ø–ª—é—Å–∞, –º–∞—Ç–µ–º–∞—Ç–∏–∫–∞, –ø–ª—é—Å
‚ûñ	–∂–∏—Ä–Ω–∏–π –∑–Ω–∞–∫ –º—ñ–Ω—É—Å–∞, –º–∞—Ç–µ–º–∞—Ç–∏–∫–∞, –º—ñ–Ω—É—Å
‚ûó	–¥—ñ–ª–µ–Ω–Ω—è, –∂–∏—Ä–Ω–∏–π –∑–Ω–∞–∫ –¥—ñ–ª–µ–Ω–Ω—è, –º–∞—Ç–µ–º–∞—Ç–∏–∫–∞
‚û∞	–∑–∞–∫—Ä—É—á–µ–Ω–∞ –ø–µ—Ç–ª—è, –∑–∞–∫—Ä—É—á–µ–Ω–∏–π, –ø–µ—Ç–ª—è
‚ûø	–∑–∞–∫—Ä—É—á–µ–Ω–∏–π, –ø–µ—Ç–ª—è, –ø–æ–¥–≤—ñ–π–Ω–∞ –∑–∞–∫—Ä—É—á–µ–Ω–∞ –ø–µ—Ç–ª—è, –ø–æ–¥–≤—ñ–π–Ω–∏–π
‚ùî	–±—ñ–ª–∏–π –∑–Ω–∞–∫ –ø–∏—Ç–∞–Ω–Ω—è, –∑–Ω–∞–∫, –∫–æ–Ω—Ç—É—Ä, –ø–∏—Ç–∞–Ω–Ω—è, –ø—É–Ω–∫—Ç—É–∞—Ü—ñ—è
‚ùï	–±—ñ–ª–∏–π –∑–Ω–∞–∫ –æ–∫–ª–∏–∫—É, –∑–Ω–∞–∫, –∫–æ–Ω—Ç—É—Ä, –æ–∫–ª–∏–∫—É, –ø—É–Ω–∫—Ç—É–∞—Ü—ñ—è
üíØ	100, c—Ç–æ –±–∞–ª—ñ–≤, –º–∞–∫—Å–∏–º—É–º, —Ä–∞—Ö—É–Ω–æ–∫, —Å—Ç–æ, —Å—Ç–æ –æ—á–æ–∫
üî†	–≤–≤–µ–¥–µ–Ω–Ω—è, –≤–≤–µ–¥–µ–Ω–Ω—è –≤–µ–ª–∏–∫–∏–º–∏ –ª–∞—Ç–∏–Ω—Å—å–∫–∏–º–∏ –ª—ñ—Ç–µ—Ä–∞–º–∏, –≤–µ–ª–∏–∫—ñ, –ª–∞—Ç–∏–Ω—Å—å–∫—ñ, –ª—ñ—Ç–µ—Ä–∏
üî°	abcd, –∞–ª—Ñ–∞–≤—ñ—Ç, –≤–≤–µ–¥–µ–Ω–Ω—è, –≤–≤–µ–¥–µ–Ω–Ω—è –º–∞–ª–∏–º–∏ –ª–∞—Ç–∏–Ω—Å—å–∫–∏–º–∏ –ª—ñ—Ç–µ—Ä–∞–º–∏, –ª–∞—Ç–∏–Ω—Å—å–∫—ñ, –ª—ñ—Ç–µ—Ä–∏, –º–∞–ª—ñ
üî¢	1234, –≤–≤–µ–¥–µ–Ω–Ω—è, –≤–≤–µ–¥–µ–Ω–Ω—è —Ü–∏—Ñ—Ä–∞–º–∏, —Ü–∏—Ñ—Ä–∏
üî£	–≤–≤–µ–¥–µ–Ω–Ω—è, –≤–≤–µ–¥–µ–Ω–Ω—è —Å–∏–º–≤–æ–ª—ñ–≤
üî§	abc, –∞–ª—Ñ–∞–≤—ñ—Ç, –≤–≤–µ–¥–µ–Ω–Ω—è, –≤–≤–µ–¥–µ–Ω–Ω—è –ª–∞—Ç–∏–Ω—Å—å–∫–∏–º–∏ –ª—ñ—Ç–µ—Ä–∞–º–∏, –ª–∞—Ç–∏–Ω—Å—å–∫—ñ, –ª—ñ—Ç–µ—Ä–∏
üÜé	3, ab, iii, –∫–Ω–æ–ø–∫–∞ AB (IV –≥—Ä—É–ø–∞ –∫—Ä–æ–≤—ñ), –∫–Ω–æ–ø–∫–∞ ¬´–≥—Ä—É–ø–∞ –∫—Ä–æ–≤—ñ ab¬ª, –∫—Ä–æ–≤
üÜë	–∫–≤–∞–¥—Ä–∞—Ç ¬´–æ—á–∏—Å—Ç–∏—Ç–∏ —Ç–µ–∫—Å—Ç¬ª, –∫–Ω–æ–ø–∫–∞ ¬´–æ—á–∏—Å—Ç–∏—Ç–∏¬ª, –æ—á–∏—Å—Ç–∏—Ç–∏ —Ç–µ–∫—Å—Ç
üÜí	–∫–≤–∞–¥—Ä–∞—Ç ¬´–∫—Ä—É—Ç–æ¬ª, –∫–Ω–æ–ø–∫–∞ "COOL", –∫—Ä—É—Ç–æ
üÜì	–±–µ–∑–∫–æ—à—Ç–æ–≤–Ω–æ, –∫–≤–∞–¥—Ä–∞—Ç ¬´–±–µ–∑–∫–æ—à—Ç–æ–≤–Ω–æ¬ª, –∫–Ω–æ–ø–∫–∞ "FREE"
üÜî	–∫–≤–∞–¥—Ä–∞—Ç ¬´—ñ–¥–µ–Ω—Ç–∏—Ñ—ñ–∫–∞—Ç–æ—Ä¬ª, –∫–Ω–æ–ø–∫–∞ "ID", –æ—Å–æ–±–∏—Å—Ç—ñ—Å—Ç—å, —ñ–¥–µ–Ω—Ç–∏—Ñ—ñ–∫–∞—Ç–æ—Ä
üÜï	–∫–≤–∞–¥—Ä–∞—Ç ¬´–Ω–æ–≤–∏–π¬ª, –∫–Ω–æ–ø–∫–∞ "NEW", –Ω–æ–≤–∏–π
üÜñ	–∫–≤–∞–¥—Ä–∞—Ç ¬´–Ω–µ–≥–∞—Ç–∏–≤–Ω–æ¬ª, –∫–Ω–æ–ø–∫–∞ "NG", –Ω–µ–≥–∞—Ç–∏–≤–Ω–æ
üÜó	ok, –∫–Ω–æ–ø–∫–∞ ¬´–û–ö¬ª
üÜò	sos, –¥–æ–ø–æ–º–æ–≥–∞, –∫–Ω–æ–ø–∫–∞ "SOS"
üÜô	–≤–≥–æ—Ä—É, –∑–Ω–∞—á–æ–∫, –∫–Ω–æ–ø–∫–∞ "UP!"
üÜö	–∫–Ω–æ–ø–∫–∞ "VS", –ø—Ä–æ—Ç–∏
üàÅ	–∫–Ω–æ–ø–∫–∞ "—Ç—É—Ç" —è–ø–æ–Ω—Å—å–∫–æ—é, —è–ø–æ–Ω—Å—å–∫–∏–π
üà∑	–∫–Ω–æ–ø–∫–∞ "—â–æ–º—ñ—Å—è—Ü—è" —è–ø–æ–Ω—Å—å–∫–æ—é, —è–ø–æ–Ω—Å—å–∫–∏–π
üà∂	–∫–Ω–æ–ø–∫–∞ "–Ω–µ –±–µ–∑–∫–æ—à—Ç–æ–≤–Ω–æ" —è–ø–æ–Ω—Å—å–∫–æ—é, —è–ø–æ–Ω—Å—å–∫–∏–π
üàØ	–∫–Ω–æ–ø–∫–∞ "–∑–∞—Ä–µ–∑–µ—Ä–≤–æ–≤–∞–Ω–æ" —è–ø–æ–Ω—Å—å–∫–æ—é, —è–ø–æ–Ω—Å—å–∫–∏–π
üâê	–∫–Ω–æ–ø–∫–∞ "—É–≥–æ–¥–∞" —è–ø–æ–Ω—Å—å–∫–æ—é, —è–ø–æ–Ω—Å—å–∫–∏–π
üàπ	–∫–Ω–æ–ø–∫–∞ "–∑–Ω–∏–∂–∫–∞" —è–ø–æ–Ω—Å—å–∫–æ—é, —è–ø–æ–Ω—Å—å–∫–∏–π
üàö	–∫–Ω–æ–ø–∫–∞ "–±–µ–∑–∫–æ—à—Ç–æ–≤–Ω–æ" —è–ø–æ–Ω—Å—å–∫–æ—é, —è–ø–æ–Ω—Å—å–∫–∏–π
üà≤	–∫–Ω–æ–ø–∫–∞ "–∑–∞–±–æ—Ä–æ–Ω–µ–Ω–æ" —è–ø–æ–Ω—Å—å–∫–æ—é, —è–ø–æ–Ω—Å—å–∫–∏–π
üâë	–∫–∏—Ç–∞–π—Å—å–∫–∏–π, –∫–Ω–æ–ø–∫–∞ "–ø—Ä–∏–π–Ω—è—Ç–Ω–æ" —è–ø–æ–Ω—Å—å–∫–æ—é
üà∏	–∫–∏—Ç–∞–π—Å—å–∫–∏–π, –∫–Ω–æ–ø–∫–∞ "–∑–∞—è–≤–∫–∞" —è–ø–æ–Ω—Å—å–∫–æ—é
üà¥	–∫–∏—Ç–∞–π—Å—å–∫–∏–π, –∫–Ω–æ–ø–∫–∞ "–¥–æ—Å—Ç–∞—Ç–Ω—è –æ—Ü—ñ–Ω–∫–∞" —è–ø–æ–Ω—Å—å–∫–æ—é
üà≥	–∫–∏—Ç–∞–π—Å—å–∫–∏–π, –∫–Ω–æ–ø–∫–∞ "–≤—ñ–ª—å–Ω–æ" —è–ø–æ–Ω—Å—å–∫–æ—é
üà∫	–∫–∏—Ç–∞–π—Å—å–∫–∏–π, –∫–Ω–æ–ø–∫–∞ "—Ä–æ–±–æ—Ç–∞" —è–ø–æ–Ω—Å—å–∫–æ—é
üàµ	–∫–∏—Ç–∞–π—Å—å–∫–∏–π, –∫–Ω–æ–ø–∫–∞ "–º—ñ—Å—Ü—å –Ω–µ–º–∞—î" —è–ø–æ–Ω—Å—å–∫–æ—é
üî¥	–≥–µ–æ–º–µ—Ç—Ä–∏—á–Ω–∏–π, –∫–æ–ª–æ, —á–µ—Ä–≤–æ–Ω–µ, —á–µ—Ä–≤–æ–Ω–∏–π –∫—Ä—É–≥
üîµ	c–∏–Ω—ñ–π –∫—Ä—É–≥, –≥–µ–æ–º–µ—Ç—Ä–∏—á–Ω–∏–π, –∫–æ–ª–æ, —Å–∏–Ω—î
üî∂	–≤–µ–ª–∏–∫–∏–π, –≤–µ–ª–∏–∫–∏–π –æ—Ä–∞–Ω–∂–µ–≤–∏–π —Ä–æ–º–±, –≤–µ–ª–∏–∫–∏–π –ø–æ–º–∞—Ä–∞–Ω—á–µ–≤–∏–π —Ä–æ–º–±, –≥–µ–æ–º–µ—Ç—Ä–∏—á–Ω–∏–π, –¥—ñ–∞–º–∞–Ω—Ç, –æ—Ä–∞–Ω–∂–µ–≤–∏–π
üî∑	–≤–µ–ª–∏–∫–∏–π —Å–∏–Ω—ñ–π —Ä–æ–º–±, –≥–µ–æ–º–µ—Ç—Ä–∏—á–Ω–∏–π, –¥—ñ–∞–º–∞–Ω—Ç, —Å–∏–Ω—ñ–π
üî∏	–≥–µ–æ–º–µ—Ç—Ä–∏—á–Ω–∏–π, –¥—ñ–∞–º–∞–Ω—Ç, –º–∞–ª–∏–π, –º–∞–ª–∏–π –æ—Ä–∞–Ω–∂–µ–≤–∏–π —Ä–æ–º–±, –º–∞–ª–∏–π –ø–æ–º–∞—Ä–∞–Ω—á–µ–≤–∏–π —Ä–æ–º–±, –æ—Ä–∞–Ω–∂–µ–≤–∏–π
üîπ	–≥–µ–æ–º–µ—Ç—Ä–∏—á–Ω–∏–π, –¥—ñ–∞–º–∞–Ω—Ç, –º–∞–ª–∏–π —Å–∏–Ω—ñ–π —Ä–æ–º–±, —Å–∏–Ω—ñ–π
üî∫	–≥–µ–æ–º–µ—Ç—Ä–∏—á–Ω–∏–π, —á–µ—Ä–≤–æ–Ω–∏–π, —á–µ—Ä–≤–æ–Ω–∏–π —Ç—Ä–∏–∫—É—Ç–Ω–∏–∫, –Ω–∞–ø—Ä–∞–≤–ª–µ–Ω–∏–π —É–≥–æ—Ä—É
üîª	–≤–Ω–∏–∑, –≥–µ–æ–º–µ—Ç—Ä–∏—á–Ω–∏–π, —á–µ—Ä–≤–æ–Ω–∏–π, —á–µ—Ä–≤–æ–Ω–∏–π —Ç—Ä–∏–∫—É—Ç–Ω–∏–∫, –Ω–∞–ø—Ä–∞–≤–ª–µ–Ω–∏–π —É–Ω–∏–∑
üí†	–≥–µ–æ–º–µ—Ç—Ä–∏—á–Ω–∏–π, –¥—ñ–∞–º–∞–Ω—Ç, –∫—Ä–∞–ø–∫–∞, –º–∞–ª—é–Ω–æ–∫, —Ä–æ–º–± —ñ–∑ –∫—Ä–∞–ø–∫–æ—é
üîò	–≥–µ–æ–º–µ—Ç—Ä–∏—á–Ω–∏–π, –∫–Ω–æ–ø–∫–∞, –ø–µ—Ä–µ–º–∏–∫–∞—á
üî≤	–≥–µ–æ–º–µ—Ç—Ä–∏—á–Ω–∏–π, –∫–≤–∞–¥—Ä–∞—Ç, –∫–≤–∞–¥—Ä–∞—Ç–Ω–∞ –∫–Ω–æ–ø–∫–∞ –∑ —á–æ—Ä–Ω–æ—é —Ä–∞–º–∫–æ—é, –∫–Ω–æ–ø–∫–∞, —á–æ—Ä–Ω–∞ –∫–≤–∞–¥—Ä–∞—Ç–Ω–∞ –∫–Ω–æ–ø–∫–∞
üî≥	–±—ñ–ª–∞ –∫–≤–∞–¥—Ä–∞—Ç–Ω–∞ –∫–Ω–æ–ø–∫–∞, –≥–µ–æ–º–µ—Ç—Ä–∏—á–Ω–∏–π, –∫–≤–∞–¥—Ä–∞—Ç, –∫–≤–∞–¥—Ä–∞—Ç–Ω–∞ –∫–Ω–æ–ø–∫–∞ –∑ –±—ñ–ª–æ—é —Ä–∞–º–∫–æ—é, –∫–Ω–æ–ø–∫–∞, –∫–æ–Ω—Ç—É—Ä
üèÅ	–∫–∞—Ä—Ç–∞—Ç–∏–π, –∫–∞—Ä—Ç–∞—Ç–∏–π –ø—Ä–∞–ø–æ—Ä, –∫–ª—ñ—á–∞—Å—Ç–∏–π, –ø—Ä–∞–ø–æ—Ä –¥–ª—è –ø–µ—Ä–µ–≥–æ–Ω—ñ–≤
üö©	—Ç—Ä–∏–∫—É—Ç–Ω–∏–π –ø—Ä–∞–ø–æ—Ä, —Ñ–ª–∞–≥—à—Ç–æ–∫
üéå	c—Ö—Ä–µ—â–µ–Ω—ñ –ø—Ä–∞–ø–æ—Ä–∏, –Ω–∞–≤—Ö—Ä–µ—Å—Ç, –ø—Ä–∞–ø–æ—Ä–∏ –Ω–∞–≤—Ö—Ä–µ—Å—Ç, —Å—Ö—Ä–µ—â–µ–Ω—ñ –ø—Ä–∞–ø–æ—Ä–∏, —É—Ä–æ—á–∏—Å—Ç—ñ—Å—Ç—å, —è–ø–æ–Ω—Å—å–∫—ñ
üè¥	–º–∞–π–æ—Ä–∏—Ç—å, —á–æ—Ä–Ω–∏–π –ø—Ä–∞–ø–æ—Ä
üè≥‚Äçüåà	–≤–µ—Å–µ–ª–∫–∞, –≤–µ—Å–µ–ª–∫–æ–≤–∏–π, –≤–µ—Å–µ–ª–∫–æ–≤–∏–π –ø—Ä–∞–ø–æ—Ä, —Ä–∞–π–¥—É–≥–∞, —Ä–∞–π–¥—É–∂–Ω–∏–π –ø—Ä–∞–ø–æ—Ä
üè¥‚Äç‚ò†	–í–µ—Å–µ–ª–∏–π –†–æ–¥–∂–µ—Ä, –∫–æ—Ä—Å–∞—Ä, –ø—ñ—Ä–∞—Ç—Å—å–∫–∏–π, –ø—ñ—Ä–∞—Ç—Å—å–∫–∏–π –ø—Ä–∞–ø–æ—Ä, —Å–∫–∞—Ä–±
¬©Ô∏è	–∞–≤—Ç–æ—Ä—Å—å–∫–µ –ø—Ä–∞–≤–æ
¬ÆÔ∏è	–∑–∞—Ä–µ—î—Å—Ç—Ä–æ–≤–∞–Ω–∞ —Ç–æ—Ä–≥–æ–≤–µ–ª—å–Ω–∞ –º–∞—Ä–∫–∞, –∑–∞—Ä–µ—î—Å—Ç—Ä–æ–≤–∞–Ω–æ
‚ÄºÔ∏è	–¥–≤–∞, –∑–Ω–∞–∫, –æ–∫–ª–∏–∫—É, –ø–æ–¥–≤—ñ–π–Ω–∏–π –∑–Ω–∞–∫ –æ–∫–ª–∏–∫—É, –ø—É–Ω–∫—Ç—É–∞—Ü—ñ—è
‚ÅâÔ∏è	–∑–Ω–∞–∫, –∑–Ω–∞–∫–∏ –ø–∏—Ç–∞–Ω–Ω—è —Ç–∞ –æ–∫–ª–∏–∫—É, –ª—ñ–≥–∞—Ç—É—Ä–∞, –æ–∫–ª–∏–∫—É, –ø–∏—Ç–∞–Ω–Ω—è, –ø—É–Ω–∫—Ç—É–∞—Ü—ñ—è
‚Ñ¢Ô∏è	tm, –º–∞—Ä–∫–∞, —Ç–æ—Ä–≥–æ–≤–µ–ª—å–Ω–∞ –º–∞—Ä–∫–∞
‚ÑπÔ∏è	i, –¥–∂–µ—Ä–µ–ª–æ —ñ–Ω—Ñ–æ—Ä–º–∞—Ü—ñ—ó, —ñ–Ω—Ñ–æ—Ä–º–∞—Ü—ñ—è
‚ÜîÔ∏è	—Å—Ç—Ä—ñ–ª–∫–∞, —Å—Ç—Ä—ñ–ª–∫–∞ –≤–ª—ñ–≤–æ-–≤–ø—Ä–∞–≤–æ, —Å—Ç—Ä—ñ–ª–∫–∞ –ø—Ä–∞–≤–æ—Ä—É—á —ñ –ª—ñ–≤–æ—Ä—É—á
‚ÜïÔ∏è	—Å—Ç—Ä—ñ–ª–∫–∞, —Å—Ç—Ä—ñ–ª–∫–∞ –≤–≥–æ—Ä—É —Ç–∞ –≤–Ω–∏–∑, —Å—Ç—Ä—ñ–ª–∫–∞ –≤–≥–æ—Ä—É-–≤–Ω–∏–∑
‚ÜñÔ∏è	–Ω–∞–ø—Ä—è–º, –ø—Ä–æ–º—ñ–∂–Ω–∏–π, –ø—ñ–≤–Ω—ñ—á–Ω–æ-–∑–∞—Ö—ñ–¥–Ω–∏–π, —Å—Ç—Ä—ñ–ª–∫–∞, —Å—Ç—Ä—ñ–ª–∫–∞ –≤–≥–æ—Ä—É –≤–ª—ñ–≤–æ, —Å—Ç—Ä—ñ–ª–∫–∞ –≤–≥–æ—Ä—É —Ç–∞ –ª—ñ–≤–æ—Ä—É—á
‚ÜóÔ∏è	–Ω–∞ –ø—ñ–≤–Ω—ñ—á–Ω–∏–π —Å—Ö—ñ–¥, –Ω–∞–ø—Ä—è–º, —Å—Ç—Ä—ñ–ª–∫–∞, —Å—Ç—Ä—ñ–ª–∫–∞ –≤–≥–æ—Ä—É –≤–ø—Ä–∞–≤–æ, —á–µ—Ç–≤–µ—Ä—Ç–∏–Ω–Ω–∏–π —Ä—É–º–±
‚ÜòÔ∏è	–Ω–∞–ø—Ä—è–º, –ø—Ä–æ–º—ñ–∂–Ω–∏–π, –ø—ñ–≤–¥–µ–Ω–Ω–æ-—Å—Ö—ñ–¥–Ω–∏–π, —Å—Ç—Ä—ñ–ª–∫–∞, —Å—Ç—Ä—ñ–ª–∫–∞ –≤–Ω–∏–∑ —É–ø—Ä–∞–≤–æ, —Å—Ç—Ä—ñ–ª–∫–∞ –≤–Ω–∏–∑ —ñ –ø—Ä–∞–≤–æ—Ä—É—á
‚ÜôÔ∏è	–Ω–∞–ø—Ä—è–º, –ø—Ä–æ–º—ñ–∂–Ω–∏–π, –ø—ñ–≤–¥–µ–Ω–Ω–æ-–∑–∞—Ö—ñ–¥–Ω–∏–π, —Å—Ç—Ä—ñ–ª–∫–∞, —Å—Ç—Ä—ñ–ª–∫–∞ –≤–Ω–∏–∑ —É–ª—ñ–≤–æ, —Å—Ç—Ä—ñ–ª–∫–∞ –≤–Ω–∏–∑ —ñ –ª—ñ–≤–æ—Ä—É—á
‚Ü©Ô∏è	—Å—Ç—Ä—ñ–ª–∫–∞, —Å—Ç—Ä—ñ–ª–∫–∞ –≤–ø—Ä–∞–≤–æ –∑ –≤–∏–≥–∏–Ω–æ–º —É–ª—ñ–≤–æ, —Å—Ç—Ä—ñ–ª–∫–∞ –ø—Ä–∞–≤–æ—Ä—É—á —ñ–∑ –ø–æ–≤–æ—Ä–æ—Ç–æ–º –ª—ñ–≤–æ—Ä—É—á
‚Ü™Ô∏è	—Å—Ç—Ä—ñ–ª–∫–∞, —Å—Ç—Ä—ñ–ª–∫–∞ –≤–ª—ñ–≤–æ –∑ –≤–∏–≥–∏–Ω–æ–º —É–ø—Ä–∞–≤–æ, —Å—Ç—Ä—ñ–ª–∫–∞ –ª—ñ–≤–æ—Ä—É—á —ñ–∑ –ø–æ–≤–æ—Ä–æ—Ç–æ–º –ø—Ä–∞–≤–æ—Ä—É—á
‚åöÔ∏è	–≥–æ–¥–∏–Ω–Ω–∏–∫, –Ω–∞—Ä—É—á–Ω–∏–π –≥–æ–¥–∏–Ω–Ω–∏–∫
‚åõÔ∏è	–ø—ñ—Å–∫–æ–≤–∏–π –≥–æ–¥–∏–Ω–Ω–∏–∫, –ø—ñ—Å–æ–∫, –ø—ñ—Å–æ—á–Ω–∏–π –≥–æ–¥–∏–Ω–Ω–∏–∫, —Ç–∞–π–º–µ—Ä
‚å®Ô∏è	–∫–ª–∞–≤—ñ–∞—Ç—É—Ä–∞, –∫–æ–º–ø‚Äô—é—Ç–µ—Ä
‚èèÔ∏è	–≤–∏–π–Ω—è—Ç–∏, –∫–Ω–æ–ø–∫–∞ ¬´–í–∏–π–Ω—è—Ç–∏¬ª, –∫–Ω–æ–ø–∫–∞ –≤–∏—Ç—è–≥–∞–Ω–Ω—è
‚è±Ô∏è	–≥–æ–¥–∏–Ω–Ω–∏–∫, —Å–µ–∫—É–Ω–¥–æ–º—ñ—Ä
‚è≤Ô∏è	–≥–æ–¥–∏–Ω–Ω–∏–∫, —Ç–∞–π–º–µ—Ä
‚è≥Ô∏è	–ø—ñ—Å–∫–æ–≤–∏–π –≥–æ–¥–∏–Ω–Ω–∏–∫ —ñ–∑ –ø—ñ—Å–∫–æ–º, —è–∫–∏–π —Å–∏–ø–ª–µ—Ç—å—Å—è, –ø—ñ—Å–æ–∫, –ø—ñ—Å–æ—á–Ω–∏–π –≥–æ–¥–∏–Ω–Ω–∏–∫, –ø—ñ—Å–æ—á–Ω–∏–π –≥–æ–¥–∏–Ω–Ω–∏–∫ —ñ–∑ –ø—ñ—Å–∫–æ–º, —è–∫–∏–π —Å–∏–ø–ª–µ—Ç—å—Å—è, —Ç–∞–π–º–µ—Ä
‚è∏Ô∏è	–≤–µ—Ä—Ç–∏–∫–∞–ª—å–Ω–∞, –¥–≤—ñ, –∫–Ω–æ–ø–∫–∞ ¬´–ü—Ä–∏–∑—É–ø–∏–Ω–∏—Ç–∏¬ª, –∫–Ω–æ–ø–∫–∞ –ø–∞—É–∑–∏, –ª—ñ–Ω—ñ—è, –ø–∞—É–∑–∞
‚èπÔ∏è	–∑—É–ø–∏–Ω–∏—Ç–∏, –∫–≤–∞–¥—Ä–∞—Ç, –∫–Ω–æ–ø–∫–∞ ¬´–ü—Ä–∏–ø–∏–Ω–∏—Ç–∏¬ª, –∫–Ω–æ–ø–∫–∞ —Å—Ç–æ–ø, –ø—Ä–∏–ø–∏–Ω–∏—Ç–∏
‚è∫Ô∏è	–∑–∞–ø–∏—Å, –∫–Ω–æ–ø–∫–∞ ¬´–ó–∞–ø–∏—Å¬ª, –∫–Ω–æ–ø–∫–∞ –∑–∞–ø–∏—Å—É, –∫–æ–ª–æ
‚ìÇÔ∏è	–∫–æ–ª–æ, –∫–æ–ª–æ –∑ –ª—ñ—Ç–µ—Ä–æ—é ¬´–º¬ª, –º
‚ñ™Ô∏è	–≥–µ–æ–º–µ—Ç—Ä–∏—á–Ω–∏–π, –∫–≤–∞–¥—Ä–∞—Ç, –º–∞–ª–∏–π —á–æ—Ä–Ω–∏–π –∫–≤–∞–¥—Ä–∞—Ç
‚ñ´Ô∏è	–≥–µ–æ–º–µ—Ç—Ä–∏—á–Ω–∏–π, –∫–≤–∞–¥—Ä–∞—Ç, –º–∞–ª–∏–π –±—ñ–ª–∏–π –∫–≤–∞–¥—Ä–∞—Ç
‚óªÔ∏è	–≥–µ–æ–º–µ—Ç—Ä–∏—á–Ω–∏–π, –∫–≤–∞–¥—Ä–∞—Ç, —Å–µ—Ä–µ–¥–Ω—ñ–π –±—ñ–ª–∏–π –∫–≤–∞–¥—Ä–∞—Ç
‚óºÔ∏è	–≥–µ–æ–º–µ—Ç—Ä–∏—á–Ω–∏–π, –∫–≤–∞–¥—Ä–∞—Ç, —Å–µ—Ä–µ–¥–Ω—ñ–π —á–æ—Ä–Ω–∏–π –∫–≤–∞–¥—Ä–∞—Ç
‚óΩÔ∏è	–≥–µ–æ–º–µ—Ç—Ä–∏—á–Ω–∏–π, –∫–≤–∞–¥—Ä–∞—Ç, –º–µ–Ω—à–∏–π –∑–∞ —Å–µ—Ä–µ–¥–Ω—ñ–π –±—ñ–ª–∏–π –∫–≤–∞–¥—Ä–∞—Ç
‚óæÔ∏è	–≥–µ–æ–º–µ—Ç—Ä–∏—á–Ω–∏–π, –∫–≤–∞–¥—Ä–∞—Ç, –º–µ–Ω—à–∏–π –∑–∞ —Å–µ—Ä–µ–¥–Ω—ñ–π —á–æ—Ä–Ω–∏–π –∫–≤–∞–¥—Ä–∞—Ç
‚òÄÔ∏è	–∫–æ—Å–º–æ—Å, –ø–æ–≥–æ–¥–∞, –ø—Ä–æ–º–µ–Ω—ñ, —Å–æ–Ω—Ü–µ, —Å–æ–Ω—è—á–Ω–∏–π, —è—Å–∫—Ä–∞–≤–∏–π
‚òÅÔ∏è	–ø–æ–≥–æ–¥–∞, —Ö–º–∞—Ä–∞
‚òÇÔ∏è	–¥–æ—â, –æ–¥—è–≥, –ø–∞—Ä–∞—Å–æ–ª—å–∫–∞, –ø–æ–≥–æ–¥–∞
‚òÉÔ∏è	–ø–æ–≥–æ–¥–∞, —Å–Ω—ñ–≥, —Å–Ω—ñ–≥–æ–≤–∏–∫, —Ö–æ–ª–æ–¥–Ω–∏–π
‚òÑÔ∏è	–∫–æ–º–µ—Ç–∞, –∫–æ—Å–º–æ—Å
‚òéÔ∏è	—Ç–µ–ª–µ—Ñ–æ–Ω
‚òëÔ∏è	–∫–ª—ñ—Ç–∏–Ω–∫–∞ –≤–∏–±–æ—Ä—á–æ–≥–æ –±—é–ª–µ—Ç–µ–Ω—è –∑ –≥–∞–ª–æ—á–∫–æ—é, –ø–æ–ª–µ –≤–∏–±–æ—Ä—á–æ–≥–æ –±—é–ª–µ—Ç–µ–Ω—è, –ø–æ–ª–µ –≤–∏–±–æ—Ä—á–æ–≥–æ –±—é–ª–µ—Ç–µ–Ω—è –∑ –ø–æ–∑–Ω–∞—á–∫–æ—é, –ø—Ä–∞–ø–æ—Ä–µ—Ü—å
‚òîÔ∏è	–¥–æ—â, –∫—Ä–∞–ø–ª—è, –æ–¥—è–≥, –ø–∞—Ä–∞—Å–æ–ª—å–∫–∞, –ø–∞—Ä–∞—Å–æ–ª—å–∫–∞ –∑ –∫—Ä–∞–ø–ª—è–º–∏ –¥–æ—â—É, –ø–æ–≥–æ–¥–∞
‚òïÔ∏è	–≥–∞—Ä—è—á–∏–π, –≥–∞—Ä—è—á–∏–π –Ω–∞–ø—ñ–π, –∫–∞–≤–∞, –Ω–∞–ø—ñ–π, –ø–∞—Ä—É—é—á–∏–π, –ø–∏—Ç–∏, —á–∞–π
‚òòÔ∏è	—Ä–æ—Å–ª–∏–Ω–∞, —Ç—Ä–∏–ª–∏—Å–Ω–∏–∫
‚òùÔ∏è	–≤–∫–∞–∑—ñ–≤–Ω–∏–π –ø–∞–ª–µ—Ü—å, —â–æ –≤–∫–∞–∑—É—î –≤–≥–æ—Ä—É, –ø–∞–ª–µ—Ü—å, –ø–æ–∫–∞–∑—É–≤–∞—Ç–∏, —Ä—É–∫–∞, —Ç—ñ–ª–æ, —É–≥–æ—Ä—É, —É–∫–∞–∑—É–≤–∞—Ç–∏
‚ò†Ô∏è	–º–æ–Ω—Å—Ç—Ä, –æ–±–ª–∏—á—á—è, –ø–µ—Ä–µ—Ö—Ä–µ—â–µ–Ω—ñ –∫—ñ—Å—Ç–∫–∏, —Å–º–µ—Ä—Ç—å, —Ç—ñ–ª–æ, —á–µ—Ä–µ–ø, —á–µ—Ä–µ–ø —ñ –∫—ñ—Å—Ç–∫–∏
‚ò¢Ô∏è	–∑–Ω–∞–∫, –æ–ø—Ä–æ–º—ñ–Ω–µ–Ω–Ω—è, —Ä–∞–¥—ñ–∞—Ü—ñ–π–Ω–∞ –Ω–µ–±–µ–∑–ø–µ–∫–∞, —Ä–∞–¥—ñ–æ–∞–∫—Ç–∏–≤–Ω—ñ—Å—Ç—å
‚ò£Ô∏è	–±—ñ–æ–ª–æ–≥—ñ—á–Ω–∞ –∑–∞–≥—Ä–æ–∑–∞, –±—ñ–æ–ª–æ–≥—ñ—á–Ω–∞ –Ω–µ–±–µ–∑–ø–µ–∫–∞, –∑–Ω–∞–∫
‚ò¶Ô∏è	–ø—Ä–∞–≤–æ—Å–ª–∞–≤–Ω–∏–π —Ö—Ä–µ—Å—Ç, —Ä–µ–ª—ñ–≥—ñ—è, —Ö—Ä–µ—Å—Ç, —Ö—Ä–∏—Å—Ç–∏—è–Ω–∏–Ω
‚ò™Ô∏è	–∑—ñ—Ä–∫–∞ —ñ –ø—ñ–≤–º—ñ—Å—è—Ü—å, –º—É—Å—É–ª—å–º–∞–Ω–∏–Ω, —Ä–µ–ª—ñ–≥—ñ—è, —ñ—Å–ª–∞–º
‚òÆÔ∏è	–º–∏—Ä, —Å–∏–º–≤–æ–ª –º–∏—Ä—É
‚òØÔ∏è	–¥–∞–æ, –¥–∞–æ—Å–∏–∑–º, —Ä–µ–ª—ñ–≥—ñ—è, —è–Ω—å, —ñ–Ω—å, —ñ–Ω—å-—è–Ω
‚ò∏Ô∏è	–±—É–¥–¥–∏—Å—Ç, –¥—Ö–∞—Ä–º–∞, –∫–æ–ª–µ—Å–æ, –∫–æ–ª–µ—Å–æ –¥—Ö–∞—Ä–º–∏, —Ä–µ–ª—ñ–≥—ñ—è
‚òπÔ∏è	–æ–±–ª–∏—á—á—è, –ø–æ—Ö–º—É—Ä–µ –æ–±–ª–∏—á—á—è, —Å—É–º–Ω–∏–π
‚ò∫Ô∏è	–æ–±–ª–∏—á—á—è, –ø–æ—Å–º—ñ—à–∫–∞, —Å–ø–æ–∫—ñ–π–Ω–∏–π, —É—Å–º—ñ—Ö–Ω–µ–Ω–µ –æ–±–ª–∏—á—á—è
‚ôÄÔ∏è	–∂—ñ–Ω–∫–∞, –∂—ñ–Ω–æ—á–∞ —Å—Ç–∞—Ç—å, –∑–Ω–∞–∫ –∂—ñ–Ω–∫–∏, —Å–∏–º–≤–æ–ª –∂—ñ–Ω–∫–∏
‚ôÇÔ∏è	–∑–Ω–∞–∫ —á–æ–ª–æ–≤—ñ–∫–∞, —Å–∏–º–≤–æ–ª —á–æ–ª–æ–≤—ñ–∫–∞, —á–æ–ª–æ–≤—ñ–∫, —á–æ–ª–æ–≤—ñ—á–∞ —Å—Ç–∞—Ç—å
‚ôàÔ∏è	–û–≤–µ–Ω, –±–∞—Ä–∞–Ω, –∑–æ–¥—ñ–∞–∫
‚ôâÔ∏è	–¢–µ–ª–µ—Ü—å, –±–∏–∫, –≤—ñ–ª, –∑–æ–¥—ñ–∞–∫
‚ôäÔ∏è	–ë–ª–∏–∑–Ω—é–∫–∏, –∑–æ–¥—ñ–∞–∫
‚ôãÔ∏è	–†–∞–∫, –∑–æ–¥—ñ–∞–∫, –∫—Ä–∞–±
‚ôåÔ∏è	–õ–µ–≤, –∑–æ–¥—ñ–∞–∫
‚ôçÔ∏è	–î—ñ–≤–∞, –∑–æ–¥—ñ–∞–∫
‚ôéÔ∏è	–¢–µ—Ä–µ–∑–∏, –∑–æ–¥—ñ–∞–∫, —Ä—ñ–≤–Ω–æ–≤–∞–≥–∞, —Å–ø—Ä–∞–≤–µ–¥–ª–∏–≤—ñ—Å—Ç—å
‚ôèÔ∏è	–°–∫–æ—Ä–ø—ñ–æ–Ω (–∑–Ω–∞–∫ –∑–æ–¥—ñ–∞–∫—É), –∑–æ–¥—ñ–∞–∫, —Å–∫–æ—Ä–ø—ñ–æ–Ω
‚ôêÔ∏è	–°—Ç—Ä—ñ–ª–µ—Ü—å, –∑–æ–¥—ñ–∞–∫
‚ôëÔ∏è	–ö–æ–∑–µ—Ä—ñ–≥, –ö–æ–∑–æ—Ä—ñ–≥, –∑–æ–¥—ñ–∞–∫, –∫–æ–∑–∞
‚ôíÔ∏è	–í–æ–¥–æ–ª—ñ–π, –≤–æ–¥–∞, –∑–æ–¥—ñ–∞–∫, –Ω–æ—Å—ñ–π
‚ôìÔ∏è	–†–∏–±–∏, –∑–æ–¥—ñ–∞–∫, —Ä–∏–±–∞
‚ôüÔ∏è	–ø—ñ—à–∞–∫, –ø—ñ—à–∫–∞, —Ñ—ñ–≥—É—Ä–∞, —à–∞—Ö–∏, —à–∞—Ö–º–∞—Ç–∏
‚ô†Ô∏è	–≥—Ä–∞, –∫–∞—Ä—Ç–∞, –º–∞—Å—Ç—å, –ø—ñ–∫–∞
‚ô£Ô∏è	–≥—Ä–∞, –∫–∞—Ä—Ç–∞, –º–∞—Å—Ç—å, —Ç—Ä–µ—Ñ–∞, —Ç—Ä–µ—Ñ–∏
‚ô•Ô∏è	–≥—Ä–∞, –∫–∞—Ä—Ç–∞, –º–∞—Å—Ç—å, —á–∏—Ä–≤–∞, —á–∏—Ä–≤–∏
‚ô¶Ô∏è	–±—É–±–Ω–∞, –±—É–±–Ω–∏, –≥—Ä–∞, –∫–∞—Ä—Ç–∞, –º–∞—Å—Ç—å
‚ô®Ô∏è	–≥–∞—Ä—è—á–∏–π, –≥–∞—Ä—è—á—ñ –¥–∂–µ—Ä–µ–ª–∞, –¥–∂–µ—Ä–µ–ª–æ, –ø–∞—Ä—É—é—á—ñ
‚ôªÔ∏è	–ø–µ—Ä–µ—Ä–æ–±–∫–∞, —Å–∏–º–≤–æ–ª —É—Ç–∏–ª—ñ–∑–∞—Ü—ñ—ó, —É—Ç–∏–ª—ñ–∑–∞—Ü—ñ—è
‚ôæÔ∏è	–±–µ–∑–∫—ñ–Ω–µ—á–Ω—ñ—Å—Ç—å, –±–µ–∑–∫—ñ–Ω—á–µ–Ω–Ω—ñ—Å—Ç—å, –≤—ñ—Å—ñ–º–∫–∞, –Ω–µ—Å–∫—ñ–Ω—á–µ–Ω–Ω—ñ—Å—Ç—å, —É–Ω—ñ–≤–µ—Ä—Å–∞–ª—å–Ω—ñ—Å—Ç—å
‚ôøÔ∏è	–¥–æ—Å—Ç—É–ø–Ω—ñ—Å—Ç—å, —Å–∏–º–≤–æ–ª –≤—ñ–∑–∫–∞, —Å–∏–º–≤–æ–ª –∫—Ä—ñ—Å–ª–∞-–≤—ñ–∑–∫–∞
‚öíÔ∏è	–∫–∏—Ä–∫–∞, –º–æ–ª–æ—Ç–æ–∫, –º–æ–ª–æ—Ç–æ–∫ —ñ –∫–∏—Ä–∫–∞, —ñ–Ω—Å—Ç—Ä—É–º–µ–Ω—Ç
‚öìÔ∏è	–∑–Ω–∞—Ä—è–¥–¥—è, –∫–æ—Ä–∞–±–µ–ª—å, —è–∫—ñ—Ä
‚öîÔ∏è	–∑–±—Ä–æ—è, –º–µ—á—ñ, –ø–µ—Ä–µ—Ö—Ä–µ—â–µ–Ω–∏–π, —Å—Ö—Ä–µ—â–µ–Ω—ñ –º–µ—á—ñ
‚öïÔ∏è	–µ—Å–∫—É–ª–∞–ø, –º–µ–¥–∏—Ü–∏–Ω–∞, –º–µ–¥–∏—á–Ω–∏–π —Å–∏–º–≤–æ–ª, –ø–µ—Ä—Å–æ–Ω–∞–ª, —Å–∏–º–≤–æ–ª –º–µ–¥–∏—Ü–∏–Ω–∏
‚öñÔ∏è	–≤–∞–≥–∞, –≤–∞–≥–∏, –∑–Ω–∞—Ä—è–¥–¥—è, –∑–æ–¥—ñ–∞–∫, —Ä—ñ–≤–Ω–æ–≤–∞–≥–∞, —Å–ø—Ä–∞–≤–µ–¥–ª–∏–≤—ñ—Å—Ç—å, —Ç–µ—Ä–µ–∑–∏
‚öóÔ∏è	–∑–Ω–∞—Ä—è–¥–¥—è, –ø–µ—Ä–µ–≥—ñ–Ω–Ω–∏–π –∫—É–±, —Ö—ñ–º—ñ—è
‚öôÔ∏è	—à–µ—Å—Ç—ñ—Ä–Ω—è, —ñ–Ω—Å—Ç—Ä—É–º–µ–Ω—Ç
‚öõÔ∏è	–∞—Ç–µ—ó—Å—Ç, –∞—Ç–æ–º, —Å–∏–º–≤–æ–ª –∞—Ç–æ–º–∞
‚ö†Ô∏è	–∑–∞—Å—Ç–µ—Ä–µ–∂–µ–Ω–Ω—è, –ø–æ–ø–µ—Ä–µ–¥–∂–µ–Ω–Ω—è
‚ö°Ô∏è	–±–ª–∏—Å–∫–∞–≤–∫–∞, –≤–∏—Å–æ–∫–∞ –Ω–∞–ø—Ä—É–≥–∞, –µ–ª–µ–∫—Ç—Ä–∏–∫–∞, –µ–ª–µ–∫—Ç—Ä–∏—á–Ω–∏–π, –Ω–∞–ø—Ä—É–≥–∞, –Ω–µ–±–µ–∑–ø–µ–∫–∞, –ø–æ—Å—Ç—Ä—ñ–ª
‚ö™Ô∏è	–±—ñ–ª–µ, –±—ñ–ª–∏–π –∫—Ä—É–≥, –≥–µ–æ–º–µ—Ç—Ä–∏—á–Ω–∏–π, –∫–æ–ª–æ
‚ö´Ô∏è	–≥–µ–æ–º–µ—Ç—Ä–∏—á–Ω–∏–π, –∫–æ–ª–æ, —á–æ—Ä–Ω–µ, —á–æ—Ä–Ω–∏–π –∫—Ä—É–≥
‚ö∞Ô∏è	Replaced with a more common term, —Ç—Ä—É–Ω–∞
‚ö±Ô∏è	–ø–æ—Ö–æ–≤–∞–ª—å–Ω–∞ —É—Ä–Ω–∞, –ø–æ—Ö–æ—Ä–æ–Ω, —Å–º–µ—Ä—Ç—å, —É—Ä–Ω–∞, —É—Ä–Ω–∞ –¥–ª—è —Ç–ª—ñ–Ω—É
‚öΩÔ∏è	–º‚Äô—è—á, —Ñ—É—Ç–±–æ–ª, —Ñ—É—Ç–±–æ–ª—å–Ω–∏–π –º‚Äô—è—á
‚öæÔ∏è	–±–µ–π—Å–±–æ–ª—å–Ω–∏–π –º‚Äô—è—á, –º‚Äô—è—á
‚õÑÔ∏è	c–Ω—ñ–≥–æ–≤–∏–∫, –ø–æ–≥–æ–¥–∞, —Å–Ω—ñ–≥, —Å–Ω—ñ–≥–æ–≤–∏–∫, —Å–Ω—ñ–≥–æ–≤–∏–∫ –±–µ–∑ —Å–Ω—ñ–≥—É, —Ö–æ–ª–æ–¥–Ω–∏–π
‚õÖÔ∏è	–ø–æ–≥–æ–¥–∞, —Å–æ–Ω—Ü–µ, —Å–æ–Ω—Ü–µ –∑–∞ —Ö–º–∞—Ä–æ—é, —Ö–º–∞—Ä–∞
‚õàÔ∏è	–≥—Ä—ñ–º, –¥–æ—â, –ø–æ–≥–æ–¥–∞, —Ö–º–∞—Ä–∞, —Ö–º–∞—Ä–∞ –∑ –±–ª–∏—Å–∫–∞–≤–∫–æ—é —Ç–∞ –¥–æ—â–µ–º
‚õèÔ∏è	–∫–∏—Ä–∫–∞, —à–∞—Ö—Ç–∞, —ñ–Ω—Å—Ç—Ä—É–º–µ–Ω—Ç
‚õëÔ∏è	–¥–æ–ø–æ–º–æ–≥–∞, –∫–∞—Å–∫–∞ –∑ –±—ñ–ª–∏–º —Ö—Ä–µ—Å—Ç–æ–º, –∫–∞—Å–∫–∞ —Ä—è—Ç—É–≤–∞–ª—å–Ω–∏–∫–∞, –ª–∏—Ü–µ, —Ö—Ä–µ—Å—Ç, —à–∞–ø–∫–∞, —à–æ–ª–æ–º
‚õìÔ∏è	–ª–∞–Ω—Ü—é–≥, –ª–∞–Ω—Ü—é–≥–∏
‚õîÔ∏è	–≤ º—ó–∑–¥, –≤ º—ó–∑–¥ –∑–∞–±–æ—Ä–æ–Ω–µ–Ω–æ, –∑–∞–±–æ—Ä–æ–Ω–µ–Ω–æ, –Ω–µ –¥–æ–∑–≤–æ–ª–µ–Ω–æ, –Ω–µ–º–∞—î, –Ω—ñ, —Ä—É—Ö
‚õ©Ô∏è	—Ä–µ–ª—ñ–≥—ñ—è, —Å–≤—è—Ç–∏–Ω—è, —Å–∏–Ω—Ç–æ—ó—Å—Ç—Å—å–∫–∏–π, —Å–∏–Ω—Ç–æ—ó—Å—Ç—Å—å–∫–∏–π —Ö—Ä–∞–º
‚õ™Ô∏è	–±—É–¥—ñ–≤–ª—è, —Ä–µ–ª—ñ–≥—ñ—è, —Ö—Ä–µ—Å—Ç, —Ö—Ä–∏—Å—Ç–∏—è–Ω—Å—å–∫–∏–π, —Ü–µ—Ä–∫–≤–∞
‚õ∞Ô∏è	–≥–æ—Ä–∞
‚õ±Ô∏è	–¥–æ—â, –ø–∞—Ä–∞—Å–æ–ª—å–∫–∞, –ø–ª—è–∂–Ω–∞ –ø–∞—Ä–∞—Å–æ–ª—å–∫–∞, –ø–æ–≥–æ–¥–∞, —Å–æ–Ω—Ü–µ
‚õ≤Ô∏è	—Ñ–æ–Ω—Ç–∞–Ω
‚õ≥Ô∏è	–≥–æ–ª—å—Ñ, –ª—É–Ω–∫–∞, –ª—É–Ω–∫–∞ –¥–ª—è –≥–æ–ª—å—Ñ—É –∑ –ø—Ä–∞–ø–æ—Ä—Ü–µ–º
‚õ¥Ô∏è	–ø–æ—Ä–æ–º, —á–æ–≤–µ–Ω
‚õµÔ∏è	–≤—ñ–¥–ø–æ—á–∏–Ω–æ–∫, –≤—ñ—Ç—Ä–∏–ª—å–Ω–∏–∫, –º–æ—Ä–µ, —Ç—Ä–∞–Ω—Å–ø–æ—Ä—Ç, —á–æ–≤–µ–Ω, —è—Ö—Ç–∞
‚õ∑Ô∏è	–ª–∏–∂–Ω–∏–∫, –ª–∏–∂—ñ, —Å–Ω—ñ–≥
‚õ∏Ô∏è	–∫–æ–≤–∑–∞–Ω, –ª—ñ–¥
‚õπÔ∏è	–ª—é–¥–∏–Ω–∞ –∑ –º‚Äô—è—á–µ–º, –ª—é–¥–∏–Ω–∞, —â–æ –≤–µ–¥–µ –º º—è—á, –º‚Äô—è—á
‚õ∫Ô∏è	–Ω–∞–º–µ—Ç, –ø–æ—Ö—ñ–¥
‚õΩÔ∏è	–±–µ–Ω–∑–æ–∫–æ–ª–æ–Ω–∫–∞, –∑–∞–ø—Ä–∞–≤–∫–∞, –Ω–∞—Å–æ—Å, –ø–∞–ª—å–Ω–µ
‚úÇÔ∏è	–Ω–æ–∂–∏—Ü—ñ, —ñ–Ω—Å—Ç—Ä—É–º–µ–Ω—Ç
‚úàÔ∏è	–ª—ñ—Ç–∞–∫, —Ç—Ä–∞–Ω—Å–ø–æ—Ä—Ç
‚úâÔ∏è	–µ–ª–µ–∫—Ç—Ä–æ–Ω–Ω–∏–π, –µ–º–µ–π–ª, –∫–æ–Ω–≤–µ—Ä—Ç, –ª–∏—Å—Ç, –ø–æ—à—Ç–∞
‚úåÔ∏è	V, –∂–µ—Å—Ç –ø–µ—Ä–µ–º–æ–≥–∏, –ø–µ—Ä–µ–º–æ–≥–∞, —Ä—É–∫–∞, —Ç—ñ–ª–æ
‚úçÔ∏è	–ø–∏—Å–∞—Ç–∏, —Ä—É–∫–∞, —Ä—É–∫–∞, —â–æ –ø–∏—à–µ, —Ç—ñ–ª–æ
‚úèÔ∏è	–æ–ª—ñ–≤–µ—Ü—å
‚úíÔ∏è	–∫—ñ–Ω—á–∏–∫ —á–æ—Ä–Ω–∏–ª—å–Ω–æ–≥–æ –ø–µ—Ä–∞, –ø–µ—Ä–æ, –ø–µ—Ä–æ —Å—Ç–∞—Ä–æ–º–æ–¥–Ω–æ—ó —á–æ—Ä–Ω–∏–ª—å–Ω–æ—ó —Ä—É—á–∫–∏, —Ä—É—á–∫–∞
‚úîÔ∏è	–∂–∏—Ä–Ω–∞ –≥–∞–ª–æ—á–∫–∞, –∂–∏—Ä–Ω–∏–π –ø—Ä–∞–ø–æ—Ä–µ—Ü—å, –∑–Ω–∞—á–æ–∫, –ø—Ä–∞–ø–æ—Ä–µ—Ü—å
‚úñÔ∏è	x, –∂–∏—Ä–Ω–∏–π –∑–Ω–∞–∫ –º–Ω–æ–∂–µ–Ω–Ω—è [x], –∂–∏—Ä–Ω–∏–π –∑–Ω–∞–∫ –º–Ω–æ–∂–µ–Ω–Ω—è ¬´x¬ª, –º–Ω–æ–∂–µ–Ω–Ω—è, –ø–æ–º–Ω–æ–∂–∏—Ç–∏, —Å–∫–∞—Å—É–≤–∞—Ç–∏
‚úùÔ∏è	–∫–∞—Ç–æ–ª–∏—Ü—å–∫–∏–π —Ö—Ä–µ—Å—Ç, –ª–∞—Ç–∏–Ω—Å—å–∫–∏–π —Ö—Ä–µ—Å—Ç, —Ä–µ–ª—ñ–≥—ñ—è, —Ö—Ä–µ—Å—Ç, —Ö—Ä–∏—Å—Ç–∏—è–Ω–∏–Ω
‚ú°Ô∏è	–¥–∞–≤–∏–¥, –∑—ñ—Ä–∫–∞, –∑—ñ—Ä–∫–∞ –î–∞–≤–∏–¥–∞, —Ä–µ–ª—ñ–≥—ñ—è, —î–≤—Ä–µ–π, —î–≤—Ä–µ–π—Å—å–∫–∏–π
‚ú≥Ô∏è	–≤–æ—Å—å–º–∏–∫—É—Ç–Ω–∞ –∑—ñ—Ä–∫–∞, –∑—ñ—Ä–æ—á–∫–∞
‚ú¥Ô∏è	–≤–æ—Å—å–º–∏–∫—ñ–Ω–µ—á–Ω–∞ –∑—ñ—Ä–∫–∞, –≤–æ—Å—å–º–∏–∫—ñ–Ω—Ü–µ–≤–∞ –∑—ñ—Ä–∫–∞, –∑—ñ—Ä–∫–∞
‚ùÑÔ∏è	–ø–æ–≥–æ–¥–∞, —Å–Ω—ñ–≥, —Å–Ω—ñ–∂–∏–Ω–∫–∞, —Ö–æ–ª–æ–¥–Ω–∏–π
‚ùáÔ∏è	–±–ª–∏—Å–∫—ñ—Ç–∫–∞
‚ùìÔ∏è	–∑–Ω–∞–∫, –∑–Ω–∞–∫ –ø–∏—Ç–∞–Ω–Ω—è, –ø–∏—Ç–∞–Ω–Ω—è, –ø—É–Ω–∫—Ç—É–∞—Ü—ñ—è
‚ùóÔ∏è	–∑–Ω–∞–∫, –∑–Ω–∞–∫ –æ–∫–ª–∏–∫—É, –æ–∫–ª–∏–∫—É, –ø—É–Ω–∫—Ç—É–∞—Ü—ñ—è
‚ù£Ô∏è	–≤–∞–∂–∫–µ —Å–µ—Ä—Ü–µ —É –≤–∏–≥–ª—è–¥—ñ –∑–Ω–∞–∫—É –æ–∫–ª–∏–∫—É, –∑–Ω–∞–∫ –æ–∫–ª–∏–∫—É, –ø—É–Ω–∫—Ç—É–∞—Ü—ñ—è, —Å–µ—Ä—Ü–µ
‚ù§Ô∏è	—Å–µ—Ä—Ü–µ, —á–µ—Ä–≤–æ–Ω–µ —Å–µ—Ä—Ü–µ
‚û°Ô∏è	–Ω–∞–ø—Ä—è–º, —Å—Ç–æ—Ä–æ–Ω–∞, —Å—Ç—Ä—ñ–ª–∫–∞, —Å—Ç—Ä—ñ–ª–∫–∞ –≤–ø—Ä–∞–≤–æ, —Å—Ç—Ä—ñ–ª–∫–∞ –ø—Ä–∞–≤–æ—Ä—É—á, —Å—Ö—ñ–¥–Ω–∏–π
‚§¥Ô∏è	—Å—Ç—Ä—ñ–ª–∫–∞, —Å—Ç—Ä—ñ–ª–∫–∞ –≤–ø—Ä–∞–≤–æ –∑ –≤–∏–≥–∏–Ω–æ–º —É–≥–æ—Ä—É, —Å—Ç—Ä—ñ–ª–∫–∞ –ø—Ä–∞–≤–æ—Ä—É—á —ñ–∑ –ø–æ–≤–æ—Ä–æ—Ç–æ–º —É–≥–æ—Ä—É
‚§µÔ∏è	–≤–Ω–∏–∑, —Å—Ç—Ä—ñ–ª–∫–∞, —Å—Ç—Ä—ñ–ª–∫–∞ –≤–ø—Ä–∞–≤–æ –∑ –≤–∏–≥–∏–Ω–æ–º —É–Ω–∏–∑, —Å—Ç—Ä—ñ–ª–∫–∞ –ø—Ä–∞–≤–æ—Ä—É—á —ñ–∑ –ø–æ–≤–æ—Ä–æ—Ç–æ–º —É–Ω–∏–∑
‚¨ÖÔ∏è	–∑–∞—Ö—ñ–¥–Ω–∏–π, –Ω–∞–ø—Ä—è–º, —Å—Ç–æ—Ä–æ–Ω–∞, —Å—Ç—Ä—ñ–ª–∫–∞, —Å—Ç—Ä—ñ–ª–∫–∞ –≤–ª—ñ–≤–æ, —Å—Ç—Ä—ñ–ª–∫–∞ –ª—ñ–≤–æ—Ä—É—á
‚¨ÜÔ∏è	–Ω–∞ –ø—ñ–≤–Ω—ñ—á, –Ω–∞–ø—Ä—è–º, —Å—Ç–æ—Ä–æ–Ω–∞ —Å–≤—ñ—Ç—É, —Å—Ç—Ä—ñ–ª–∫–∞, —Å—Ç—Ä—ñ–ª–∫–∞ –≤–≥–æ—Ä—É
‚¨áÔ∏è	–Ω–∞–ø—Ä—è–º, –ø—ñ–≤–¥–µ–Ω–Ω–∏–π, —Å—Ç–æ—Ä–æ–Ω–∞, —Å—Ç—Ä—ñ–ª–∫–∞, —Å—Ç—Ä—ñ–ª–∫–∞ –≤–Ω–∏–∑
‚¨õÔ∏è	–≤–µ–ª–∏–∫–∏–π —á–æ—Ä–Ω–∏–π –∫–≤–∞–¥—Ä–∞—Ç, –≥–µ–æ–º–µ—Ç—Ä–∏—á–Ω–∏–π, –∫–≤–∞–¥—Ä–∞—Ç
‚¨úÔ∏è	–≤–µ–ª–∏–∫–∏–π –±—ñ–ª–∏–π –∫–≤–∞–¥—Ä–∞—Ç, –≥–µ–æ–º–µ—Ç—Ä–∏—á–Ω–∏–π, –∫–≤–∞–¥—Ä–∞—Ç
‚≠êÔ∏è	–∑—ñ—Ä–∫–∞, —Å–µ—Ä–µ–¥–Ω—è –±—ñ–ª–∞ –∑—ñ—Ä–∫–∞
‚≠ïÔ∏è	–≤–µ–ª–∏–∫–µ –∂–∏—Ä–Ω–µ –∫–æ–ª–æ, –∫–æ–ª–æ, –æ
„Ä∞Ô∏è	–ø—É–Ω–∫—Ç—É–∞—Ü—ñ—è, —Ç–∏—Ä–µ, —Ö–≤–∏–ª—è—Å—Ç–µ —Ç–∏—Ä–µ, —Ö–≤–∏–ª—è—Å—Ç–∏–π
„ÄΩÔ∏è	–∑–Ω–∞—á–æ–∫, —á–∞—Å—Ç–∏–Ω–∞, —è–ø–æ–Ω—Å—å–∫–∏–π –∑–Ω–∞–∫ –ø–æ—á–∞—Ç–∫—É —á–∞—Å—Ç–∏–Ω–∏ –ø—ñ—Å–Ω—ñ
„äóÔ∏è	–≤—ñ—Ç–∞–Ω–Ω—è, –∫–∏—Ç–∞–π—Å—å–∫–∏–π, –∫–Ω–æ–ø–∫–∞ "–≤—ñ—Ç–∞–Ω–Ω—è" —è–ø–æ–Ω—Å—å–∫–æ—é, –ø—Ä–∏–≤—ñ—Ç–∞–Ω–Ω—è, —ñ–¥–µ–æ–≥—Ä–∞–º–∞, —ñ—î—Ä–æ–≥–ª—ñ—Ñ
„äôÔ∏è	–∫–∏—Ç–∞–π—Å—å–∫–∏–π, –∫–Ω–æ–ø–∫–∞ "—Å–µ–∫—Ä–µ—Ç" —è–ø–æ–Ω—Å—å–∫–æ—é, —Å–µ–∫—Ä–µ—Ç, —ñ–¥–µ–æ–≥—Ä–∞–º–∞, —ñ—î—Ä–æ–≥–ª—ñ—Ñ
üÄÑÔ∏è	–≥—Ä–∞, –º–∞–¥–∂–æ–Ω–≥, —Ñ—ñ—à–∫–∞ –º–∞–¥–∂–æ–Ω–≥ —á–µ—Ä–≤–æ–Ω–∏–π –¥—Ä–∞–∫–æ–Ω, —Ñ—ñ—à–∫–∞ –º–∞–¥–∂–æ–Ω–≥—É ¬´—á–µ—Ä–≤–æ–Ω–∏–π –¥—Ä–∞–∫–æ–Ω¬ª, —á–µ—Ä–≤–æ–Ω–∏–π
üÖ∞Ô∏è	1, a, i, –∫–Ω–æ–ø–∫–∞ A (I–Ü –≥—Ä—É–ø–∞ –∫—Ä–æ–≤—ñ), –∫–Ω–æ–ø–∫–∞ ¬´–≥—Ä—É–ø–∞ –∫—Ä–æ–≤—ñ –∞¬ª, –∫—Ä–æ–≤
üÖ±Ô∏è	2, b, ii, –∫–Ω–æ–ø–∫–∞ B (III –≥—Ä—É–ø–∞ –∫—Ä–æ–≤—ñ), –∫–Ω–æ–ø–∫–∞ ¬´–≥—Ä—É–ø–∞ –∫—Ä–æ–≤—ñ b¬ª, –∫—Ä–æ–≤
üÖæÔ∏è	4, iv, o, –∫–Ω–æ–ø–∫–∞ ¬´–Ü –≥—Ä—É–ø–∞ –∫—Ä–æ–≤—ñ¬ª, –∫–Ω–æ–ø–∫–∞ ¬´–≥—Ä—É–ø–∞ –∫—Ä–æ–≤—ñ o¬ª, –∫—Ä–æ–≤
üÖøÔ∏è	–∫–Ω–æ–ø–∫–∞ ¬´–ø–∞—Ä–∫—É–≤–∞–Ω–Ω—è¬ª, –ø–∞—Ä–∫—É–≤–∞–Ω–Ω—è
üàÇÔ∏è	–∫–Ω–æ–ø–∫–∞ "—Å–µ—Ä–≤—ñ—Å–Ω–∏–π –∑–±—ñ—Ä" —è–ø–æ–Ω—Å—å–∫–æ—é, —è–ø–æ–Ω—Å—å–∫–∏–π
üåéÔ∏è	–∞–º–µ—Ä–∏–∫–∞, –≥–ª–æ–±—É—Å, –≥–ª–æ–±—É—Å, —â–æ –ø–æ–∫–∞–∑—É—î –ê–º–µ—Ä–∏–∫–∏, –∑–µ–º–ª—è, —Å–≤—ñ—Ç
üåïÔ∏è	–∫–æ—Å–º–æ—Å, –º—ñ—Å—è—Ü—å, –ø–æ–≤–Ω–∏–π, –ø–æ–≤–Ω–∏–π –º—ñ—Å—è—Ü—å, –ø–æ–≥–æ–¥–∞
üåúÔ∏è	–∫–æ—Å–º–æ—Å, –º—ñ—Å—è—Ü—å, –æ–±–ª–∏—á—á—è, –æ—Å—Ç–∞–Ω–Ω—è —á–≤–µ—Ä—Ç—å –º—ñ—Å—è—Ü—è –∑ –æ–±–ª–∏—á—á—è–º, –ø–æ–≥–æ–¥–∞, —á–≤–µ—Ä—Ç—å
üå°Ô∏è	–ø–æ–≥–æ–¥–∞, —Ç–µ—Ä–º–æ–º–µ—Ç—Ä
üå§Ô∏è	–ø–æ–≥–æ–¥–∞, —Å–æ–Ω—Ü–µ, —Å–æ–Ω—Ü–µ –∑–∞ —Ö–º–∞—Ä–∫–æ—é, —Ö–º–∞—Ä–∞
üå•Ô∏è	–ø–æ–≥–æ–¥–∞, —Å–æ–Ω—Ü–µ, —Å–æ–Ω—Ü–µ –∑–∞ —Ö–º–∞—Ä–∏–Ω–æ—é, —Ö–º–∞—Ä–∞
üå¶Ô∏è	–¥–æ—â, –ø–æ–≥–æ–¥–∞, —Å–æ–Ω—Ü–µ, —Å–æ–Ω—Ü–µ –∑–∞ –¥–æ—â–æ–≤–æ—é —Ö–º–∞—Ä–æ—é, —Ö–º–∞—Ä–∞
üåßÔ∏è	–¥–æ—â, –ø–æ–≥–æ–¥–∞, —Ö–º–∞—Ä–∞, —Ö–º–∞—Ä–∞ –∑ –¥–æ—â–µ–º
üå®Ô∏è	–ø–æ–≥–æ–¥–∞, —Å–Ω—ñ–≥, —Ö–º–∞—Ä–∞, —Ö–º–∞—Ä–∞ –∑—ñ —Å–Ω—ñ–≥–æ–º, —Ö–æ–ª–æ–¥–Ω–∏–π
üå©Ô∏è	–±–ª–∏—Å–∫–∞–≤–∫–∞, –ø–æ–≥–æ–¥–∞, —Ö–º–∞—Ä–∞, —Ö–º–∞—Ä–∞ –∑ –±–ª–∏—Å–∫–∞–≤–∫–æ—é
üå™Ô∏è	–ø–æ–≥–æ–¥–∞, —Ç–æ—Ä–Ω–∞–¥–æ, —É—Ä–∞–≥–∞–Ω, —Ö–º–∞—Ä–∞
üå´Ô∏è	–ø–æ–≥–æ–¥–∞, —Ç—É–º–∞–Ω, —Ö–º–∞—Ä–∞
üå¨Ô∏è	–≤—ñ—Ç–µ—Ä, –≤—ñ—è—Ç–∏, –æ–±–ª–∏—á—á—è, –æ–±–ª–∏—á—á—è, —â–æ –¥–º–µ, –ø–æ–≥–æ–¥–∞, —Ö–º–∞—Ä–∞
üå∂Ô∏è	–≥–æ—Å—Ç—Ä–∏–π, –≥–æ—Å—Ç—Ä–∏–π –ø–µ—Ä–µ—Ü—å, –ø–µ—Ä–µ—Ü—å
üç∏Ô∏è	–±–∞—Ä, –±–æ–∫–∞–ª, –±–æ–∫–∞–ª –¥–ª—è –∫–æ–∫—Ç–µ–π–ª—é, –∫–æ–∫—Ç–µ–π–ª—å, –ø–∏—Ç–∏
üçΩÔ∏è	–≤–∏–¥–µ–ª–∫–∞, –≤–∏–¥–µ–ª–∫–∞, –Ω—ñ–∂ —ñ —Ç–∞—Ä—ñ–ª–∫–∞, –∫—É–ª—ñ–Ω–∞—Ä—ñ—è, –Ω—ñ–∂, —Ç–∞—Ä—ñ–ª–∫–∞
üéìÔ∏è	–≤–∏–ø—É—Å–∫, –∫–∞–ø–µ–ª—é—Ö, –∫–≤–∞–¥—Ä–∞—Ç–Ω–∞ –∞–∫–∞–¥–µ–º—ñ—á–Ω–∞ —à–∞–ø–æ—á–∫–∞, –æ–¥—è–≥, —à–∞–ø–∫–∞
üéñÔ∏è	–≤—ñ–π—Å—å–∫–æ–≤–∞ –º–µ–¥–∞–ª—å, –≤—ñ–π—Å—å–∫–æ–≤–∏–π, –º–µ–¥–∞–ª—å, —Å–≤—è—Ç–∫—É–≤–∞–Ω–Ω—è
üéóÔ∏è	–ø–∞–º‚Äô—è—Ç–Ω–∏–π, —Å–≤—è—Ç–∫—É–≤–∞–Ω–Ω—è, —Å—Ç—Ä—ñ—á–∫–∞, —Å—Ç—Ä—ñ—á–∫–∞ –Ω–∞ –∑–≥–∞–¥–∫—É
üéôÔ∏è	–º—É–∑–∏—á–Ω–∏–π, –º—ñ–∫—Ä–æ—Ñ–æ–Ω, —Å—Ç—É–¥—ñ–π–Ω–∏–π –º—ñ–∫—Ä–æ—Ñ–æ–Ω, —Å—Ç—É–¥—ñ—è
üéöÔ∏è	–±—ñ–≥—É–Ω–µ—Ü—å —Ä—ñ–≤–Ω—è, –º—É–∑–∏—á–Ω–∏–π, –ø–æ–≤–∑—É–Ω–æ–∫, –ø–æ–≤–∑—É–Ω–æ–∫ —Ä—ñ–≤–Ω—è
üéõÔ∏è	–µ–ª–µ–º–µ–Ω—Ç –∫–µ—Ä—É–≤–∞–Ω–Ω—è, –∫—Ä—É–≥–ª—ñ —Ä–µ–≥—É–ª—è—Ç–æ—Ä–∏, –º—É–∑–∏—á–Ω–∏–π, –æ–±–µ—Ä—Ç–æ–≤—ñ —Ä–µ–≥—É–ª—è—Ç–æ—Ä–∏
üéûÔ∏è	–∫–∞–¥—Ä–∏, –∫–∞–¥—Ä–∏ –∫—ñ–Ω–æ–ø–ª—ñ–≤–∫–∏, –∫—ñ–Ω–æ, –ø–ª—ñ–≤–∫–∞, —Ñ—ñ–ª—å–º
üéüÔ∏è	–≤—Ö—ñ–¥–Ω–∏–π, –≤—Ö—ñ–¥–Ω—ñ –∫–≤–∏—Ç–∫–∏, –∫–≤–∏—Ç–æ–∫
üéßÔ∏è	–Ω–∞–≤—É—à–Ω–∏–∫–∏
üé¨Ô∏è	–∫—ñ–Ω–æ—Ö–ª–æ–ø–∞–≤–∫–∞, —Ñ—ñ–ª—å–º, —Ö–ª–æ–ø–∞–≤–∫–∞
üé≠Ô∏è	–≤–∏—Å—Ç–∞–≤–∞, –º–∞—Å–∫–∞, –º–∏—Å—Ç–µ—Ü—Ç–≤–æ, —Ç–µ–∞—Ç—Ä, —Ç–µ–∞—Ç—Ä–∞–ª—å–Ω–µ –º–∏—Å—Ç–µ—Ü—Ç–≤–æ
üéÆÔ∏è	–≥—Ä–∞, –∫–æ–Ω—Ç—Ä–æ–ª–µ—Ä, —ñ–≥—Ä–æ–≤–∏–π –∫–æ–Ω—Ç—Ä–æ–ª–µ—Ä
üèÇÔ∏è	–ª–∏–∂—ñ, —Å–Ω–æ—É–±–æ—Ä–¥, —Å–Ω–æ—É–±–æ—Ä–¥–∏—Å—Ç, —Å–Ω—ñ–≥
üèÑÔ∏è	–ª—é–¥–∏–Ω–∞, —â–æ –∑–∞–π–º–∞—î—Ç—å—Å—è —Å–µ—Ä—Ñ—ñ–Ω–≥–æ–º, —Å–µ—Ä—Ñ—ñ–Ω–≥
üèÜÔ∏è	–ø—Ä–∏–∑
üèäÔ∏è	–ª—é–¥–∏–Ω–∞, —â–æ –ø–ª–∏–≤–µ, –ø–ª–∞–≤–∞—Ç–∏
üèãÔ∏è	–≤–∞–∂–∫–æ–∞—Ç–ª–µ—Ç, —Ç—è–≥–∞—Ä
üèåÔ∏è	–≥–æ–ª—å—Ñ, –ª—é–¥–∏–Ω–∞, —â–æ –≥—Ä–∞—î –≤ –≥–æ–ª—å—Ñ, –º‚Äô—è—á
üèçÔ∏è	–º–æ—Ç–æ—Ü–∏–∫–ª, –ø–µ—Ä–µ–≥–æ–Ω–∏
üèéÔ∏è	c–ø–æ—Ä—Ç–∏–≤–Ω–∏–π –∞–≤—Ç–æ–º–æ–±—ñ–ª—å, –∞–≤—Ç–æ–º–æ–±—ñ–ª—å, –ø–µ—Ä–µ–≥–æ–Ω–∏
üèîÔ∏è	–≥–æ—Ä–∞, –≥–æ—Ä–∞ —ñ–∑ –∑–∞—Å–Ω—ñ–∂–µ–Ω–æ—é –≤–µ—Ä—Ö—ñ–≤–∫–æ—é, —Å–Ω—ñ–≥, —Ö–æ–ª–æ–¥–Ω–∏–π
üèïÔ∏è	–∫–µ–º–ø—ñ–Ω–≥, –ø–æ—Ö—ñ–¥
üèñÔ∏è	–ø–∞—Ä–∞—Å–æ–ª—è, –ø–ª—è–∂, –ø–ª—è–∂ —ñ –ø–∞—Ä–∞—Å–æ–ª—å–∫–∞
üèóÔ∏è	–±—É–¥—ñ–≤–ª—è, —Å–ø–æ—Ä—É–¥–∂–µ–Ω–Ω—è, —Å–ø–æ—Ä—É–¥–∂–µ–Ω–Ω—è –±—É–¥—ñ–≤–ª—ñ
üèòÔ∏è	–±—É–¥–∏–Ω–æ–∫, –±—É–¥—ñ–≤–ª—è, –≥—Ä—É–ø–∞ –±—É–¥–∏–Ω–∫—ñ–≤
üèôÔ∏è	–±—É–¥—ñ–≤–ª—è, –∫—Ä–∞—î–≤–∏–¥ –º—ñ—Å—Ç–∞, –º—ñ—Å—å–∫–∏–π –∫—Ä–∞—î–≤–∏–¥
üèöÔ∏è	–±—É–¥–∏–Ω–æ–∫, –±—É–¥—ñ–≤–ª—è, –∑–∞–Ω–µ–¥–±–∞–Ω–∏–π –±—É–¥–∏–Ω–æ–∫, –ø–æ–∫–∏–Ω—É—Ç–∏–π
üèõÔ∏è	–∞–Ω—Ç–∏—á–Ω–∞ –±—É–¥—ñ–≤–ª—è, –±—É–¥—ñ–≤–ª—è, –∫–ª–∞—Å–∏—á–Ω–∏–π
üèúÔ∏è	–ø—É—Å—Ç–µ–ª—è
üèùÔ∏è	–±–µ–∑–ª—é–¥–Ω–∏–π, –±–µ–∑–ª—é–¥–Ω–∏–π –æ—Å—Ç—Ä—ñ–≤, –æ—Å—Ç—Ä—ñ–≤
üèûÔ∏è	–Ω–∞—Ü—ñ–æ–Ω–∞–ª—å–Ω–∏–π –ø–∞—Ä–∫, –ø–∞—Ä–∫
üèüÔ∏è	—Å—Ç–∞–¥—ñ–æ–Ω
üè†Ô∏è	–±—É–¥–∏–Ω–æ–∫, –±—É–¥—ñ–≤–ª—è, –¥—ñ–º
üè≠Ô∏è	–±—É–¥—ñ–≤–ª—è, —Ñ–∞–±—Ä–∏–∫–∞
üè≥Ô∏è	–±—ñ–ª–∏–π –ø—Ä–∞–ø–æ—Ä, –º–∞–π–æ—Ä–∏—Ç—å
üèµÔ∏è	—Ä–æ–∑–µ—Ç–∞, —Ä–æ–∑–µ—Ç–∫–∞, —Ä–æ—Å–ª–∏–Ω–∞
üè∑Ô∏è	–±–∏—Ä–∫–∞, —è—Ä–ª–∏–∫
üêàÔ∏è	–¥–æ–º–∞—à–Ω—ñ–π —É–ª—é–±–ª–µ–Ω–µ—Ü—å, –∫—ñ—Ç
üêïÔ∏è	–ø–µ—Å, —Å–æ–±–∞–∫–∞
üêüÔ∏è	–∑–æ–¥—ñ–∞–∫, —Ä–∏–±–∞, —Ä–∏–±–∏
üê¶Ô∏è	–ø—Ç–∞—Ö, –ø—Ç–∞—à–∫–∞
üêøÔ∏è	–±—É—Ä—É–Ω–¥—É–∫
üëÅÔ∏è	–æ–∫–æ, —Ç—ñ–ª–æ
üëÇÔ∏è	–≤—É—Ö–æ, —Ç—ñ–ª–æ
üëÜÔ∏è	–≤–∫–∞–∑—ñ–≤–Ω–∏–π –ø–∞–ª–µ—Ü—å —Ç–∏–ª—å–Ω–æ—é —Å—Ç–æ—Ä–æ–Ω–æ—é, —â–æ –≤–∫–∞–∑—É—î –≤–≥–æ—Ä—É, –ø–∞–ª–µ—Ü—å, –ø–∞–ª–µ—Ü—å —Ç–∏–ª—å–Ω–∏–º –±–æ–∫–æ–º, —â–æ –≤–∫–∞–∑—É—î –≤–≥–æ—Ä—É, –ø–æ–∫–∞–∑—É–≤–∞—Ç–∏, —Ä—É–∫–∞, —Ç—ñ–ª–æ, —É–≥–æ—Ä—É, —É–∫–∞–∑—É–≤–∞—Ç–∏
üëáÔ∏è	–≤–∫–∞–∑—ñ–≤–Ω–∏–π –ø–∞–ª–µ—Ü—å —Ç–∏–ª—å–Ω–æ—é —Å—Ç–æ—Ä–æ–Ω–æ—é, —â–æ –≤–∫–∞–∑—É—î –≤–Ω–∏–∑, –ø–∞–ª–µ—Ü—å, –ø–∞–ª–µ—Ü—å —Ç–∏–ª—å–Ω–∏–º –±–æ–∫–æ–º, —â–æ –≤–∫–∞–∑—É—î –≤–Ω–∏–∑, –ø–æ–∫–∞–∑—É–≤–∞—Ç–∏, —Ä—É–∫–∞, —Ç—ñ–ª–æ, —É–∫–∞–∑—É–≤–∞—Ç–∏, —É–Ω–∏–∑
üëàÔ∏è	–≤–∫–∞–∑—ñ–≤–Ω–∏–π –ø–∞–ª–µ—Ü—å —Ç–∏–ª—å–Ω–æ—é —Å—Ç–æ—Ä–æ–Ω–æ—é, —â–æ –≤–∫–∞–∑—É—î –≤–ª—ñ–≤–æ, –ø–∞–ª–µ—Ü—å, –ø–∞–ª–µ—Ü—å —Ç–∏–ª—å–Ω–∏–º –±–æ–∫–æ–º, —â–æ –≤–∫–∞–∑—É—î –≤–ª—ñ–≤–æ, –ø–æ–∫–∞–∑—É–≤–∞—Ç–∏, —Ä—É–∫–∞, —Ç—ñ–ª–æ, —É–∫–∞–∑—É–≤–∞—Ç–∏
üëâÔ∏è	–≤–∫–∞–∑—ñ–≤–Ω–∏–π –ø–∞–ª–µ—Ü—å —Ç–∏–ª—å–Ω–æ—é —Å—Ç–æ—Ä–æ–Ω–æ—é, —â–æ –≤–∫–∞–∑—É—î –≤–ø—Ä–∞–≤–æ, –ø–∞–ª–µ—Ü—å, –ø–∞–ª–µ—Ü—å —Ç–∏–ª—å–Ω–∏–º –±–æ–∫–æ–º, —â–æ –≤–∫–∞–∑—É—î –≤–ø—Ä–∞–≤–æ, –ø–æ–∫–∞–∑—É–≤–∞—Ç–∏, —Ä—É–∫–∞, —Ç—ñ–ª–æ, —É–∫–∞–∑—É–≤–∞—Ç–∏
üëçÔ∏è	+1, –≤–µ–ª–∏–∫—ñ –ø–∞–ª—å—Ü—ñ –≤–≥–æ—Ä—É, –ø–æ–¥–æ–±–∞—î—Ç—å—Å—è, —Ä—É–∫–∞, —Ç—ñ–ª–æ
üëéÔ∏è	-1, –≤–µ–ª–∏–∫—ñ –ø–∞–ª—å—Ü—ñ –≤–Ω–∏–∑, –Ω–µ –ø–æ–¥–æ–±–∞—î—Ç—å—Å—è, —Ä—É–∫–∞, —Ç—ñ–ª–æ
üëìÔ∏è	–æ–¥—è–≥, –æ–∫–æ, –æ–∫—É–ª—è—Ä–∏
üë™Ô∏è	–±–∞—Ç—å–∫–æ, –¥–∏—Ç–∏–Ω–∞, –º–∞–º–∞, –º–∞—Ç—ñ—Ä, —Ä–æ–¥–∏–Ω–∞, —Ç–∞—Ç–æ
üëΩÔ∏è	–∫–∞–∑–∫–∞, –∫–æ—Å–º–æ—Å, –º–æ–Ω—Å—Ç—Ä, –Ω–ª–æ, –æ–±–ª–∏—á—á—è, –ø–æ–∑–∞–∑–µ–º–Ω–∏–π, –ø—Ä–∏–±—É–ª–µ—Ü—å, —Å—Ç–≤–æ—Ä—ñ–Ω–Ω—è, —Ñ–∞–Ω—Ç–∞–∑—ñ—è
üí£Ô∏è	–±–æ–º–±–∞, –∫–æ–º—ñ–∫—Å–∏
üí∞Ô∏è	–≥—Ä–æ—à—ñ, –¥–æ–ª–∞—Ä, –º—ñ—à–æ–∫, –º—ñ—à–æ–∫ –≥—Ä–æ—à–µ–π
üí≥Ô∏è	–±–∞–Ω–∫, –≥—Ä–æ—à—ñ, –∫–∞—Ä—Ç–∫–∞, –∫—Ä–µ–¥–∏—Ç–Ω–∞, –∫—Ä–µ–¥–∏—Ç–Ω–∞ –∫–∞—Ä—Ç–∫–∞
üíªÔ∏è	–∫–æ–º–ø‚Äô—é—Ç–µ—Ä, –Ω–æ—É—Ç–±—É–∫, –ø–µ—Ä—Å–æ–Ω–∞–ª—å–Ω–∏–π, –ø–∫
üíøÔ∏è	blu-ray, cd, dvd, –¥–∏—Å–∫, –∫–æ–º–ø–∞–∫—Ç-–¥–∏—Å–∫, –∫–æ–º–ø‚Äô—é—Ç–µ—Ä, –æ–ø—Ç–∏—á–Ω–∏–π
üìãÔ∏è	–ø–∞–ø–∫–∞, –ø–ª–∞–Ω—à–µ—Ç, –ø–ª–∞–Ω—à–µ—Ç –¥–ª—è –∞—Ä–∫—É—à—ñ–≤
üìöÔ∏è	–∫–Ω–∏–≥–∏, –∫–Ω–∏–∂–∫–∞
üìüÔ∏è	–ø–µ–π–¥–∂–µ—Ä
üì§Ô∏è	–∫–æ—Ä–æ–±–∫–∞, –ª–∏—Å—Ç, –ª–æ—Ç–æ–∫, –ª–æ—Ç–æ–∫ –≤–∏—Ö—ñ–¥–Ω–æ—ó —Å–∫—Ä–∏–Ω—å–∫–∏, –Ω–∞–¥—ñ—Å–ª–∞–Ω–∏–π, –ø–æ—à—Ç–∞
üì•Ô∏è	–≤—Ö—ñ–¥–Ω–∞ –ø–æ—à—Ç–∞, –∫–æ—Ä–æ–±–∫–∞, –ª–∏—Å—Ç, –ª–æ—Ç–æ–∫, –ª–æ—Ç–æ–∫ –≤—Ö—ñ–¥–Ω–æ—ó —Å–∫—Ä–∏–Ω—å–∫–∏, –æ—Ç—Ä–∏–º—É–≤–∞—Ç–∏, –ø–æ—à—Ç–∞
üì¶Ô∏è	–ø–∞–∫—É–Ω–æ–∫, –ø–æ—Å–∏–ª–∫–∞
üì™Ô∏è	–∑–∞–∫—Ä–∏—Ç–∞ –ø–æ—à—Ç–æ–≤–∞ —Å–∫—Ä–∏–Ω—å–∫–∞ –∑ –æ–ø—É—â–µ–Ω–∏–º –ø—Ä–∞–ø–æ—Ä—Ü–µ–º, –∑–∞–∫—Ä–∏—Ç–∏–π, –æ–ø—É—â–µ–Ω–∏–π, –ø–æ—à—Ç–∞, –ø–æ—à—Ç–æ–≤–∞ —Å–∫—Ä–∏–Ω—å–∫–∞
üì´Ô∏è	–∑–∞–∫—Ä–∏—Ç–∞ –ø–æ—à—Ç–æ–≤–∞ —Å–∫—Ä–∏–Ω—å–∫–∞ –∑ –ø—ñ–¥–Ω—è—Ç–∏–º –ø—Ä–∞–ø–æ—Ä—Ü–µ–º, –∑–∞–∫—Ä–∏—Ç–∏–π, –ø–æ—à—Ç–∞, –ø–æ—à—Ç–æ–≤–∞ —Å–∫—Ä–∏–Ω—å–∫–∞
üì¨Ô∏è	–≤—ñ–¥–∫—Ä–∏—Ç–∞ –ø–æ—à—Ç–æ–≤–∞ —Å–∫—Ä–∏–Ω—å–∫–∞ –∑ –ø—ñ–¥–Ω—è—Ç–∏–º –ø—Ä–∞–ø–æ—Ä—Ü–µ–º, –≤—ñ–¥–∫—Ä–∏—Ç–∏–π, –ø–æ—à—Ç–∞, –ø–æ—à—Ç–æ–≤–∞ —Å–∫—Ä–∏–Ω—å–∫–∞
üì≠Ô∏è	–≤—ñ–¥–∫—Ä–∏—Ç–∞ –ø–æ—à—Ç–æ–≤–∞ —Å–∫—Ä–∏–Ω—å–∫–∞ –∑ –æ–ø—É—â–µ–Ω–∏–º –ø—Ä–∞–ø–æ—Ä—Ü–µ–º, –≤—ñ–¥–∫—Ä–∏—Ç–∏–π, –æ–ø—É—â–µ–Ω–∏–π, –ø–æ—à—Ç–∞, –ø–æ—à—Ç–æ–≤–∞ —Å–∫—Ä–∏–Ω—å–∫–∞
üì∑Ô∏è	–≤—ñ–¥–µ–æ, —Ñ–æ—Ç–æ–∞–ø–∞—Ä–∞—Ç
üìπÔ∏è	–≤—ñ–¥–µ–æ, –≤—ñ–¥–µ–æ–∫–∞–º–µ—Ä–∞, –∫–∞–º–µ—Ä–∞
üì∫Ô∏è	–≤—ñ–¥–µ–æ, —Ç–±, —Ç–µ–ª–µ–≤—ñ–∑–æ—Ä
üìªÔ∏è	–≤—ñ–¥–µ–æ, —Ä–∞–¥—ñ–æ, —Ä–∞–¥—ñ–æ–ø—Ä–∏–π–º–∞—á
üìΩÔ∏è	–≤—ñ–¥–µ–æ, –∫—ñ–Ω–æ, –∫—ñ–Ω–æ–ø—Ä–æ–µ–∫—Ç–æ—Ä, –ø—Ä–æ–µ–∫—Ç–æ—Ä, —Ñ—ñ–ª—å–º
üîàÔ∏è	–Ω–µ–≥—É—á–Ω–æ, –Ω–∏–∑—å–∫–∞ –≥—É—á–Ω—ñ—Å—Ç—å –¥–∏–Ω–∞–º—ñ–∫–∞, –ø—Ä–∏–≥–ª—É—à–µ–Ω–æ
üîíÔ∏è	–∑–∞–∫—Ä–∏—Ç–æ, –∑–∞–º–∫–Ω–µ–Ω–∏–π –∑–∞–º–æ–∫
üîìÔ∏è	–≤—ñ–¥—Ä–∏—Ç–∏, –≤—ñ–¥—ñ–º–∫–Ω–µ–Ω–∏–π –∑–∞–º–æ–∫, –≤—ñ–¥—ñ–º–∫–Ω—É—Ç–∏, –∑–∞–º–æ–∫
üïâÔ∏è	–∑–≤—É–∫ –æ–º, –æ–º, —Ä–µ–ª—ñ–≥—ñ—è, —ñ–Ω–¥—É—ó–∑–º
üïäÔ∏è	–≥–æ–ª—É–±, –ª—ñ—Ç–∞—Ç–∏, –º–∏—Ä, –ø—Ç–∞—Ö
üïêÔ∏è	00, 1, 1:00, –≥–æ–¥–∏–Ω–∞, –≥–æ–¥–∏–Ω–Ω–∏–∫, –æ–¥–∏–Ω, –ø–µ—Ä—à–∞ –≥–æ–¥–∏–Ω–∞
üïëÔ∏è	00, 2, 2:00, –≥–æ–¥–∏–Ω–∞, –≥–æ–¥–∏–Ω–Ω–∏–∫, –¥–≤–∞, –¥—Ä—É–≥–∞ –≥–æ–¥–∏–Ω–∞
üïíÔ∏è	00, 3, 3:00, –≥–æ–¥–∏–Ω–∞, –≥–æ–¥–∏–Ω–Ω–∏–∫, —Ç—Ä–µ—Ç—è –≥–æ–¥–∏–Ω–∞, —Ç—Ä–∏
üïìÔ∏è	00, 4, 4:00, –≥–æ–¥–∏–Ω–∞, –≥–æ–¥–∏–Ω–Ω–∏–∫, —á–µ—Ç–≤–µ—Ä—Ç–∞ –≥–æ–¥–∏–Ω–∞, —á–æ—Ç–∏—Ä–∏
üïîÔ∏è	00, 5, 5:00, –≥–æ–¥–∏–Ω–∞, –≥–æ–¥–∏–Ω–Ω–∏–∫, –ø‚Äô—è—Ç–∞ –≥–æ–¥–∏–Ω–∞, –ø‚Äô—è—Ç—å
üïïÔ∏è	00, 6, 6:00, –≥–æ–¥–∏–Ω–∞, –≥–æ–¥–∏–Ω–Ω–∏–∫, —à–æ—Å—Ç–∞ –≥–æ–¥–∏–Ω–∞, —à—ñ—Å—Ç—å
üïñÔ∏è	00, 7, 7:00, –≥–æ–¥–∏–Ω–∞, –≥–æ–¥–∏–Ω–Ω–∏–∫, —Å—å–æ–º–∞ –≥–æ–¥–∏–Ω–∞, —Å—ñ–º
üïóÔ∏è	00, 8, 8:00, –≤–æ—Å—å–º–∞ –≥–æ–¥–∏–Ω–∞, –≤—ñ—Å—ñ–º, –≥–æ–¥–∏–Ω–∞, –≥–æ–¥–∏–Ω–Ω–∏–∫
üïòÔ∏è	00, 9, 9:00, –≥–æ–¥–∏–Ω–∞, –≥–æ–¥–∏–Ω–Ω–∏–∫, –¥–µ–≤‚Äô—è—Ç–∞ –≥–æ–¥–∏–Ω–∞, –¥–µ–≤‚Äô—è—Ç—å
üïôÔ∏è	00, 10, 10:00, –≥–æ–¥–∏–Ω–∞, –≥–æ–¥–∏–Ω–Ω–∏–∫, –¥–µ—Å—è—Ç–∞ –≥–æ–¥–∏–Ω–∞, –¥–µ—Å—è—Ç—å
üïöÔ∏è	00, 11, 11:00, –≥–æ–¥–∏–Ω–∞, –≥–æ–¥–∏–Ω–Ω–∏–∫, –æ–¥–∏–Ω–∞–¥—Ü—è—Ç–∞ –≥–æ–¥–∏–Ω–∞, –æ–¥–∏–Ω–∞–¥—Ü—è—Ç—å
üïõÔ∏è	00, 12, 12:00, –≥–æ–¥–∏–Ω–∞, –≥–æ–¥–∏–Ω–Ω–∏–∫, –¥–≤–∞–Ω–∞–¥—Ü—è—Ç–∞ –≥–æ–¥–∏–Ω–∞, –¥–≤–∞–Ω–∞–¥—Ü—è—Ç—å
üïØÔ∏è	—Å–≤—ñ—Ç–ª–æ, —Å–≤—ñ—á–∫–∞
üï∞Ô∏è	–≥–æ–¥–∏–Ω–Ω–∏–∫, –∫–∞–º—ñ–Ω–Ω–∏–π –≥–æ–¥–∏–Ω–Ω–∏–∫
üï≥Ô∏è	–¥—ñ—Ä–∞, –ª—É–Ω–∫–∞
üï¥Ô∏è	–±—ñ–∑–Ω–µ—Å, –∫–æ—Å—Ç—é–º, —á–æ–ª–æ–≤—ñ–∫, —á–æ–ª–æ–≤—ñ–∫ —É –¥—ñ–ª–æ–≤–æ–º—É –∫–æ—Å—Ç—é–º—ñ, —â–æ –ª–µ–≤—ñ—Ç—É—î
üïµÔ∏è	–¥–µ—Ç–µ–∫—Ç–∏–≤, —Å–∏—â–∏–∫, —à–ø–∏–≥—É–Ω
üï∂Ô∏è	–æ–∫–æ, –æ–∫—É–ª—è—Ä–∏, —Å–æ–Ω—Ü–µ–∑–∞—Ö–∏—Å–Ω—ñ –æ–∫—É–ª—è—Ä–∏, —Ç–µ–º–Ω–∏–π
üï∑Ô∏è	–∫–æ–º–∞—Ö–∞, –ø–∞–≤—É–∫
üï∏Ô∏è	–ø–∞–≤—É–∫, –ø–∞–≤—É—Ç–∏–Ω–∞, –ø–∞–≤—É—Ç–∏–Ω–Ω—è
üïπÔ∏è	–≤—ñ–¥–µ–æ–≥—Ä–∞, –≥—Ä–∞, –¥–∂–æ–π—Å—Ç–∏–∫
üñáÔ∏è	–∑—á–µ–ø–ª–µ–Ω–∏–π, –∑—á–µ–ø–ª–µ–Ω—ñ —Å–∫—Ä—ñ–ø–∫–∏, —Å–∫—Ä—ñ–ø–∫–∞
üñäÔ∏è	–∫—É–ª—å–∫–æ–≤–∞, –∫—É–ª—å–∫–æ–≤–∞ —Ä—É—á–∫–∞
üñãÔ∏è	—Ä—É—á–∫–∞, —á–æ—Ä–Ω–∏–ª—å–Ω–∞, —á–æ—Ä–Ω–∏–ª—å–Ω–∞ —Ä—É—á–∫–∞
üñåÔ∏è	–º–∞–ª—é–≤–∞–Ω–Ω—è, –ø–µ–Ω–∑–µ–ª—å
üñçÔ∏è	–ø–∞—Å—Ç–µ–ª—å, —Ñ–ª–æ–º–∞—Å—Ç–µ—Ä
üñêÔ∏è	–ø–∞–ª–µ—Ü—å, –ø—ñ–¥–Ω—è—Ç–∞ —Ä—É–∫–∞ –∑ —Ä–æ–∑–≤–µ–¥–µ–Ω–∏–º–∏ –ø–∞–ª—å—Ü—è–º–∏, —Ä–æ–∑—á–µ–ø—ñ—Ä–µ–Ω–∏–π, —Ä—É–∫–∞, —Ç—ñ–ª–æ
üñ•Ô∏è	–∫–æ–º–ø‚Äô—é—Ç–µ—Ä, –Ω–∞—Å—Ç—ñ–ª—å–Ω–∏–π
üñ®Ô∏è	–∫–æ–º–ø‚Äô—é—Ç–µ—Ä, –ø—Ä–∏–Ω—Ç–µ—Ä
üñ±Ô∏è	3, –∫–Ω–æ–ø–∫–∞, –∫–æ–º–ø‚Äô—é—Ç–µ—Ä, –∫–æ–º–ø‚Äô—é—Ç–µ—Ä–Ω–∞ –º–∏—à–∞, –º–∏—à–∞, —Ç—Ä–∏
üñ≤Ô∏è	–∫–æ–º–ø‚Äô—é—Ç–µ—Ä, —Ç—Ä–µ–∫–±–æ–ª
üñºÔ∏è	–∫–∞—Ä—Ç–∏–Ω–∞, –∫–∞—Ä—Ç–∏–Ω–∞ –≤ —Ä–∞–º—Ü—ñ, –º–∏—Å—Ç–µ—Ü—Ç–≤–æ, –º—É–∑–µ–π, —Ä–∞–º–∞
üóÇÔ∏è	–∫–∞—Ä—Ç–æ—Ç–µ–∫–∞, —Ä–æ–∑–¥—ñ–ª—å–Ω–∏–∫–∏ –≤ –∫–∞—Ä—Ç–æ—Ç–µ—Ü—ñ, —Ä–æ–∑–¥—ñ–ª—å–Ω–∏–∫–∏ –Ω—É–º–µ—Ä–∞—Ü—ñ—ó –∫–∞—Ä—Ç–æ–∫, —Ä–æ–∑–¥—ñ–ª—é–≤–∞—á—ñ
üóÉÔ∏è	–∫–æ—Ä–æ–±–∫–∞, —Å–∫—Ä–∏–Ω—å–∫–∞ –¥–ª—è –∫–∞—Ä—Ç–æ–∫, —Ñ–∞–π–ª–∏
üóÑÔ∏è	—Ä–µ—î—Å—Ç—Ä–∞—Ç–æ—Ä, —à–∞—Ñ–∞, —à–∞—Ñ–∞ –¥–ª—è –¥–æ–∫—É–º–µ–Ω—Ç—ñ–≤
üóëÔ∏è	–∫–æ—à–∏–∫, —Å–º—ñ—Ç—Ç—è, —Å–º—ñ—Ç—Ç—î–≤–∏–π –∫–æ—à–∏–∫
üóíÔ∏è	–±–ª–æ–∫–Ω–æ—Ç, –±–ª–æ–∫–Ω–æ—Ç –Ω–∞ —Å–ø—ñ—Ä–∞–ª—ñ, –Ω–∞ —Å–ø—ñ—Ä–∞–ª—ñ
üóìÔ∏è	–±–ª–æ–∫–Ω–æ—Ç, –∫–∞–ª–µ–Ω–¥–∞—Ä, –∫–∞–ª–µ–Ω–¥–∞—Ä –Ω–∞ —Å–ø—ñ—Ä–∞–ª—ñ, –Ω–∞ —Å–ø—ñ—Ä–∞–ª—ñ
üóúÔ∏è	–∑–∞—Ç–∏—Å–∫–∞—á, –∑–Ω–∞—Ä—è–¥–¥—è, –∫–ª—ñ—â—ñ
üóùÔ∏è	c—Ç–∞—Ä–æ–≤–∏–Ω–Ω–∏–π –∫–ª—é—á, –∑–∞–º–æ–∫, –∫–ª—é—á, –ø—ñ–¥–∫–∞–∑–∫–∞, —Å—Ç–∞—Ä–∏–π, —Å—Ç–∞—Ä–æ–≤–∏–Ω–Ω–∏–π –∫–ª—é—á
üó°Ô∏è	–∑–±—Ä–æ—è, –∫–∏–Ω–¥–∂–∞–ª, –Ω—ñ–∂
üó£Ô∏è	–≥–æ–≤–æ—Ä–∏—Ç–∏, –≥–æ–ª–æ–≤–∞, –≥–æ–ª–æ–≤–∞, —â–æ –≥–æ–≤–æ—Ä–∏—Ç—å, –æ–±–ª–∏—á—á—è, —Å–∏–ª—É–µ—Ç
üó®Ô∏è	–¥—ñ–∞–ª–æ–≥, —Ä–æ–∑–º–æ–≤–∞, —Ö–º–∞—Ä–∏–Ω–∫–∞ –∑ —Ç–µ–∫—Å—Ç–æ–º –∑–ª—ñ–≤–∞
üóØÔ∏è	–±—É–ª—å–∫–∞ —ñ–∑ —Å–µ—Ä–¥–∏—Ç–æ—é —Ä–µ–ø–ª—ñ–∫–æ—é, –∑–ª–∏–π, —Ä–æ–∑–ª—é—á–µ–Ω–∏–π, —Ö–º–∞—Ä–∏–Ω–∫–∞
üó≥Ô∏è	–±—é–ª–µ—Ç–µ–Ω—å, –≥–æ–ª–æ—Å—É–≤–∞–Ω–Ω—è, —É—Ä–Ω–∞, —É—Ä–Ω–∞ –¥–ª—è –≥–æ–ª–æ—Å—É–≤–∞–Ω–Ω—è —ñ –±—é–ª–µ—Ç–µ–Ω—å, —É—Ä–Ω–∞ –¥–ª—è –≥–æ–ª–æ—Å—É–≤–∞–Ω–Ω—è —ñ –≤–∏–±–æ—Ä—á–∏–π –±—é–ª–µ—Ç–µ–Ω—å
üó∫Ô∏è	–∫–∞—Ä—Ç–∞, –∫–∞—Ä—Ç–∞ —Å–≤—ñ—Ç—É, —Å–≤—ñ—Ç
üòêÔ∏è	–Ω–µ–∑–≤–æ—Ä—É—à–Ω–∏–π, –Ω–µ–π—Ç—Ä–∞–ª—å–Ω–∏–π, –æ–±–ª–∏—á—á—è, –æ–±–ª–∏—á—á—è –∑ –Ω–µ–π—Ç—Ä–∞–ª—å–Ω–∏–º –≤–∏—Ä–∞–∑–æ–º
üöáÔ∏è	–º–µ—Ç—Ä–æ, —Ç—Ä–∞–Ω—Å–ø–æ—Ä—Ç
üöçÔ∏è	–∞–≤—Ç–æ–±—É—Å, –∞–≤—Ç–æ–±—É—Å, —â–æ –Ω–∞–±–ª–∏–∂–∞—î—Ç—å—Å—è, –Ω–∞–±–ª–∏–∂–∞—Ç–∏—Å—è, —Ç—Ä–∞–Ω—Å–ø–æ—Ä—Ç
üöëÔ∏è	–∞–≤—Ç–æ–º–æ–±—ñ–ª—å —à–≤–∏–¥–∫–æ—ó –¥–æ–ø–æ–º–æ–≥–∏, —Ç—Ä–∞–Ω—Å–ø–æ—Ä—Ç
üöîÔ∏è	–∞–≤—Ç–æ–º–æ–±—ñ–ª—å, –Ω–∞–±–ª–∏–∂–∞—î—Ç—å—Å—è, –ø–æ–ª—ñ—Ü–µ–π—Å—å–∫–∞ –º–∞—à–∏–Ω–∞, —â–æ –Ω–∞–±–ª–∏–∂–∞—î—Ç—å—Å—è, –ø–æ–ª—ñ—Ü–µ–π—Å—å–∫–∏–π –∞–≤—Ç–æ–º–æ–±—ñ–ª—å, —â–æ –Ω–∞–±–ª–∏–∂–∞—î—Ç—å—Å—è, –ø–æ–ª—ñ—Ü—ñ—è
üöòÔ∏è	–∞–≤—Ç–æ–º–æ–±—ñ–ª—å, –∞–≤—Ç–æ–º–æ–±—ñ–ª—å, —â–æ –Ω–∞–±–ª–∏–∂–∞—î—Ç—å—Å—è, –º–∞—à–∏–Ω–∞, –Ω–∞–±–ª–∏–∂–∞—î—Ç—å—Å—è, —Ç—Ä–∞–Ω—Å–ø–æ—Ä—Ç
üö≠Ô∏è	–∑–∞–±–æ—Ä–æ–Ω–µ–Ω–æ, –∫—É—Ä–∏—Ç–∏, –Ω–µ, –ø–∞–ª–∏—Ç–∏, –ø–∞–ª–∏—Ç–∏ –∑–∞–±–æ—Ä–æ–Ω–µ–Ω–æ, —Å–∏–º–≤–æ–ª ¬´–Ω–µ –ø–∞–ª–∏—Ç–∏¬ª
üö≤Ô∏è	–≤–µ–ª–æ—Å–∏–ø–µ–¥, —Ç—Ä–∞–Ω—Å–ø–æ—Ä—Ç
üöπÔ∏è	–≤–±–∏—Ä–∞–ª—å–Ω—è, –¥–ª—è —á–æ–ª–æ–≤—ñ–∫—ñ–≤, –∫–ª–æ–∑–µ—Ç, —Ç—É–∞–ª–µ—Ç–Ω–∞ –∫—ñ–º–Ω–∞—Ç–∞, —á–æ–ª–æ–≤—ñ—á–∞ –≤–±–∏—Ä–∞–ª—å–Ω—è, —á–æ–ª–æ–≤—ñ—á–∏–π —Ç—É–∞–ª–µ—Ç
üö∫Ô∏è	–¥–ª—è –∂—ñ–Ω–æ–∫, –∂—ñ–Ω–æ—á–∞ –≤–±–∏—Ä–∞–ª—å–Ω—è, –∂—ñ–Ω–æ—á–∏–π —Ç—É–∞–ª–µ—Ç, —É–±–∏—Ä–∞–ª—å–Ω—è
üöºÔ∏è	–¥–ª—è –Ω–µ–º–æ–≤–ª—è—Ç, –∑–∞–º—ñ–Ω–∞ –ø–µ–ª—é—à–æ–∫, –Ω–µ–º–æ–≤–ª—è, —Å–∏–º–≤–æ–ª –Ω–µ–º–æ–≤–ª—è
üõãÔ∏è	–≥–æ—Ç–µ–ª—å, –¥–∏–≤–∞–Ω, –∫–∞–Ω–∞–ø–∞ –π —Ç–æ—Ä—à–µ—Ä, –ª–∞–º–ø–∞
üõçÔ∏è	–ø–æ–∫—É–ø–∫–∏, —Å—É–º–∫–∞, —Å—É–º–∫–∏ –¥–ª—è –ø–æ–∫—É–ø–æ–∫
üõéÔ∏è	–≥–æ—Ç–µ–ª—å, –≥–æ—Ç–µ–ª—å–Ω–∏–π –¥–∑–≤–æ–Ω–∏–∫, –¥–∑–≤–æ–Ω–∏–∫
üõèÔ∏è	–≥–æ—Ç–µ–ª—å, –ª—ñ–∂–∫–æ, —Å–æ–Ω
üõ†Ô∏è	–≥–∞–π–∫–æ–≤–∏–π –∫–ª—é—á, –º–æ–ª–æ—Ç–æ–∫, –º–æ–ª–æ—Ç–æ–∫ —ñ –≥–∞–π–∫–æ–≤–∏–π –∫–ª—é—á, —ñ–Ω—Å—Ç—Ä—É–º–µ–Ω—Ç
üõ°Ô∏è	–∑–±—Ä–æ—è, —â–∏—Ç
üõ¢Ô∏è	–±–æ—á–∫–∞, –±–æ—á–∫–∞ –¥–ª—è –Ω–∞—Ñ—Ç–∏, –ø–∞–ª–∏–≤–æ
üõ£Ô∏è	–∞–≤—Ç–æ–º–∞–≥—ñ—Å—Ç—Ä–∞–ª—å, –¥–æ—Ä–æ–≥–∞
üõ§Ô∏è	–∑–∞–ª—ñ–∑–Ω–∏—Ü—è, –∑–∞–ª—ñ–∑–Ω–∏—á–Ω–∞ –∫–æ–ª—ñ—è, –ø–æ—Ç—è–≥
üõ•Ô∏è	–º–æ—Ç–æ—Ä–Ω–∏–π, –º–æ—Ç–æ—Ä–Ω–∏–π —á–æ–≤–µ–Ω, —Ç—Ä–∞–Ω—Å–ø–æ—Ä—Ç, —á–æ–≤–µ–Ω
üõ©Ô∏è	–ª—ñ—Ç–∞–∫, –º–∞–ª–∏–π –ª—ñ—Ç–∞–∫, —Ç—Ä–∞–Ω—Å–ø–æ—Ä—Ç
üõ∞Ô∏è	–∫–æ—Å–º–æ—Å, —Å—É–ø—É—Ç–Ω–∏–∫, —Ç—Ä–∞–Ω—Å–ø–æ—Ä—Ç
üõ≥Ô∏è	–∫–æ—Ä–∞–±–µ–ª—å, –ø–∞—Å–∞–∂–∏—Ä, –ø–∞—Å–∞–∂–∏—Ä—Å—å–∫–∏–π –∫–æ—Ä–∞–±–µ–ª—å, —Ç—Ä–∞–Ω—Å–ø–æ—Ä—Ç
